,location,location_id,direction,position,ons,offs,total,lifts,period
0,A Ave & Chandler,2,E,NS,0,1,1,0,Spring2018
1,A Ave & Second St,3,E,FS,10,3,13,1,Spring2018
2,A Ave & 10th St,4,W,NS,1,0,1,0,Spring2018
3,A Ave & 8th St,6,E,NS,0,2,2,0,Spring2018
4,A Ave & 8th St,7,W,NS,1,0,1,0,Spring2018
5,900 Block Abernethy,8,E,AT,0,0,0,0,Spring2018
6,Abernethy & Barclay,9,N,NS,0,0,0,0,Spring2018
7,Abernethy & Barclay,10,S,OP,1,1,2,0,Spring2018
8,Abernethy & Beatrice,11,E,FS,0,1,1,0,Spring2018
9,Abernethy & Center,12,W,NS,1,0,1,0,Spring2018
10,Abernethy & Duniway,13,N,NS,0,0,0,1,Spring2018
11,Abernethy & Duniway,14,S,OP,0,0,0,1,Spring2018
12,Abernethy & Portland Ave,16,W,FS,5,3,8,0,Spring2018
13,Abernethy & Portland Ave,17,E,NS,4,5,9,1,Spring2018
14,2800 Block NE 92nd,20,N,AT,0,0,0,0,Spring2018
15,2800 Block NE 92nd,21,S,AT,0,0,0,0,Spring2018
16,3400 Block NE 92nd,25,N,AT,3,7,10,0,Spring2018
17,NE 92nd & Hill,26,S,NS,5,1,6,4,Spring2018
18,N Adair & 7th,27,W,FS,4,15,19,2,Spring2018
19,2200 Block Baseline,28,W,AT,48,72,120,33,Spring2018
20,N Adair & 10th,30,W,NS,29,68,97,9,Spring2018
21,N Adair & 12th,31,W,NS,17,53,70,5,Spring2018
22,N Adair & 14th,32,W,NS,26,48,74,2,Spring2018
23,N Adair & 17th,33,W,FS,10,15,25,2,Spring2018
24,N Adair & 20th,34,W,FS,25,39,64,3,Spring2018
25,N Adair & 4th,35,W,FS,61,138,199,59,Spring2018
26,N Trenton & Alaska,40,E,NS,66,20,86,46,Spring2018
27,N Alaska & Chautauqua,41,E,NS,40,10,50,1,Spring2018
28,N Alaska & Chautauqua Pl,42,E,OP,38,16,54,6,Spring2018
29,N Alaska & Chautauqua Pl,43,W,NS,17,34,51,4,Spring2018
30,N Alaska & Foss,44,E,OP,19,16,35,19,Spring2018
31,N Alaska & University Park,45,W,OP,10,30,40,15,Spring2018
32,NE Alberta & M L King,46,E,FS,116,45,161,9,Spring2018
33,NE Alberta & 11th,48,E,NS,14,14,28,2,Spring2018
34,NE Alberta & 11th,49,W,NS,11,14,25,4,Spring2018
35,NE Alberta & 13th,50,E,NS,27,17,44,21,Spring2018
36,NE Alberta & 13th,51,W,NS,19,19,38,19,Spring2018
37,NE Alberta & 15th,52,E,NS,90,103,193,23,Spring2018
38,NE Alberta & 15th,53,W,NS,92,94,186,14,Spring2018
39,NE Alberta & 18th,54,E,NS,32,36,68,4,Spring2018
40,NE Alberta & 18th,55,W,NS,32,29,61,3,Spring2018
41,NE Alberta & 24th,60,E,NS,28,30,58,4,Spring2018
42,NE Alberta & 24th,61,W,NS,30,30,60,1,Spring2018
43,NE Alberta & 27th,63,E,NS,46,48,94,6,Spring2018
44,NE Alberta & 27th,64,W,NS,55,45,100,29,Spring2018
45,SE Alberta & 70th,67,E,OP,8,11,19,6,Spring2018
46,SE Alberta & 70th,68,W,NS,6,7,13,5,Spring2018
53,NE Alberta & 9th,69,E,NS,48,33,81,17,Spring2018
54,NE Alberta & 9th,70,W,NS,33,41,74,17,Spring2018
55,N Albina & Ainsworth,71,N,FS,17,39,56,2,Spring2018
56,N Albina & Ainsworth,72,S,NS,49,24,73,4,Spring2018
57,N Albina & Alberta,73,N,NS,22,54,76,17,Spring2018
58,N Albina & Alberta,74,S,FS,60,22,82,9,Spring2018
59,N Albina & Blandena,76,N,FS,22,56,78,54,Spring2018
60,N Albina & Blandena,77,S,FS,65,24,89,56,Spring2018
61,N Albina & Bryant,78,N,NS,10,24,34,2,Spring2018
62,N Albina & Bryant,79,S,NS,32,11,43,1,Spring2018
63,N Albina & Buffalo,80,N,NS,2,14,16,0,Spring2018
64,N Albina & Buffalo,81,S,NS,19,4,23,0,Spring2018
65,N Albina & Dekum,82,N,NS,10,21,31,10,Spring2018
66,N Albina & Dekum,83,S,NS,28,16,44,33,Spring2018
67,N Albina & Holman,84,N,OP,3,10,13,0,Spring2018
68,N Albina & Killingsworth,88,N,FS,255,299,554,85,Spring2018
69,N Albina & Killingsworth,89,S,FS,317,241,558,72,Spring2018
70,N Albina & Lombard St,90,S,FS,71,23,94,5,Spring2018
71,N Albina & Rosa Parks Way,91,N,FS,19,31,50,3,Spring2018
72,N Albina & Rosa Parks Way,92,S,FS,39,19,58,2,Spring2018
73,N Albina & Lombard St,93,N,NS,10,62,72,5,Spring2018
74,N Albina & Sumner,94,N,NS,52,53,105,3,Spring2018
75,N Albina & Sumner,95,S,NS,59,62,121,1,Spring2018
76,SW Allen & Dale,99,E,NS,6,1,7,0,Spring2018
77,SW Allen & Erickson,100,E,NS,32,10,42,12,Spring2018
78,SW Allen & Erickson,101,W,FS,11,28,39,12,Spring2018
79,SW Allen & Hall,102,E,NS,11,51,62,9,Spring2018
80,SW Allen & Hall,103,W,NS,36,20,56,2,Spring2018
81,SW Allen & Menlo,104,E,NS,25,7,32,0,Spring2018
82,SW Allen & Menlo,105,W,NS,8,25,33,1,Spring2018
83,SW Allen & Murray,106,E,FS,29,4,33,8,Spring2018
84,SW Allen & Taralynn,108,W,FS,2,10,12,2,Spring2018
85,SW Allen & Wilson,111,E,NS,15,5,20,0,Spring2018
86,SW Allen & Wilson,112,W,OP,6,13,19,1,Spring2018
87,SW Allen & 141st,113,E,OP,21,3,24,0,Spring2018
88,SW Allen & 141st,114,W,NS,2,21,23,2,Spring2018
89,N Anchor & Channel,115,E,NS,259,183,442,34,Spring2018
90,NE 21st & Argyle,118,S,FS,18,0,18,0,Spring2018
91,W Arlington & Barton,121,E,NS,31,7,38,5,Spring2018
92,W Arlington & Barton,122,W,NS,0,5,5,0,Spring2018
93,W Arlington & Beatrice,123,E,NS,1,0,1,0,Spring2018
94,W Arlington & Beatrice,124,W,NS,0,1,1,0,Spring2018
95,W Arlington & Bellevue,125,E,NS,0,2,2,0,Spring2018
96,W Arlington & Bellevue,126,W,NS,0,0,0,0,Spring2018
97,E Arlington & Cornell,131,E,NS,2,2,4,0,Spring2018
98,E Arlington & Cornell,132,W,NS,2,1,3,0,Spring2018
99,E Arlington & Harvard,133,E,NS,1,0,1,0,Spring2018
106,E Arlington & Harvard,134,W,NS,0,0,0,0,Spring2018
107,W Arlington & McLoughlin,135,W,NS,3,31,34,5,Spring2018
108,W Arlington & Portland Ave,136,E,NS,6,4,10,1,Spring2018
109,E Arlington & Portland Ave,137,W,NS,2,2,4,1,Spring2018
110,E Arlington & 82nd Dr,140,E,NS,6,6,12,0,Spring2018
111,82nd Dr & E Berkeley,141,S,FS,3,5,8,0,Spring2018
112,SW Arthur & 1st,142,E,NS,31,53,84,30,Spring2018
113,SW Arthur & 1st,143,W,NS,87,66,153,22,Spring2018
114,19th & B St,146,E,FS,263,178,441,38,Spring2018
115,B Ave & Second St,147,W,NS,17,28,45,1,Spring2018
116,10100 Block SW Barbur,150,E,AT,15,18,33,2,Spring2018
117,10700 Block SW Barbur,152,S,AT,2,4,6,0,Spring2018
118,11100 Block SW Barbur,153,W,AT,0,0,0,0,Spring2018
119,11100 Block SW Barbur,154,E,OP,2,1,3,0,Spring2018
120,4900 Block SW Barbur,155,S,OP,58,68,126,4,Spring2018
121,4900 Block SW Barbur,156,N,AT,71,54,125,2,Spring2018
122,SW Barbur & 26th Ave,159,E,OP,42,6,48,4,Spring2018
123,9500 Block SW Barbur,160,E,AT,11,5,16,0,Spring2018
124,SW Barbur & Alice,162,E,FS,23,7,30,2,Spring2018
125,SW Barbur & Alice,163,W,NS,6,21,27,0,Spring2018
126,SW Barbur & Taylors Ferry,164,W,NS,5,16,21,1,Spring2018
127,SW Barbur & Barbur Ct,165,W,OP,8,34,42,5,Spring2018
128,SW Barbur & Capitol Hwy,168,E,NS,64,43,107,4,Spring2018
129,SW Barbur & Capitol Hill,170,S,FS,40,135,175,18,Spring2018
130,SW Barbur & Hamilton,172,N,FS,129,90,219,9,Spring2018
131,SW Barbur & Hamilton,173,W,NS,86,151,237,7,Spring2018
132,SW Barbur & Hooker,174,N,NS,28,19,47,1,Spring2018
133,SW Barbur & Hooker,175,S,NS,27,33,60,2,Spring2018
134,SW Barbur & Lane,176,S,NS,8,22,30,1,Spring2018
135,SW Barbur & Lane,177,N,OP,28,15,43,0,Spring2018
136,SW Barbur & Luradel,178,S,OP,17,53,70,3,Spring2018
137,SW Barbur & Luradel,179,N,FS,49,21,70,2,Spring2018
138,SW Barbur & Moss,180,N,NS,18,6,24,0,Spring2018
139,SW Barbur & Parkhill Dr,181,S,FS,0,2,2,0,Spring2018
140,SW Barbur & Parkhill,182,N,FS,3,1,4,0,Spring2018
141,11200 Block SW Barbur,183,E,AT,15,5,20,1,Spring2018
142,11200 Block SW Barbur,184,W,OP,4,12,16,0,Spring2018
143,SW Barbur & Pennoyer,185,S,OP,5,7,12,0,Spring2018
144,SW Barbur & Pennoyer,186,N,FS,11,6,17,0,Spring2018
145,SW Barbur & Primrose,187,W,NS,18,64,82,13,Spring2018
146,SW Barbur & Capitol Hwy,188,S,FS,2,9,11,0,Spring2018
147,SW Barbur & Slavin/Capitol Hwy,189,N,OP,6,3,9,0,Spring2018
148,SW Barbur & Terwilliger,191,W,FS,31,68,99,4,Spring2018
149,SW Barbur & Terwilliger,193,E,FS,70,18,88,2,Spring2018
150,8900 Block SW Barbur,194,W,AT,4,35,39,7,Spring2018
151,SW Barbur & Whitaker,195,N,FS,18,23,41,0,Spring2018
152,SW Barbur & Whitaker,196,S,OP,29,20,49,0,Spring2018
159,SW Barbur & Woods,197,N,NS,7,5,12,0,Spring2018
160,SW Barbur & Woods,198,S,OP,5,8,13,0,Spring2018
161,SW Barbur & Bertha,199,W,FS,130,216,346,28,Spring2018
162,SW Barbur & 13th,200,W,FS,15,27,42,2,Spring2018
163,SW Barbur & Evans,201,S,NS,2,20,22,2,Spring2018
164,SW Barbur & 19th,202,E,NS,110,36,146,13,Spring2018
165,SW Barbur & 2nd,203,N,NS,49,5,54,2,Spring2018
166,SW Barbur & 3rd,207,W,NS,10,58,68,1,Spring2018
167,SW Barbur & 30th,208,E,FS,94,16,110,23,Spring2018
168,SW Barbur & 53rd,209,W,NS,12,15,27,1,Spring2018
169,SW Barbur & 53rd,210,E,FS,17,12,29,1,Spring2018
170,SW Pacific Hwy & 64th,211,E,NS,47,23,70,0,Spring2018
171,Barbur Transit Center,212,E,AT,563,55,618,11,Spring2018
172,12200 Block NW Barnes,227,S,AT,39,7,46,1,Spring2018
173,NW Barnes & Saltzman,228,N,AT,11,15,26,10,Spring2018
174,7600 Block SW Barnes,229,E,FS,25,8,33,0,Spring2018
175,8200 Block SW Barnes (Art School),230,E,OP,5,6,11,0,Spring2018
176,8200 Block SW Barnes (Art School),231,W,AT,8,6,14,0,Spring2018
177,9300 Block SW Barnes,233,E,AT,6,6,12,2,Spring2018
178,12400 Block NW Barnes,234,N,OP,13,31,44,0,Spring2018
179,8800 Block SW Barnes (Catlin Gabel School),235,W,NS,2,11,13,0,Spring2018
180,SW Barnes & Leahy,236,E,NS,90,15,105,1,Spring2018
181,SW Barnes & Leahy,237,W,NS,11,85,96,1,Spring2018
182,SW Barnes & Miller,238,E,FS,33,21,54,0,Spring2018
183,SW Barnes & Miller,239,W,FS,20,50,70,1,Spring2018
184,SW Barnes & Monterey/St Vincent Hosp Dr,240,W,NS,1,3,4,0,Spring2018
185,SW Barnes & Monterey,241,E,NS,4,1,5,0,Spring2018
186,SW Barnes & W Stark,247,E,FS,24,8,32,0,Spring2018
187,SW Barnes & 70th,251,E,OP,4,1,5,0,Spring2018
188,SW Barnes & 70th,252,W,FS,1,9,10,0,Spring2018
189,SW Barnes & 84th,253,W,FS,4,5,9,0,Spring2018
190,SW Barnes & 88th,255,E,NS,13,3,16,0,Spring2018
191,E Baseline & Valley View,256,E,OP,6,1,7,1,Spring2018
192,SE Tualatin Valley Hwy & 44th,257,W,NS,36,17,53,93,Spring2018
193,700 Block Baseline,258,E,AT,13,4,17,1,Spring2018
194,SW Baseline & Adams,259,W,NS,80,11,91,18,Spring2018
195,E Main & NE Brookwood,260,W,FS,6,12,18,1,Spring2018
196,E Main & SE Brookwood,261,E,NS,15,6,21,0,Spring2018
197,Baseline St & S 26th,263,E,NS,41,11,52,12,Spring2018
198,SW Baseline St & 17th,264,W,OP,27,44,71,11,Spring2018
199,W Baseline Rd & SW Lisa,265,W,FS,2,0,2,0,Spring2018
200,2200 Block Baseline,267,E,AT,43,26,69,17,Spring2018
201,1000 Block SW Baseline St,268,W,AT,18,58,76,13,Spring2018
202,W Baseline Rd & SW Willow Creek Dr,269,E,NS,0,18,18,1,Spring2018
203,Baseline St & S 1st,270,E,FS,21,19,40,2,Spring2018
204,Baseline St & S 10th,271,E,NS,17,20,37,3,Spring2018
205,Baseline St & S 12th,272,E,FS,111,27,138,12,Spring2018
212,Baseline St & S 14th,273,E,NS,40,32,72,4,Spring2018
213,W Baseline Rd & SW 185th,275,W,FS,4,0,4,0,Spring2018
214,Baseline & S 20th,277,E,NS,51,40,91,8,Spring2018
215,W Baseline Rd & SW 194th,278,E,FS,0,2,2,0,Spring2018
216,W Baseline Rd & SW 195th,279,W,NS,2,0,2,0,Spring2018
217,SE Baseline St & 2nd,280,W,NS,122,164,286,39,Spring2018
218,Baseline St & N 26th,284,W,FS,7,35,42,10,Spring2018
219,Baseline St & N 29th/Hobbs,285,E,OP,11,5,16,0,Spring2018
220,Baseline St & N 29th/Hobbs,286,W,FS,6,15,21,0,Spring2018
221,Baseline St & N 31st,287,W,FS,3,7,10,3,Spring2018
222,E Main & NE 32nd,288,W,NS,4,12,16,2,Spring2018
223,SW Baseline & 331st,290,W,OP,1,2,3,0,Spring2018
224,SW Baseline & 331st,291,E,FS,2,1,3,1,Spring2018
225,SW Baseline & NW 334th,292,W,FS,1,5,6,0,Spring2018
226,SW Baseline & NW 334th,293,E,OP,4,1,5,0,Spring2018
227,Baseline & NW 338th,296,W,FS,1,3,4,0,Spring2018
228,Baseline & NW 338th,297,E,OP,2,3,5,0,Spring2018
229,Baseline St & Valley View,298,W,AT,2,9,11,0,Spring2018
230,SW Baseline & 345th,300,E,NS,10,4,14,4,Spring2018
231,E Main & NE 37th,301,W,NS,5,4,9,1,Spring2018
232,E Main & SE 37th,302,E,NS,5,5,10,1,Spring2018
233,Baseline St & S 4th,303,E,NS,110,34,144,40,Spring2018
234,SE Baseline St & 3rd,304,W,NS,80,104,184,8,Spring2018
235,E Main & NE 40th,305,W,NS,2,2,4,0,Spring2018
236,E Main & NE 40th,306,E,OP,5,3,8,0,Spring2018
237,SE Baseline St & 5th,307,W,NS,7,40,47,5,Spring2018
238,SE Baseline St & 7th,308,W,NS,37,69,106,28,Spring2018
239,SE Baseline St & 9th,310,W,NS,80,132,212,23,Spring2018
240,6200 Block N Basin,313,E,AT,2,0,2,0,Spring2018
241,6300 Block N Basin,314,N,AT,1,3,4,0,Spring2018
242,N Basin & Fathom,315,S,FS,6,0,6,0,Spring2018
243,6700 Block N Basin (Coast Guard),316,E,AT,8,5,13,0,Spring2018
244,N Basin & Emerson,317,S,OP,8,1,9,0,Spring2018
245,N Basin & Emerson,318,N,FS,3,12,15,0,Spring2018
246,N Basin & Ensign,319,S,NS,14,1,15,0,Spring2018
247,N Basin & Ensign,320,N,FS,18,49,67,0,Spring2018
248,N Basin & Fathom,321,N,NS,17,30,47,0,Spring2018
249,N Basin & Leverman,322,S,OP,7,1,8,0,Spring2018
250,N Basin & Pacific Pride,324,N,AT,1,12,13,0,Spring2018
251,2600 Block SW Beaverton-Hillsdale,325,E,AT,17,8,25,0,Spring2018
252,3600 Block SW Beaverton-Hillsdale,326,E,AT,8,3,11,0,Spring2018
253,3600 Block SW Beaverton-Hillsdale,327,W,OP,2,8,10,0,Spring2018
254,SW Beaverton-Hillsdale & 59th,328,E,OP,57,16,73,61,Spring2018
255,6100 Block SW Beaverton-Hillsdale,329,W,AT,28,44,72,18,Spring2018
256,7300 Block SW Beaverton-Hillsdale,331,E,OP,7,11,18,2,Spring2018
257,7400 Block SW Beaverton-Hillsdale,332,W,AT,8,16,24,1,Spring2018
258,7700 Block SW Beaverton-Hillsdale,333,E,AT,31,28,59,12,Spring2018
265,SW Beaverton-Hillsdale & Apple Way,335,E,NS,8,6,14,1,Spring2018
266,SW Beaverton-Hillsdale & Bertha,336,E,NS,12,3,15,5,Spring2018
267,SW Beaverton-Hillsdale & Dosch,340,W,NS,30,92,122,3,Spring2018
268,SW Beaverton-Hillsdale & Griffith,341,W,FS,18,56,74,32,Spring2018
269,SW Beaverton-Hillsdale & Griffith,342,E,NS,55,19,74,25,Spring2018
270,SW Beaverton-Hillsdale & Jamieson,343,W,OP,34,26,60,7,Spring2018
271,SW Beaverton-Hillsdale & Jamieson,344,E,FS,29,40,69,8,Spring2018
272,SW Beaverton-Hillsdale & White Pine Ln,345,E,FS,19,8,27,0,Spring2018
273,SW Beaverton-Hillsdale & Laurelwood,346,W,NS,12,23,35,0,Spring2018
274,SW Beaverton-Hillsdale & Laurelwood,347,E,NS,21,12,33,1,Spring2018
275,SW Beaverton-Hillsdale & Oleson,348,E,NS,138,48,186,17,Spring2018
276,SW Beaverton-Hillsdale & Poplar Ln,349,W,NS,5,3,8,1,Spring2018
277,SW Beaverton-Hillsdale & Oleson,350,W,NS,29,73,102,6,Spring2018
278,SW Beaverton-Hillsdale & Shattuck,351,E,NS,84,24,108,26,Spring2018
279,SW Beaverton-Hillsdale & Shattuck,352,W,FS,25,107,132,43,Spring2018
280,SW Beaverton-Hillsdale & Western,354,E,FS,17,39,56,15,Spring2018
281,SW Beaverton-Hillsdale & Western,355,W,OP,37,29,66,18,Spring2018
282,SW Beaverton-Hillsdale & White Pine Ln,356,W,NS,7,13,20,0,Spring2018
283,SW Beaverton-Hillsdale & 101st,357,E,FS,4,4,8,1,Spring2018
284,SW Beaverton-Hillsdale & 101st,358,W,NS,3,4,7,0,Spring2018
285,SW Beaverton- Hillsdale & 107th,359,W,NS,36,30,66,11,Spring2018
286,SW Beaverton-Hillsdale & 107th,360,E,NS,31,45,76,17,Spring2018
287,SW Beaverton-Hillsdale & 110th,361,W,NS,21,11,32,7,Spring2018
288,SW Beaverton-Hillsdale & 110th,362,E,OP,10,22,32,9,Spring2018
289,SW Beaverton-Hillsdale & 18th Dr,363,W,NS,58,64,122,9,Spring2018
290,SW Beaverton-Hillsdale & 25th,364,E,FS,14,5,19,0,Spring2018
291,SW Beaverton-Hillsdale & 25th,365,W,NS,9,30,39,0,Spring2018
292,2600 Block SW Beaverton-Hillsdale,366,W,FS,6,6,12,2,Spring2018
293,SW Beaverton-Hillsdale & 30th,367,E,NS,79,21,100,5,Spring2018
294,SW Beaverton-Hillsdale & 33rd,368,E,NS,33,12,45,6,Spring2018
295,SW Beaverton-Hillsdale & 35th,369,E,FS,28,9,37,0,Spring2018
296,SW Beaverton-Hillsdale & 35th,370,W,OP,16,29,45,3,Spring2018
297,SW Beaverton-Hillsdale & 39th Dr,371,E,OP,44,6,50,3,Spring2018
298,SW Beaverton-Hillsdale & 39th Dr,372,W,NS,5,45,50,0,Spring2018
299,SW Beaverton-Hillsdale & 42nd,373,E,FS,34,13,47,10,Spring2018
300,SW Beaverton-Hillsdale & 42nd,374,W,NS,12,36,48,11,Spring2018
301,SW Beaverton-Hillsdale & 45th,375,E,FS,62,21,83,6,Spring2018
302,SW Beaverton-Hillsdale & 45th,376,W,NS,23,69,92,2,Spring2018
303,SW Beaverton-Hillsdale & 50th,377,E,NS,21,4,25,0,Spring2018
304,SW Beaverton-Hillsdale & 50th,378,W,OP,3,15,18,0,Spring2018
305,SW Beaverton-Hillsdale & 56th,379,E,OP,38,13,51,2,Spring2018
306,SW Beaverton-Hillsdale & 56th,380,W,FS,12,41,53,3,Spring2018
307,SW Beaverton-Hillsdale & 59th,381,W,NS,16,43,59,55,Spring2018
308,SW Beaverton-Hillsdale & 62nd,382,E,FS,48,25,73,18,Spring2018
309,6500 Block SW Beaverton-Hillsdale,383,E,AT,31,15,46,6,Spring2018
310,SW Beaverton-Hillsdale & 65th,384,W,OP,20,42,62,8,Spring2018
311,SW Beaverton-Hillsdale & 78th,385,W,NS,39,33,72,4,Spring2018
318,SW Beaverton-Hillsdale & 78th,386,E,NS,23,22,45,1,Spring2018
319,SW Beaverton-Hillsdale & 91st,387,W,FS,22,24,46,4,Spring2018
320,SW Beaverton-Hillsdale & 91st,388,E,OP,27,20,47,5,Spring2018
321,SW Beaverton-Hillsdale & 99th,389,W,NS,10,12,22,2,Spring2018
322,SW Beaverton-Hillsdale & 99th,390,E,OP,9,7,16,2,Spring2018
323,SE Bell & Our Ct ,394,N,NS,6,13,19,35,Spring2018
324,SE Bell & Johnson Creek,395,N,NS,26,11,37,2,Spring2018
325,SE Bell & Johnson Creek,396,S,FS,13,25,38,3,Spring2018
326,SE Bell & Pierce ,397,N,NS,7,6,13,0,Spring2018
327,SE Bell & Jordan ,398,S,NS,5,9,14,1,Spring2018
328,SE Belmont & 11th,400,E,FS,121,151,272,39,Spring2018
329,SE Belmont & 14th,402,E,NS,37,70,107,16,Spring2018
330,SE Belmont & 17th,404,E,NS,15,58,73,4,Spring2018
331,SE Belmont & 20th,406,E,NS,32,104,136,3,Spring2018
332,SE Belmont & 23rd,408,E,NS,10,39,49,2,Spring2018
333,SE Belmont & 26th,410,W,NS,137,68,205,52,Spring2018
334,SE Belmont & 30th,417,W,FS,173,45,218,29,Spring2018
335,SE Belmont & 30th,418,E,FS,56,143,199,57,Spring2018
336,SE Belmont & 34th,422,E,FS,53,174,227,32,Spring2018
337,SE Belmont & 34th,423,W,FS,183,51,234,22,Spring2018
338,SE Belmont & 37th,425,E,FS,17,69,86,25,Spring2018
339,SE Belmont & 38th,426,W,FS,75,18,93,27,Spring2018
340,SE Belmont & Cesar Chavez Blvd,427,E,FS,100,184,284,58,Spring2018
341,SE Belmont & Cesar Chavez Blvd,428,W,NS,156,84,240,37,Spring2018
342,SE Belmont & 42nd,429,E,NS,17,82,99,3,Spring2018
343,SE Belmont & 42nd,430,W,FS,109,20,129,4,Spring2018
344,SE Belmont & 46th,435,W,NS,92,33,125,40,Spring2018
345,SE Belmont & 46th,436,E,OP,40,101,141,45,Spring2018
346,SE Belmont & 49th,439,E,NS,16,29,45,13,Spring2018
347,SE Belmont & 49th,440,W,NS,41,15,56,11,Spring2018
348,SE Belmont & 50th,442,E,FS,8,16,24,0,Spring2018
349,SE Belmont & 53rd,443,E,FS,4,23,27,1,Spring2018
350,SE Belmont & 53rd,444,W,NS,28,3,31,2,Spring2018
351,SE Belmont & 55th,445,E,NS,6,28,34,4,Spring2018
352,SE Belmont & 55th,446,W,NS,25,7,32,3,Spring2018
353,SE Belmont & 58th,448,E,OP,2,18,20,6,Spring2018
354,SE Belmont & 58th,449,W,NS,18,2,20,8,Spring2018
355,SE Belmont & 60th,450,E,FS,46,133,179,12,Spring2018
356,SE Belmont & 60th,451,W,NS,122,30,152,13,Spring2018
357,SE Belmont & 62nd,453,E,OP,3,6,9,3,Spring2018
358,SE Belmont & 62nd,454,W,FS,8,5,13,2,Spring2018
359,SE Belmont & 65th,456,E,OP,1,4,5,0,Spring2018
360,SE Belmont & 65th,457,W,NS,5,1,6,0,Spring2018
361,SE Belmont & 67th,459,E,NS,3,10,13,0,Spring2018
362,SE Belmont & 68th,460,W,NS,24,4,28,0,Spring2018
363,SE Belmont & 9th,465,E,NS,58,80,138,10,Spring2018
364,1400 Block SW Bertha ,467,E,AT,4,1,5,0,Spring2018
371,SW Binford Lake & Heiney,469,W,NS,1,4,5,0,Spring2018
372,SW Binford Lake & Towle,470,E,NS,3,0,3,0,Spring2018
373,SW Binford Lake & Towle,471,W,FS,0,2,2,0,Spring2018
374,11200 Block SW Boones Ferry Rd,492,N,AT,1,0,1,0,Spring2018
375,18200 Block SW Boones Ferry Rd,495,S,AT,1,21,22,0,Spring2018
376,18400 Block SW Boones Ferry Rd,496,N,AT,31,5,36,3,Spring2018
377,SW Boones Ferry Rd & Alsea,500,S,NS,2,6,8,0,Spring2018
378,SW Boones Ferry Rd & Apache,501,S,NS,1,5,6,0,Spring2018
379,SW Boones Ferry Rd & Apache,502,N,OP,1,0,1,0,Spring2018
380,SW Boones Ferry Rd & Arapaho,503,N,NS,2,0,2,0,Spring2018
381,SW Boones Ferry Rd & Arnold,506,S,FS,0,1,1,0,Spring2018
382,SW Boones Ferry Rd & Arnold,507,N,OP,2,0,2,0,Spring2018
383,SW Boones Ferry Rd & Blake,510,N,NS,7,0,7,0,Spring2018
384,Boones Ferry Rd & Bryant,512,N,FS,3,3,6,7,Spring2018
385,SW Lower Boones Ferry & Childs Rd,513,E,FS,3,1,4,0,Spring2018
386,SW Lower Boones Ferry & Childs Rd,514,W,OP,0,6,6,0,Spring2018
387,SW Boones Ferry Rd & Clara Ln,515,W,FS,0,5,5,0,Spring2018
388,SW Boones Ferry Rd & Colony Dr,516,S,OP,0,1,1,0,Spring2018
389,SW Boones Ferry Rd & Colony Dr,517,N,FS,1,0,1,0,Spring2018
390,SW Boones Ferry Rd & Coronado,520,S,FS,1,1,2,0,Spring2018
391,SW Boones Ferry Rd & Day,521,N,OP,3,0,3,1,Spring2018
392,SW Boones Ferry Rd & Day,522,S,FS,0,3,3,1,Spring2018
393,Boones Ferry Rd & Firwood,529,S,NS,1,3,4,6,Spring2018
394,SW Boones Ferry Rd & Ibach,530,S,FS,1,11,12,1,Spring2018
395,SW Boones Ferry Rd & Ibach,531,N,NS,8,0,8,0,Spring2018
396,SW Boones Ferry Rd & Greenhill Ln,533,S,OP,0,0,0,0,Spring2018
397,SW Boones Ferry Rd & Greenhill Ln,534,N,NS,0,0,0,0,Spring2018
398,SW Boones Ferry Rd & Killarney,535,S,NS,0,3,3,0,Spring2018
399,Boones Ferry Rd & Kruse Way Pl,536,S,FS,2,9,11,0,Spring2018
400,18000 Block SW Lower Boones Ferry,537,E,AT,16,3,19,2,Spring2018
401,Boones Ferry Rd & SW Madrona,538,N,OP,1,1,2,3,Spring2018
402,Boones Ferry Rd & SW Madrona,539,S,NS,0,1,1,0,Spring2018
403,SW Boones Ferry Rd & Norwood,542,S,OP,0,4,4,0,Spring2018
404,SW Boones Ferry Rd & Norwood,543,N,NS,4,0,4,0,Spring2018
405,SW Boones Ferry Rd & Palatine,545,N,FS,1,0,1,0,Spring2018
406,Boones Ferry Rd & Rainbow,553,S,OP,0,2,2,0,Spring2018
407,Boones Ferry Rd & Rainbow,554,N,FS,3,0,3,0,Spring2018
408,18000 Block SW Lower Boones Ferry,558,W,AT,3,16,19,3,Spring2018
409,SW Boones Ferry Rd & Siletz,562,N,NS,2,0,2,0,Spring2018
410,SW Boones Ferry Rd & Siletz,563,S,NS,0,2,2,0,Spring2018
411,Boones Ferry Rd & Spring Lane,564,N,NS,9,2,11,0,Spring2018
412,SW Boones Ferry Rd & Stephenson,565,N,OP,3,0,3,0,Spring2018
413,SW Boones Ferry Rd & Stephenson,566,W,FS,0,3,3,0,Spring2018
414,Boones Ferry Rd & Twin Fir,568,S,OP,1,2,3,0,Spring2018
415,Boones Ferry Rd & Twin Fir,569,N,FS,2,1,3,0,Spring2018
416,SW Lower Boones Ferry & Boones Ferry,570,E,FS,5,1,6,0,Spring2018
417,Boones Ferry Rd & West Sunset Dr,576,S,NS,0,0,0,0,Spring2018
424,Boones Ferry Rd & West Sunset Dr,577,N,OP,0,0,0,0,Spring2018
425,SW Boones Ferry Rd & 19th,580,E,FS,2,0,2,0,Spring2018
426,SW Boones Ferry Rd & 22nd,581,S,OP,0,4,4,0,Spring2018
427,SW Boones Ferry Rd & 4th,583,W,OP,0,1,1,0,Spring2018
428,SW Boones Ferry Rd & 4th,584,E,FS,1,0,1,0,Spring2018
429,SW Laurelwood & Brentwood,593,N,NS,0,0,0,0,Spring2018
430,SW Brentwood & 78th,595,E,NS,1,0,1,0,Spring2018
431,NW Bridge Ave & St Helens,596,N,NS,0,3,3,0,Spring2018
432,NW Bridge Ave & Germantown,597,N,OP,0,0,0,0,Spring2018
433,NW Bridge Ave & Germantown,598,S,NS,0,0,0,0,Spring2018
434,NW Bridge Ave & Springville,599,N,OP,0,3,3,0,Spring2018
435,NW Bridge Ave & Springville,600,S,NS,5,0,5,0,Spring2018
436,NE Broadway & Grand,605,W,NS,6,25,31,18,Spring2018
437,SW Broadway & Hall,607,S,FS,3,7,10,0,Spring2018
438,N Broadway & Benton,611,E,FS,6,17,23,3,Spring2018
439,SW Broadway & Lincoln,614,S,NS,0,0,0,0,Spring2018
440,SW Broadway & Market,616,S,FS,2,29,31,13,Spring2018
441,NE Broadway & M L King,622,W,FS,32,13,45,14,Spring2018
442,NW Broadway & Irving,625,N,NS,73,70,143,48,Spring2018
443,N Broadway & Vancouver,627,W,NS,11,27,38,30,Spring2018
444,NE Broadway & 12th,629,W,NS,164,119,283,192,Spring2018
445,NE Broadway & 16th,631,W,FS,106,58,164,50,Spring2018
446,NE Broadway & 2nd,633,W,NS,12,8,20,5,Spring2018
447,NE Broadway & 21st,634,W,FS,110,34,144,54,Spring2018
448,NE Broadway & 24th,635,W,FS,123,64,187,54,Spring2018
449,NE Broadway & 26th,636,E,FS,20,31,51,20,Spring2018
450,NE Broadway & 26th,637,W,FS,25,16,41,9,Spring2018
451,NE Broadway & 28th,638,E,FS,54,81,135,53,Spring2018
452,NE Broadway & 28th,639,W,NS,82,61,143,47,Spring2018
453,NE Broadway & 32nd,642,E,FS,68,80,148,34,Spring2018
454,NE Broadway & 33rd,644,W,FS,84,69,153,31,Spring2018
455,NE Broadway & 35th,646,E,FS,8,8,16,2,Spring2018
456,NE Broadway & 35th,647,W,NS,11,10,21,8,Spring2018
457,NE Broadway & 37th,648,E,NS,6,19,25,10,Spring2018
458,NE Broadway & 37th,649,W,NS,23,4,27,9,Spring2018
459,NE Broadway & 44th,650,W,NS,38,29,67,45,Spring2018
460,NE Broadway & 44th,651,E,FS,31,42,73,94,Spring2018
461,NE Broadway & 47th,653,E,NS,5,12,17,1,Spring2018
462,SW Broadway & 5th,654,W,NS,11,133,144,5,Spring2018
463,NE Broadway & 7th,655,W,NS,20,8,28,10,Spring2018
464,NE Broadway & 9th,656,W,NS,45,15,60,67,Spring2018
465,Bryant & Black Forest Ct,663,N,OP,0,0,0,0,Spring2018
466,Bryant & Chapman Way,664,N,FS,1,0,1,0,Spring2018
467,Bryant & Lakeview,665,N,NS,1,1,2,0,Spring2018
468,17500 Block Bryant,667,S,AT,0,1,1,0,Spring2018
469,Bryant & Lords Ln,668,N,NS,0,0,0,0,Spring2018
470,Bryant & Wildwood,669,S,FS,0,0,0,0,Spring2018
477,Kerr & Jefferson Pkwy,672,S,NS,8,7,15,0,Spring2018
478,4600 Block W Burnside,682,W,AT,0,2,2,0,Spring2018
479,W Burnside & SW Fischer Ln,685,E,NS,2,0,2,0,Spring2018
480,W Burnside & NW Barnes,686,N,OP,11,2,13,1,Spring2018
481,W Burnside & NW Barnes,687,W,FS,1,13,14,0,Spring2018
482,W Burnside & Burnside Bridge,689,W,AT,87,345,432,138,Spring2018
483,W Burnside & Mt. Calvary Cemetery,690,E,AT,4,2,6,0,Spring2018
484,W Burnside & Mt Calvary Cemetery,691,W,AT,0,6,6,0,Spring2018
485,9100 Block E Burnside,696,E,OP,8,22,30,1,Spring2018
486,9100 Block E Burnside,697,W,AT,24,9,33,3,Spring2018
487,E Burnside & SE Floral,701,E,NS,4,9,13,3,Spring2018
488,E Burnside & NE Floral,702,W,NS,5,4,9,0,Spring2018
489,E Burnside & NE Grand,704,E,NS,328,362,690,115,Spring2018
490,W Burnside & NW Hermosa,706,E,OP,2,0,2,0,Spring2018
491,W Burnside & NW Hermosa,707,W,FS,1,3,4,0,Spring2018
492,E Burnside & SE Laurelhurst,710,E,NS,1,8,9,0,Spring2018
493,E Burnside & NE Laurelhurst,711,W,NS,6,3,9,0,Spring2018
494,W Burnside & SW Tichner,712,E,FS,9,2,11,13,Spring2018
495,W Burnside & NW Macleay,713,W,FS,4,13,17,18,Spring2018
496,W Burnside & SW 8th,715,E,NS,75,95,170,72,Spring2018
497,W Burnside & NW Park,716,W,NS,140,85,225,76,Spring2018
498,W Burnside & SW St Clair,718,E,NS,275,82,357,61,Spring2018
499,W Burnside & SW 13th,723,E,NS,144,80,224,80,Spring2018
500,W Burnside & SW 15th,725,E,NS,40,7,47,6,Spring2018
501,E Burnside & SE 16th,726,E,FS,31,56,87,5,Spring2018
502,E Burnside & NE 18th,730,W,NS,32,17,49,7,Spring2018
503,W Burnside & NW 19th,735,W,NS,101,192,293,87,Spring2018
504,E Burnside & SE 20th,740,E,NS,59,102,161,25,Spring2018
505,W Burnside & NW 20th Pl,742,W,NS,169,404,573,198,Spring2018
506,W Burnside & NW King,747,W,NS,36,122,158,61,Spring2018
507,W Burnside & SW 21st,749,E,NS,169,50,219,35,Spring2018
508,W Burnside & NW 23rd,755,W,NS,82,350,432,101,Spring2018
509,E Burnside & SE 24th,759,E,FS,52,86,138,5,Spring2018
510,E Burnside & NE 24th,760,W,FS,84,37,121,2,Spring2018
511,E Burnside & SE 28th,763,E,NS,96,158,254,18,Spring2018
512,E Burnside & NE 28th,764,W,FS,165,91,256,16,Spring2018
513,E Burnside & NE 32nd,768,W,FS,44,29,73,4,Spring2018
514,E Burnside & SE 32nd,769,E,NS,29,51,80,3,Spring2018
515,E Burnside & SE Cesar Chavez Blvd,770,E,NS,89,109,198,30,Spring2018
516,E Burnside & NE Cesar Chavez Blvd,771,W,NS,82,95,177,25,Spring2018
517,E Burnside & SE 41st,774,E,NS,3,10,13,0,Spring2018
518,E Burnside & NE 41st,775,W,NS,7,4,11,1,Spring2018
519,E Burnside & SE 44th,776,E,NS,5,11,16,0,Spring2018
520,E Burnside & NE 44th,777,W,NS,12,3,15,0,Spring2018
521,E Burnside & NE 47th,778,W,NS,34,19,53,7,Spring2018
522,E Burnside & SE 47th,779,E,FS,15,36,51,6,Spring2018
523,W Burnside & NW 48th Ave,780,W,NS,1,6,7,0,Spring2018
530,W Burnside & SW 48th Dr,781,E,FS,5,1,6,0,Spring2018
531,W Burnside & NW 5th,782,W,FS,372,389,761,179,Spring2018
532,E Burnside & NE 52nd,785,W,NS,52,12,64,1,Spring2018
533,E Burnside & SE 52nd,786,E,FS,13,42,55,1,Spring2018
534,E Burnside & SE 55th,787,E,FS,25,45,70,9,Spring2018
535,E Burnside & NE 55th,788,W,NS,39,20,59,8,Spring2018
536,E Burnside & NE 58th,791,W,NS,15,2,17,1,Spring2018
537,W Burnside & SW 6th,792,E,NS,784,476,1260,285,Spring2018
538,E Burnside & SE 60th,793,E,NS,56,70,126,19,Spring2018
539,E Burnside & NE 60th,794,W,NS,69,51,120,17,Spring2018
540,E Burnside & NE 62nd,796,W,NS,15,5,20,0,Spring2018
541,E Burnside & SE 67th,799,E,OP,4,15,19,0,Spring2018
542,E Burnside & NE 67th,800,W,NS,17,8,25,0,Spring2018
543,E Burnside & NE 69th,801,W,NS,11,4,15,0,Spring2018
544,E Burnside & SE 72nd,806,E,NS,5,15,20,1,Spring2018
545,E Burnside & NE 72nd,807,W,NS,18,7,25,1,Spring2018
546,E Burnside & SE 74th,808,E,NS,8,19,27,1,Spring2018
547,E Burnside & NE 74th,809,W,NS,21,10,31,1,Spring2018
548,E Burnside & NE 79th,811,W,NS,48,13,61,8,Spring2018
549,E Burnside & SE 79th,812,E,NS,9,33,42,2,Spring2018
550,E Burnside & SE 82nd,813,E,NS,226,159,385,68,Spring2018
551,E Burnside & NE 82nd,814,W,NS,120,230,350,75,Spring2018
552,E Burnside & SE 87th,817,E,NS,8,25,33,6,Spring2018
553,E Burnside & NE 87th,818,W,NS,20,6,26,5,Spring2018
554,E Burnside & SE 8th,820,E,NS,110,153,263,14,Spring2018
555,E Burnside & SE 94th,822,E,FS,9,14,23,6,Spring2018
556,E Burnside & NE 94th,823,W,NS,13,11,24,9,Spring2018
557,S Buxton & SW Cherry Park,830,N,FS,0,3,3,0,Spring2018
558,S Buxton & SW Cherry Park,831,S,NS,4,0,4,1,Spring2018
559,Buxton & E Columbia River Hwy,832,N,NS,5,16,21,1,Spring2018
560,S Buxton & SW Martine,833,S,NS,1,0,1,0,Spring2018
561,S Buxton & SE 6th,836,N,NS,0,0,0,0,Spring2018
562,S Buxton & SE 8th,837,N,NS,0,1,1,1,Spring2018
563,SE Bybee & Milwaukie,838,W,NS,83,62,145,22,Spring2018
564,SE Bybee & Milwaukie,839,E,NS,10,16,26,3,Spring2018
565,SE Bybee & 14th,843,W,NS,2,2,4,1,Spring2018
566,SE Bybee & 14th,844,E,FS,2,2,4,2,Spring2018
567,SE Bybee & 17th,845,E,NS,56,55,111,14,Spring2018
568,SE Bybee & 18th,846,W,NS,6,4,10,0,Spring2018
569,SE Bybee & 19th,847,E,NS,3,7,10,0,Spring2018
570,SE Bybee & 20th,848,W,NS,8,2,10,0,Spring2018
571,SE Bybee & 22nd,852,E,FS,7,10,17,13,Spring2018
572,SE Bybee & 22nd,853,W,NS,6,4,10,14,Spring2018
573,SE Bybee & 23rd,855,W,NS,2,8,10,15,Spring2018
574,SE Bybee & 27th,858,E,FS,5,7,12,1,Spring2018
575,2400 Block SE Bybee,859,W,AT,3,5,8,1,Spring2018
576,SE Bybee & 28th,860,S,NS,0,1,1,0,Spring2018
583,4600 Block SW Cameron,861,E,AT,0,1,1,0,Spring2018
584,SW Cameron & Fairvale Ct,862,E,NS,3,4,7,0,Spring2018
585,SW Cameron & Shattuck,863,E,FS,2,2,4,0,Spring2018
586,SW Cameron & 53rd,865,E,NS,8,6,14,0,Spring2018
587,SW Campus Dr & OHSU Garage F,868,E,OP,26,8,34,4,Spring2018
588,SW Campus Dr & Terwilliger,870,E,NS,23,2,25,1,Spring2018
589,SW Campus Dr & Loading Dock 5,871,W,AT,99,8,107,2,Spring2018
590,7500 Block SW Canyon,882,W,AT,1,7,8,0,Spring2018
591,SW Canyon & Canyon Dr,883,W,OP,5,28,33,0,Spring2018
592,SW Canyon & Benz Park,885,W,NS,1,3,4,0,Spring2018
593,SW Canyon & Copel,890,W,NS,0,3,3,0,Spring2018
594,SW Canyon & Jade,892,N,FS,4,0,4,0,Spring2018
595,SW Canyon & Linden,893,E,OP,2,0,2,0,Spring2018
596,Hwy 26 On Ramp & SW Skyline,894,E,FS,42,17,59,17,Spring2018
597,Hwy 26/Canyon Rd Ramp & SW Skyline,895,W,FS,15,51,66,14,Spring2018
598,SW Canyon & Walker,898,W,FS,22,23,45,4,Spring2018
599,SW Canyon & Walker,899,E,OP,16,22,38,3,Spring2018
600,SW Canyon & 104th,904,W,NS,10,9,19,1,Spring2018
601,SW Canyon & 107th,906,E,NS,33,24,57,12,Spring2018
602,SW Canyon & 107th,907,W,NS,24,27,51,4,Spring2018
603,SW Canyon & 110th,908,E,NS,7,8,15,1,Spring2018
604,SW Canyon & 110th,909,W,FS,5,7,12,1,Spring2018
605,SW Canyon & 115th,910,W,NS,4,26,30,21,Spring2018
606,SW Canyon & 73rd,912,E,NS,5,0,5,0,Spring2018
607,SW Canyon & 87th,913,E,FS,62,27,89,6,Spring2018
608,SW Canyon & 87th,914,W,FS,24,27,51,1,Spring2018
609,SW Canyon & 91st,915,E,NS,9,7,16,7,Spring2018
610,SW Canyon & 93rd,917,W,OP,1,3,4,0,Spring2018
611,SW Canyon & 93rd,918,E,NS,1,1,2,0,Spring2018
612,SW Canyon & 96th,919,W,OP,1,3,4,0,Spring2018
613,SW Canyon & 96th,920,E,NS,5,2,7,0,Spring2018
614,SW Capitol & Alice,921,S,NS,2,6,8,0,Spring2018
615,SW Capitol & Alice,922,N,NS,6,2,8,0,Spring2018
616,SW Capitol & Barbur,923,N,NS,71,39,110,4,Spring2018
617,SW Capitol & Bertha Ct,925,E,FS,121,116,237,14,Spring2018
618,9500 Block SW Capitol,926,S,OP,1,9,10,0,Spring2018
619,SW Capitol & Carson,927,S,NS,1,9,10,4,Spring2018
620,SW Capitol & Sunset,929,E,OP,323,406,729,33,Spring2018
621,SW Capitol & Taylors Ferry,930,S,NS,7,49,56,19,Spring2018
622,SW Capitol & Dickinson,931,S,FS,2,33,35,8,Spring2018
623,SW Capitol & Dickinson,932,N,NS,31,3,34,9,Spring2018
624,SW Capitol & Dolph,933,S,OP,1,11,12,2,Spring2018
625,SW Capitol & Dolph,934,N,FS,11,1,12,2,Spring2018
626,SW Capitol & Florida,935,S,FS,7,24,31,2,Spring2018
627,SW Capitol & Galeburn,936,S,OP,6,46,52,3,Spring2018
628,SW Capitol & Galeburn,937,N,NS,30,7,37,1,Spring2018
629,SW Capitol & Garden Home,939,N,OP,18,6,24,0,Spring2018
636,SW Capitol & Idaho,942,N,NS,26,3,29,0,Spring2018
637,SW Capitol & Idaho,943,W,FS,4,25,29,0,Spring2018
638,SW Capitol & Marigold,946,N,FS,15,2,17,0,Spring2018
639,SW Capitol & Marigold,947,S,FS,0,11,11,0,Spring2018
640,SW Capitol & Miles,948,N,NS,24,4,28,0,Spring2018
641,SW Capitol & Miles,949,S,FS,3,30,33,1,Spring2018
642,SW Capitol & Pomona,951,S,FS,2,41,43,1,Spring2018
643,SW Capitol & Pomona,952,N,NS,41,3,44,2,Spring2018
644,SW Capitol & Sunset,955,W,NS,376,345,721,30,Spring2018
645,SW Capitol & Terwilliger,956,E,NS,12,15,27,0,Spring2018
646,SW Capitol & Terwilliger,957,W,FS,13,16,29,1,Spring2018
647,SW Capitol & Texas,958,S,FS,0,13,13,1,Spring2018
648,SW Capitol & California,959,N,NS,10,9,19,1,Spring2018
649,SW Capitol & Nebraska,963,E,FS,26,2,28,0,Spring2018
650,SW Capitol & Nebraska,964,W,OP,17,37,54,3,Spring2018
651,SW Capitol & 26th,965,E,FS,97,21,118,7,Spring2018
652,SW Capitol & 26th,966,W,FS,28,112,140,16,Spring2018
653,SW Capitol & 33rd,970,W,NS,12,93,105,6,Spring2018
654,SW Capitol & 33rd,971,E,OP,88,12,100,4,Spring2018
655,SW Capitol & 35th,972,E,NS,124,40,164,18,Spring2018
656,SW Capitol & Brugger,975,E,NS,6,0,6,0,Spring2018
657,8600 Block SE Causey,984,W,AT,22,10,32,6,Spring2018
658,8800 Block SE Causey,987,E,OP,7,19,26,5,Spring2018
659,SE Causey & 82nd,989,W,NS,17,10,27,9,Spring2018
660,SW Cedar Hills & Butner,993,S,FS,11,21,32,1,Spring2018
661,3300 Block SW Cedar Hills,995,N,AT,4,12,16,4,Spring2018
662,SW Cedar Hills & Butner,996,N,NS,24,10,34,0,Spring2018
663,SW Cedar Hills & Fairfield,1002,N,NS,32,63,95,31,Spring2018
664,SW Cedar Hills & Fairfield,1003,S,OP,89,31,120,43,Spring2018
665,SW Cedar Hills & Huntington,1010,E,OP,5,3,8,6,Spring2018
666,SW Cedar Hills & Huntington,1011,W,NS,3,5,8,11,Spring2018
667,SW Cedar Hills & Jenkins,1013,N,NS,9,21,30,4,Spring2018
668,SW Cedar Hills & Jenkins,1014,S,FS,9,17,26,4,Spring2018
669,SW Cedar Hills & Lynnridge,1017,E,FS,2,1,3,0,Spring2018
670,SW Cedar Hills & Lynnridge,1018,W,FS,1,3,4,0,Spring2018
671,SW Cedar Hills & Park Way,1019,N,NS,11,12,23,4,Spring2018
672,SW Cedar Hills & Park Way,1020,S,FS,15,10,25,3,Spring2018
673,SW Cedar Hills & Walker,1021,N,NS,17,29,46,24,Spring2018
674,SW Cedar Hills & Walker,1022,S,FS,27,25,52,26,Spring2018
675,Jantzen Beach Main Stop,1026,S,OP,312,337,649,91,Spring2018
676,SW Center & 125th,1034,E,FS,10,15,25,2,Spring2018
677,SW Center & 125th,1035,W,FS,15,12,27,1,Spring2018
678,N Channel Ave & Anchor,1041,E,FS,0,17,17,0,Spring2018
679,N Channel Ave & Ballast,1042,E,OP,0,0,0,0,Spring2018
680,N Channel Ave & Commerce,1043,S,OP,0,0,0,0,Spring2018
681,N Channel Ave & Dolphin,1044,S,OP,1,0,1,0,Spring2018
682,N Chautauqua & Washburne,1045,N,NS,1,4,5,0,Spring2018
689,N Chautauqua & Washburne,1046,S,OP,3,1,4,0,Spring2018
690,N Chautauqua & Alaska,1047,N,NS,11,36,47,0,Spring2018
691,N Chautauqua & Willis,1050,S,NS,13,7,20,4,Spring2018
692,SW Chestnut & Bertha,1051,W,NS,10,1,11,0,Spring2018
693,SW Chestnut & 12th,1053,S,NS,2,0,2,0,Spring2018
694,SW Chestnut & 14th,1056,N,NS,4,2,6,0,Spring2018
695,Clackamas Community College,1068,S,AT,386,376,762,128,Spring2018
696,SE Clinton & 21st,1092,W,NS,13,8,21,0,Spring2018
697,SE Clinton & 23rd,1093,E,NS,5,5,10,0,Spring2018
698,SE Clinton & 23rd,1094,W,FS,7,2,9,0,Spring2018
699,SE Clinton & 26th,1095,E,NS,39,13,52,0,Spring2018
700,Rose Quarter Transit Center,1097,N,AT,917,147,1064,128,Spring2018
701,3500 Block NE Columbia Blvd,1099,W,AT,3,19,22,0,Spring2018
702,3500 Block NE Columbia Blvd,1100,E,OP,11,3,14,0,Spring2018
703,3800 Block NE Columbia Blvd,1101,W,AT,2,5,7,0,Spring2018
704,3800 Block NE Columbia Blvd,1102,E,AT,6,2,8,0,Spring2018
705,SW Columbia & Park Ave,1108,E,NS,122,115,237,17,Spring2018
706,SW Columbia & 12th,1111,E,NS,80,60,140,103,Spring2018
707,SW 18th & Goose Hollow MAX Station,1114,E,AT,300,156,456,63,Spring2018
708,NE Columbia Blvd & 27th,1115,W,OP,0,3,3,0,Spring2018
709,NE Columbia Blvd & 42nd,1116,W,FS,3,7,10,0,Spring2018
710,NE Columbia Blvd & 42nd,1117,E,FS,6,2,8,0,Spring2018
711,NE Columbia Blvd & 47th,1118,E,NS,41,19,60,1,Spring2018
712,SW Commercial & Hall,1122,N,FS,2,13,15,0,Spring2018
713,SW Commercial & Hall,1123,S,NS,9,7,16,1,Spring2018
714,SW Corbett & Abernethy,1125,S,NS,0,1,1,0,Spring2018
715,SW Corbett & Abernethy,1126,N,NS,0,1,1,0,Spring2018
716,SW Corbett & Bancroft,1127,S,NS,0,2,2,0,Spring2018
717,SW Corbett & Bancroft,1128,N,NS,1,1,2,0,Spring2018
718,SW Corbett & Boundary St,1129,N,NS,6,2,8,1,Spring2018
719,SW Corbett & Carolina,1130,N,NS,2,0,2,0,Spring2018
720,SW Corbett & Carolina,1131,S,NS,0,2,2,0,Spring2018
721,SW Corbett & Curry,1132,S,NS,1,1,2,0,Spring2018
722,SW Corbett & Curry,1133,N,NS,2,1,3,0,Spring2018
723,SW Corbett & Flower,1134,S,NS,0,1,1,0,Spring2018
724,SW Corbett & Flower,1135,N,NS,1,0,1,0,Spring2018
725,SW Corbett & Gaines,1136,N,NS,4,0,4,0,Spring2018
726,SW Corbett & Gaines,1137,S,NS,2,4,6,1,Spring2018
727,SW Corbett & Gibbs,1138,S,NS,5,2,7,0,Spring2018
728,SW Corbett & Gibbs,1139,N,NS,1,10,11,0,Spring2018
729,SW Corbett & Hamilton,1140,S,NS,2,1,3,0,Spring2018
730,SW Corbett & Hamilton,1141,N,NS,1,4,5,0,Spring2018
731,SW Corbett & Mitchell,1146,N,FS,2,0,2,0,Spring2018
732,SW Corbett & Mitchell,1147,S,NS,1,3,4,0,Spring2018
733,SW Corbett & Nebraska,1148,S,OP,1,1,2,0,Spring2018
734,SW Corbett & Pendleton,1149,N,NS,3,0,3,0,Spring2018
735,SW Corbett & Pendleton,1150,S,NS,1,2,3,0,Spring2018
742,SW Corbett & Richardson,1151,S,FS,0,3,3,1,Spring2018
743,SW Corbett & Richardson,1152,N,NS,5,0,5,0,Spring2018
744,SW Corbett & Sweeney,1155,S,OP,1,1,2,0,Spring2018
745,NE Evergreen Pkwy & Cornelius Pass Rd,1158,W,FS,8,3,11,0,Spring2018
746,NE Evergreen Pkwy & 106th (NW 188th),1159,W,NS,27,17,44,1,Spring2018
747,12200 Block NW Cornell,1160,E,AT,10,5,15,10,Spring2018
748,12200 Block NW Cornell,1161,W,OP,2,8,10,5,Spring2018
749,12900 Block NW Cornell,1162,W,AT,10,9,19,0,Spring2018
750,NW Cornell & Dale,1163,E,NS,32,14,46,38,Spring2018
751,13900 Block NW Cornell,1165,W,AT,2,3,5,0,Spring2018
752,14100 Block NW Cornell,1166,E,OP,0,0,0,0,Spring2018
753,14100 Block NW Cornell,1167,W,AT,1,8,9,0,Spring2018
754,NW Cornell & Barnes,1171,E,NS,9,18,27,3,Spring2018
755,NW Cornell & Dale,1172,W,NS,14,14,28,11,Spring2018
756,NW Cornell & Murray,1174,W,FS,33,32,65,17,Spring2018
757,NW Cornell & Saltzman,1182,W,FS,48,49,97,19,Spring2018
758,NW Cornell & Saltzman,1183,E,NS,42,31,73,20,Spring2018
759,NW Cornell & Science Park Dr,1184,W,OP,14,25,39,0,Spring2018
760,13800 Block NW Cornell (Sunset HS),1186,E,AT,3,3,6,0,Spring2018
761,NW Cornell & Trail,1187,W,FS,10,23,33,3,Spring2018
762,NW Cornell & Trail,1188,E,OP,21,10,31,3,Spring2018
763,14600 Block NW Cornell,1189,E,AT,24,13,37,0,Spring2018
764,NW Cornell & Cornell Woods,1190,W,OP,10,18,28,0,Spring2018
765,NW Cornell & 110th,1194,E,FS,1,0,1,0,Spring2018
766,NW Cornell & 110th,1195,W,NS,0,0,0,0,Spring2018
767,NW Cornell & Cedar Hills Blvd,1196,E,NS,4,3,7,0,Spring2018
768,NW Cornell & 113th,1199,W,FS,4,9,13,0,Spring2018
769,NW Cornell & 119th,1200,E,OP,9,5,14,1,Spring2018
770,NW Cornell & 119th,1201,W,NS,8,11,19,0,Spring2018
771,NW Cornell & 123rd,1203,W,FS,3,15,18,4,Spring2018
772,NW Cornell & 143rd,1204,E,OP,26,13,39,0,Spring2018
773,NW Cornell & 153rd,1205,E,FS,11,9,20,1,Spring2018
774,4100 Block SW Council Crest,1207,E,AT,0,2,2,0,Spring2018
775,SW Council Crest & Chehalem,1211,N,FS,2,0,2,0,Spring2018
776,SW Council Crest & Chehalem,1212,E,NS,1,4,5,0,Spring2018
777,SW Council Crest & Chehalem,1213,W,OP,2,0,2,0,Spring2018
778,SW Council Crest & Chehalem (south leg),1214,S,NS,0,2,2,0,Spring2018
779,SW Council Crest & Greenway,1215,E,FS,1,3,4,0,Spring2018
780,SW Council Crest & Tualatin,1217,S,OP,0,2,2,0,Spring2018
781,SW Council Crest & Tualatin,1218,W,NS,1,0,1,0,Spring2018
782,700 Block Country Club,1219,W,AT,0,0,0,0,Spring2018
783,Country Club & Boones Ferry Rd,1220,W,NS,1,4,5,0,Spring2018
784,Country Club & Iron Mtn,1221,W,FS,3,1,4,0,Spring2018
785,Country Club & Iron Mtn,1222,E,NS,0,3,3,0,Spring2018
786,Country Club & Knaus Rd,1223,W,NS,2,1,3,0,Spring2018
787,Country Club & Knaus Rd,1224,E,OP,0,1,1,0,Spring2018
788,2500 Block Country Club,1225,E,AT,18,15,33,12,Spring2018
795,Country Club & Hazel Road,1226,W,FS,18,19,37,12,Spring2018
796,Country Club & Redwood,1227,W,NS,0,0,0,0,Spring2018
797,Country Club & Bridge,1228,E,NS,0,0,0,0,Spring2018
798,Country Club & Sundeleaf,1229,W,OP,1,0,1,0,Spring2018
799,Country Club & Sundeleaf,1230,E,NS,0,2,2,0,Spring2018
800,Country Club & Uplands,1231,W,OP,0,0,0,0,Spring2018
801,Country Club & Uplands,1232,E,NS,0,0,0,0,Spring2018
802,Country Club & Wembley Park,1233,W,OP,0,0,0,0,Spring2018
803,Country Club & Wembley Park,1234,E,NS,0,0,0,0,Spring2018
804,NE Cully & Shaver,1239,S,FS,8,1,9,0,Spring2018
805,NE Cully & Prescott,1240,N,NS,37,105,142,36,Spring2018
806,NE Cully & Prescott,1241,S,FS,122,38,160,26,Spring2018
807,NE Cully & Killingsworth,1243,N,FS,6,1,7,0,Spring2018
808,NE Cully & Mason,1244,N,FS,5,29,34,2,Spring2018
809,NE Cully & Mason,1245,S,NS,20,7,27,1,Spring2018
810,SE Currin & Hwy 211-224,1252,S,NS,0,0,0,0,Spring2018
811,E Dartmouth & Cornell,1255,E,NS,4,2,6,0,Spring2018
812,E Dartmouth & Cornell,1256,W,NS,2,5,7,0,Spring2018
813,E Dartmouth & Harvard,1257,E,NS,4,1,5,1,Spring2018
814,E Dartmouth & Harvard,1258,W,NS,1,4,5,0,Spring2018
815,E Dartmouth & Portland Ave,1259,W,NS,2,17,19,2,Spring2018
816,NE Dekum & Dean,1264,E,NS,48,16,64,4,Spring2018
817,NE Dekum & Durham,1265,E,FS,64,15,79,21,Spring2018
818,NE Dekum & Durham,1267,W,NS,23,57,80,16,Spring2018
819,NE Dekum & Saratoga,1271,W,NS,11,9,20,10,Spring2018
820,NE Dekum & M L King,1273,W,NS,25,98,123,25,Spring2018
821,NE Dekum & Claremont,1275,W,FS,16,49,65,5,Spring2018
822,NE Dekum & 15th,1277,W,NS,23,22,45,1,Spring2018
823,NE Dekum & 15th,1278,E,NS,23,22,45,0,Spring2018
824,NE Dekum & 18th,1280,W,FS,16,11,27,1,Spring2018
825,NE Dekum & 18th,1281,E,NS,11,17,28,1,Spring2018
826,NE Dekum & 22nd,1282,W,NS,13,8,21,2,Spring2018
827,NE Dekum & 22nd,1283,E,FS,8,16,24,4,Spring2018
828,NE Dekum & 24th,1284,E,NS,5,8,13,9,Spring2018
829,NE Dekum & 27th,1285,W,NS,24,20,44,11,Spring2018
830,NE Dekum & 27th,1286,E,NS,43,27,70,10,Spring2018
831,NE Dekum & 29th,1287,W,FS,23,27,50,0,Spring2018
832,NE Dekum & 29th,1288,E,FS,29,29,58,1,Spring2018
833,NE Dekum & 32nd Pl,1289,W,OP,37,23,60,2,Spring2018
834,NE Dekum & 33rd,1290,E,NS,34,44,78,4,Spring2018
835,NE Dekum & 6th,1292,W,NS,12,45,57,8,Spring2018
836,NE Dekum & 6th,1293,E,NS,144,55,199,39,Spring2018
837,N Denver & Russet,1299,S,OP,7,17,24,8,Spring2018
838,N Denver & Terry,1300,N,NS,2,16,18,0,Spring2018
839,N Denver & Terry,1301,S,NS,12,2,14,1,Spring2018
840,N Denver & Watts,1303,N,FS,2,11,13,1,Spring2018
841,N Denver & Watts,1304,S,NS,8,3,11,0,Spring2018
848,13100 Block SE Division,1309,W,AT,28,9,37,4,Spring2018
849,16900 Block SE Division,1310,W,AT,70,20,90,53,Spring2018
850,3100 Block NW Division,1312,E,AT,6,15,21,1,Spring2018
851,SE Division & 68th,1313,W,FS,55,27,82,11,Spring2018
852,7300 Block SE Division,1314,E,AT,16,36,52,8,Spring2018
853,NW Division & Civic Dr,1315,E,FS,4,37,41,11,Spring2018
854,NW Division & Civic Dr,1316,W,FS,39,8,47,9,Spring2018
855,NE Division & Hogan Pl,1317,W,FS,27,47,74,36,Spring2018
856,NE Division & Palmblad Dr,1320,E,FS,6,16,22,6,Spring2018
857,NW Division & Birdsdale,1321,E,NS,11,16,27,1,Spring2018
858,Division & Buchanan,1323,E,OP,2,1,3,0,Spring2018
859,NE Division & Burnside,1324,E,FS,44,27,71,34,Spring2018
860,NE Division & Burnside,1325,W,FS,9,14,23,8,Spring2018
861,19200 Block SE Division,1326,W,AT,10,9,19,3,Spring2018
862,NE Division & Cleveland,1327,W,FS,2,10,12,7,Spring2018
863,NE Division & Cleveland,1328,E,NS,10,4,14,5,Spring2018
864,NW Division & Eastman Parkway,1331,E,FS,9,96,105,33,Spring2018
865,NW Division & Eastman Parkway,1332,W,NS,65,5,70,22,Spring2018
866,NW Division & Eastwood,1334,W,NS,18,10,28,5,Spring2018
867,NE Division & Fleming,1335,E,NS,6,4,10,1,Spring2018
868,NE Division & Fleming,1336,W,OP,5,6,11,1,Spring2018
869,NE Division & Francis,1338,W,OP,7,13,20,14,Spring2018
870,NE Division & Hogan,1339,E,FS,30,18,48,18,Spring2018
871,NE Division & Kelly,1340,W,NS,1,22,23,7,Spring2018
872,NW Division & Miller,1342,W,FS,24,2,26,2,Spring2018
873,Division & Morton,1343,N,NS,5,5,10,5,Spring2018
874,NW Division & Norman,1344,E,FS,2,20,22,10,Spring2018
875,NW Division & Riverview,1346,E,NS,3,6,9,0,Spring2018
876,NW Division & Riverview,1347,W,FS,9,8,17,0,Spring2018
877,NE Division & Main,1348,E,FS,5,59,64,9,Spring2018
878,SE Division & 165th,1350,W,OP,15,20,35,15,Spring2018
879,Division & Selma,1351,E,NS,1,0,1,0,Spring2018
880,NE Division & Village Squire Ct,1355,E,OP,10,11,21,1,Spring2018
881,NE Division & Village Squire Ct,1356,W,NS,15,11,26,5,Spring2018
882,NW Division & Wallula,1357,E,FS,3,22,25,1,Spring2018
883,NW Division & Wallula,1358,W,FS,19,7,26,1,Spring2018
884,SE Division & 101st,1359,E,NS,17,38,55,10,Spring2018
885,SE Division & 101st,1360,W,NS,21,16,37,6,Spring2018
886,SE Division & 103rd,1361,E,NS,7,17,24,1,Spring2018
887,SE Division & 104th Dr,1362,W,NS,21,9,30,2,Spring2018
888,SE Division & 105th,1363,E,FS,6,15,21,2,Spring2018
889,SE Division & 106th,1364,W,NS,10,7,17,8,Spring2018
890,SE Division & 109th,1365,E,NS,12,33,45,10,Spring2018
891,SE Division & 110th,1367,W,NS,19,5,24,1,Spring2018
892,SE Division & 112th,1368,E,FS,32,74,106,29,Spring2018
893,SE Division & 112th,1369,W,NS,72,41,113,36,Spring2018
894,SE Division & 116th,1370,E,OP,9,23,32,10,Spring2018
901,SE Division & 115th,1371,W,FS,20,8,28,1,Spring2018
902,SE Division & 119th,1373,E,FS,31,131,162,39,Spring2018
903,SE Division & 119th,1374,W,OP,55,17,72,11,Spring2018
904,SE Division & 12th,1375,E,NS,182,110,292,13,Spring2018
905,SE Division & 12th,1376,W,FS,92,175,267,11,Spring2018
906,Division & 12th,1377,S,NS,5,3,8,1,Spring2018
907,SE Division & 122nd,1379,E,FS,201,181,382,109,Spring2018
908,SE Division & 122nd,1381,W,FS,220,160,380,109,Spring2018
909,SE Division & 124th,1382,W,NS,70,78,148,44,Spring2018
910,SE Division & 125th,1383,E,NS,33,85,118,19,Spring2018
911,Division & 13th,1385,N,OP,7,3,10,1,Spring2018
912,SE Division & 130th,1386,E,NS,47,100,147,32,Spring2018
913,SE Division & 130th,1387,W,FS,130,50,180,32,Spring2018
914,SE Division & 131st,1388,E,FS,10,41,51,1,Spring2018
915,SE Division & 136th,1389,E,FS,47,113,160,35,Spring2018
916,SE Division & 135th,1390,W,NS,96,38,134,34,Spring2018
917,SE Division & 138th,1391,E,NS,13,31,44,6,Spring2018
918,SE Division & 139th,1392,W,FS,51,24,75,12,Spring2018
919,Division & 13th,1393,S,NS,2,4,6,3,Spring2018
920,SE Division & 142nd,1396,W,NS,61,14,75,4,Spring2018
921,SE Division & 145th,1398,E,FS,50,152,202,92,Spring2018
922,SE Division & 145th,1399,W,NS,96,26,122,56,Spring2018
923,SE Division & 148th,1400,E,FS,69,59,128,36,Spring2018
924,Division & 15th,1404,N,NS,11,4,15,4,Spring2018
925,SE Division & 151st,1405,E,FS,5,26,31,2,Spring2018
926,SE Division & 152nd,1407,W,NS,43,10,53,2,Spring2018
927,SE Division & 156th,1408,W,NS,99,30,129,36,Spring2018
928,SE Division & 162nd,1415,E,FS,68,192,260,67,Spring2018
929,SE Division & 162nd,1416,W,NS,184,69,253,70,Spring2018
930,SE Division & 165th,1417,E,FS,12,17,29,14,Spring2018
931,SE Division & 168th,1418,E,NS,21,59,80,68,Spring2018
932,SE Division & 17th,1419,E,NS,22,42,64,3,Spring2018
933,SE Division & 17th,1420,W,OP,55,14,69,8,Spring2018
934,SE Division & 174th,1422,E,NS,39,94,133,24,Spring2018
935,SE Division & 174th,1423,W,NS,90,39,129,24,Spring2018
936,SE Division & 176th Pl,1425,W,OP,64,19,83,10,Spring2018
937,SE Division & 182nd,1427,E,FS,70,143,213,54,Spring2018
938,SE Division & 182nd,1428,W,FS,160,56,216,61,Spring2018
939,SE Division & 185th,1429,E,FS,5,16,21,4,Spring2018
940,SE Division & 185th,1430,W,NS,24,25,49,2,Spring2018
941,SE Division & 190th,1433,E,NS,6,25,31,11,Spring2018
942,SE Division & 190th,1434,W,FS,20,5,25,7,Spring2018
943,SE Division & 20th,1435,E,NS,83,114,197,14,Spring2018
944,SE Division & 23rd,1439,E,NS,27,29,56,1,Spring2018
945,SE Division & 26th,1441,E,NS,56,66,122,4,Spring2018
946,SE Division & 26th,1442,W,FS,66,54,120,3,Spring2018
947,SE Division & 28th Pl,1444,W,NS,44,29,73,0,Spring2018
954,SE Division & 28th Pl,1445,E,NS,31,43,74,0,Spring2018
955,SE Division & 30th,1447,E,NS,14,49,63,2,Spring2018
956,SE Division & 30th,1448,W,NS,45,17,62,3,Spring2018
957,SE Division & 32nd,1449,E,NS,26,57,83,2,Spring2018
958,SE Division & 32nd,1450,W,NS,54,25,79,2,Spring2018
959,SE Division & 34th,1451,E,NS,23,79,102,3,Spring2018
960,SE Division & 34th,1452,W,NS,79,30,109,5,Spring2018
961,SE Division & 37th,1457,W,NS,107,32,139,6,Spring2018
962,SE Division & Cesar Chavez Blvd,1458,E,NS,151,155,306,82,Spring2018
963,SE Division & Cesar Chavez Blvd,1459,W,NS,124,176,300,83,Spring2018
964,SE Division & 41st,1461,W,NS,44,21,65,11,Spring2018
965,SE Division & 41st,1462,E,NS,32,51,83,17,Spring2018
966,SE Division & 45th,1465,E,FS,13,33,46,1,Spring2018
967,SE Division & 45th,1466,W,NS,43,10,53,1,Spring2018
968,SE Division & 48th,1467,E,NS,21,45,66,4,Spring2018
969,SE Division & 48th,1468,W,NS,43,10,53,1,Spring2018
970,SE Division & 50th,1470,W,NS,66,65,131,15,Spring2018
971,SE Division & 52nd,1471,E,FS,117,67,184,20,Spring2018
972,SE Division & 52nd,1472,W,NS,75,64,139,17,Spring2018
973,SE Division & 55th,1475,E,FS,102,49,151,10,Spring2018
974,SE Division & 58th,1476,W,FS,35,82,117,13,Spring2018
975,SE Division & 60th,1477,E,OP,21,64,85,10,Spring2018
976,SE Division & 60th,1478,W,FS,50,16,66,13,Spring2018
977,SE Division & 64th,1480,E,NS,15,37,52,3,Spring2018
978,SE Division & 64th,1481,W,OP,29,9,38,0,Spring2018
979,SE Division & 67th,1483,E,FS,33,51,84,16,Spring2018
980,SE Division & 71st,1486,E,FS,12,41,53,3,Spring2018
981,SE Division & 71st,1487,W,OP,38,12,50,1,Spring2018
982,SE Division & 74th,1488,W,OP,53,16,69,8,Spring2018
983,SE Division & 76th,1489,E,OP,15,69,84,4,Spring2018
984,SE Division & 76th,1490,W,NS,28,10,38,1,Spring2018
985,SE Division & 77th,1492,W,NS,46,5,51,2,Spring2018
986,SE Division & 79th,1493,E,NS,8,54,62,5,Spring2018
987,SE Division & 8th,1496,W,FS,7,22,29,0,Spring2018
988,SE Division & 82nd,1497,E,FS,405,322,727,113,Spring2018
989,SE Division & 82nd,1499,W,FS,323,410,733,91,Spring2018
990,SE Division & 85th,1500,E,NS,19,36,55,3,Spring2018
991,SE Division & 85th,1501,W,NS,30,18,48,1,Spring2018
992,SE Division & 89th,1502,W,NS,26,16,42,3,Spring2018
993,SE Division & 89th,1503,E,FS,14,22,36,3,Spring2018
994,Division & 9th ,1504,W,FS,0,2,2,0,Spring2018
995,SE Division & 92nd ,1505,E,NS,21,41,62,5,Spring2018
996,SE Division & 92nd ,1506,W,FS,45,22,67,6,Spring2018
997,SE Division & 98th ,1508,W,FS,36,15,51,15,Spring2018
998,3100 Block SW Dosch ,1510,S,AT,0,0,0,0,Spring2018
999,SW Dosch & Doschview,1511,S,OP,0,0,0,0,Spring2018
1000,3500 Block SW Dosch ,1513,S,AT,0,0,0,0,Spring2018
1007,SW Dosch & Bridlemile,1515,E,NS,0,2,2,0,Spring2018
1008,SW Dosch & Bridlemile,1516,W,OP,3,0,3,0,Spring2018
1009,SW Dosch & Dosch Ct,1517,S,FS,0,10,10,0,Spring2018
1010,SW Dosch & Dosch Ct,1518,N,OP,6,0,6,0,Spring2018
1011,SW Dosch & Hamilton,1519,N,NS,0,1,1,0,Spring2018
1012,SW Dosch & Martins,1520,S,OP,0,0,0,0,Spring2018
1013,SW Dosch & Martins,1521,N,FS,1,0,1,0,Spring2018
1014,SW Dosch & Newby,1522,S,OP,0,0,0,0,Spring2018
1015,SW Dosch & Newby,1523,N,FS,0,0,0,0,Spring2018
1016,SW Dosch & Patton,1524,N,NS,10,0,10,0,Spring2018
1017,5400 Block SE Duke,1528,E,AT,5,14,19,1,Spring2018
1018,SE Duke & 78th,1529,W,OP,29,2,31,1,Spring2018
1019,SE Duke & 52nd,1530,W,NS,13,8,21,1,Spring2018
1020,SE Duke & 57th,1531,E,FS,3,14,17,9,Spring2018
1021,SE Duke & 57th,1532,W,FS,16,3,19,4,Spring2018
1022,SE Duke & 60th,1534,W,NS,54,23,77,22,Spring2018
1023,SE Duke & 64th,1537,E,NS,11,32,43,10,Spring2018
1024,SE Duke & 65th,1538,W,NS,31,7,38,9,Spring2018
1025,SE Duke & 67th,1539,E,NS,11,40,51,30,Spring2018
1026,SE Duke & 60th,1540,E,NS,23,53,76,24,Spring2018
1027,SE Duke & 67th,1541,W,NS,39,8,47,28,Spring2018
1028,SE Duke & 72nd,1544,E,NS,19,75,94,16,Spring2018
1029,SE Duke & 72nd,1545,W,FS,66,18,84,15,Spring2018
1030,SE Duke & 75th,1546,E,NS,6,32,38,12,Spring2018
1031,SE Duke & 74th,1547,W,NS,40,7,47,9,Spring2018
1032,SE Duke & 78th,1548,E,NS,2,30,32,1,Spring2018
1033,SE Duke & 82nd,1550,E,NS,6,114,120,30,Spring2018
1034,SE Duke & 81st,1551,W,NS,101,5,106,19,Spring2018
1035,SE Eagle Creek Rd & Currin,1555,N,FS,1,0,1,0,Spring2018
1036,28200 Block SE Eagle Creek Rd,1556,S,AT,1,3,4,1,Spring2018
1037,28400 Block SE Eagle Creek Rd,1557,N,AT,4,0,4,0,Spring2018
1038,25800 Block SE Eagle Creek Rd,1558,N,AT,8,5,13,0,Spring2018
1039,SE Eagle Creek Rd & Riverside Way,1559,S,FS,6,7,13,1,Spring2018
1040,SE Eagle Creek Rd & Folsom,1560,S,NS,0,1,1,0,Spring2018
1041,SE Eagle Creek Rd & Heiple Rd,1561,N,OP,1,0,1,0,Spring2018
1042,SE Eagle Creek Rd & Heiple Rd,1562,S,FS,0,1,1,0,Spring2018
1043,SE Eagle Creek Rd & Hwy 211,1563,S,FS,2,3,5,0,Spring2018
1044,SE Eagle Creek Rd & Hwy 211,1564,N,NS,1,2,3,0,Spring2018
1045,SE Eagle Creek Rd & Risberg,1565,N,OP,1,0,1,0,Spring2018
1046,SE Eagle Creek Rd & Risberg,1566,S,NS,1,1,2,0,Spring2018
1047,SE Eagle Creek Rd & Wildcat Mtn,1567,S,NS,0,3,3,0,Spring2018
1048,SE Eagle Creek Rd & Wildcat Mtn,1568,N,FS,3,0,3,0,Spring2018
1049,SW Eastman & Birdsdale,1569,N,OP,6,1,7,0,Spring2018
1050,SW Eastman & Birdsdale,1570,S,FS,1,2,3,0,Spring2018
1051,1500 Block NW Eastman,1571,S,AT,4,14,18,4,Spring2018
1052,NW Eastman & Division,1572,N,FS,94,4,98,21,Spring2018
1053,SE 223rd & NW 20th,1576,S,NS,1,9,10,6,Spring2018
1060,SW Eastman & Florence,1577,E,OP,0,0,0,0,Spring2018
1061,SW Eastman & Florence,1578,W,FS,0,0,0,1,Spring2018
1062,1300 Block NW Eastman,1579,S,AT,2,104,106,26,Spring2018
1063,SW Eastman & W Powell,1580,N,NS,2,4,6,0,Spring2018
1064,NW Eastman & W Powell,1581,S,NS,1,1,2,0,Spring2018
1065,600 Block NW Eastman (Townfair),1582,N,AT,0,0,0,0,Spring2018
1066,600 Block NW Eastman (Townfair),1583,S,OP,0,0,0,0,Spring2018
1067,NW Eastman & 3rd,1585,N,FS,1,2,3,0,Spring2018
1068,NW Eastman & 3rd,1586,S,OP,1,1,2,0,Spring2018
1069,SW Eastman & 4th,1587,E,OP,1,0,1,0,Spring2018
1070,SW Eastman & 4th,1588,S,FS,0,1,1,0,Spring2018
1071,SE Ellis & Foster,1596,W,NS,4,28,32,3,Spring2018
1072,SE Ellis & Foster,1597,E,FS,12,7,19,3,Spring2018
1073,SE Ellis & 86th Ave,1598,W,NS,9,2,11,0,Spring2018
1074,SE Ellis & 86th Ct,1600,E,OP,1,8,9,0,Spring2018
1075,SE Ellis & 89th,1602,E,OP,1,6,7,3,Spring2018
1076,SE Ellis & 92nd,1604,E,NS,1,6,7,0,Spring2018
1077,NW Everett & Broadway,1606,E,NS,21,39,60,11,Spring2018
1078,NW Everett & 11th,1607,E,FS,75,33,108,30,Spring2018
1079,NW Everett & 14th,1608,E,NS,42,11,53,2,Spring2018
1080,NW Everett & 19th,1611,E,NS,91,20,111,56,Spring2018
1081,NW Everett & 2nd,1612,E,NS,299,169,468,96,Spring2018
1082,NW Everett & 21st,1615,E,FS,110,33,143,58,Spring2018
1083,2700 Block SW Fairview,1618,E,AT,0,0,0,0,Spring2018
1084,2700 Block SW Fairview,1619,W,OP,0,0,0,0,Spring2018
1085,2800 Block SW Fairview,1620,W,AT,0,0,0,0,Spring2018
1086,2800 Block SW Fairview,1622,S,OP,1,0,1,0,Spring2018
1087,2800 Block SW Fairview,1623,N,AT,0,0,0,0,Spring2018
1088,4000 Block SW Fairview (Arboretum),1624,N,AT,2,2,4,0,Spring2018
1089,4000 Block SW Fairview (Arboretum),1625,S,OP,1,1,2,0,Spring2018
1090,SW Fairview & Bennington,1626,E,OP,0,1,1,0,Spring2018
1091,SW Fairview & Bennington,1627,S,FS,4,0,4,0,Spring2018
1092,SW Fairview & Canterbury,1628,N,NS,1,0,1,0,Spring2018
1093,SW Fairview & Cascade,1629,S,NS,1,0,1,0,Spring2018
1094,SW Fairview & Champlain,1632,E,OP,0,0,0,0,Spring2018
1095,SW Fairview & Kingston,1633,E,NS,9,22,31,1,Spring2018
1096,2900 Block SW Fairview,1635,W,AT,0,1,1,0,Spring2018
1097,2900 Block SW Fairview,1636,E,OP,1,0,1,0,Spring2018
1098,SW Fairview & View Place,1637,S,FS,0,1,1,0,Spring2018
1099,SW Fairview & Wildwood Trail,1638,N,AT,0,0,0,0,Spring2018
1100,SW Fairview & Wildwood Trail,1639,S,AT,0,0,0,0,Spring2018
1101,SW Farmington & 156th,1640,E,OP,47,29,76,2,Spring2018
1102,SW Farmington & 157th Pl,1641,W,OP,32,48,80,2,Spring2018
1103,18200 Block SW Farmington,1642,E,AT,1,0,1,0,Spring2018
1104,SW Farmington & Erickson,1646,E,FS,8,30,38,4,Spring2018
1105,SW Farmington & Hall,1648,W,NS,41,6,47,2,Spring2018
1106,SW Farmington & Hocken,1649,W,NS,10,3,13,0,Spring2018
1113,SW Farmington & Hocken,1650,E,FS,2,13,15,1,Spring2018
1114,SW Farmington & Kinnaman,1651,W,FS,21,58,79,5,Spring2018
1115,SW Farmington & Kinnaman,1652,E,NS,35,16,51,13,Spring2018
1116,17500 Block SW Farmington,1657,W,OP,78,67,145,23,Spring2018
1117,SW Farmington & Remington Dr,1658,E,FS,86,81,167,12,Spring2018
1118,SW Farmington & Murray,1660,W,FS,48,58,106,6,Spring2018
1119,SW Farmington & Murray,1661,E,NS,62,65,127,11,Spring2018
1120,SW Farmington & Watson,1665,E,NS,5,58,63,3,Spring2018
1121,SW Farmington & 142nd,1668,W,FS,9,23,32,5,Spring2018
1122,SW Farmington & 142nd,1669,E,FS,19,12,31,0,Spring2018
1123,SW Farmington & St Marys Dr,1670,W,FS,17,27,44,10,Spring2018
1124,SW Farmington & 149th,1671,E,NS,37,15,52,20,Spring2018
1125,SW Farmington & 153rd,1672,E,FS,17,4,21,0,Spring2018
1126,SW Farmington & 153rd,1673,W,NS,5,16,21,0,Spring2018
1127,SW Farmington & 160th,1674,W,FS,18,24,42,5,Spring2018
1128,SW Farmington & 160th,1675,E,FS,22,20,42,9,Spring2018
1129,SW Farmington & 165th,1678,W,FS,7,16,23,0,Spring2018
1130,SW Farmington & 165th,1679,E,FS,9,6,15,0,Spring2018
1131,SW Farmington & 170th,1682,W,FS,12,17,29,8,Spring2018
1132,SW Farmington & 170th,1683,E,FS,25,14,39,5,Spring2018
1133,SW Farmington & 179th,1688,E,NS,16,11,27,0,Spring2018
1134,SW Farmington & 188th Ct,1689,W,FS,12,9,21,0,Spring2018
1135,SW Farmington & 188th Ct,1690,E,NS,8,8,16,1,Spring2018
1136,SW Farmington & 192nd,1691,W,FS,4,5,9,0,Spring2018
1137,SW Farmington & 192nd,1692,E,FS,5,5,10,0,Spring2018
1138,SW Farmington & 195th,1693,E,NS,21,11,32,1,Spring2018
1139,SW Farmington & 196th,1694,W,NS,8,16,24,1,Spring2018
1140,N Fessenden & Allegheny,1698,W,NS,6,30,36,2,Spring2018
1141,N Fessenden & Allegheny,1699,E,FS,27,5,32,2,Spring2018
1142,N Fessenden & Berkeley,1700,W,FS,12,32,44,10,Spring2018
1143,N Fessenden & Burr,1703,E,NS,142,43,185,10,Spring2018
1144,N Fessenden & Burr,1704,W,NS,51,128,179,13,Spring2018
1145,N Fessenden & Columbia Way,1707,E,FS,170,24,194,8,Spring2018
1146,N Fessenden & Columbia Way,1708,W,NS,22,135,157,9,Spring2018
1147,N Fessenden & Geneva,1709,E,FS,64,24,88,9,Spring2018
1148,N Fessenden & Midway,1712,E,FS,61,20,81,1,Spring2018
1149,N Fessenden & Midway,1713,W,NS,17,70,87,5,Spring2018
1150,N Fessenden & Richmond,1714,E,FS,78,21,99,10,Spring2018
1151,N Fessenden & Richmond,1715,W,OP,18,64,82,11,Spring2018
1152,N Fessenden & Tioga,1718,W,NS,4,15,19,0,Spring2018
1153,N Fessenden & Portsmouth,1719,W,NS,6,17,23,0,Spring2018
1154,N Fessenden & Portsmouth,1720,E,NS,15,7,22,0,Spring2018
1155,N Fessenden & Van Houten,1721,W,NS,14,34,48,1,Spring2018
1156,N Fessenden & Van Houten,1722,E,NS,47,19,66,3,Spring2018
1157,N Fessenden & Wall,1723,W,OP,9,31,40,3,Spring2018
1158,8900 Block SE Flavel,1728,E,OP,0,12,12,0,Spring2018
1159,8800 Block SE Flavel,1729,W,OP,11,0,11,0,Spring2018
1166,SE Flavel & 52nd,1731,W,NS,46,15,61,1,Spring2018
1167,SE Flavel & 52nd,1732,E,FS,15,42,57,7,Spring2018
1168,SE Flavel & 57th,1737,W,NS,19,7,26,0,Spring2018
1169,SE Flavel & 57th,1738,E,FS,6,18,24,0,Spring2018
1170,SE Flavel & 60th,1739,E,NS,32,58,90,13,Spring2018
1171,SE Flavel & 60th,1740,W,NS,34,24,58,12,Spring2018
1172,SE Flavel & 62nd,1743,W,NS,26,7,33,6,Spring2018
1173,SE Flavel & 64th,1745,E,NS,8,29,37,9,Spring2018
1174,SE Flavel & 66th Place,1748,E,NS,10,37,47,0,Spring2018
1175,SE Flavel & 66th,1749,W,NS,35,10,45,0,Spring2018
1176,SE Flavel & 70th,1754,E,NS,5,16,21,6,Spring2018
1177,SE Flavel & 72nd,1755,W,FS,68,20,88,18,Spring2018
1178,SE Flavel & 82nd,1759,E,FS,20,24,44,32,Spring2018
1179,SE Flavel & 83rd,1760,W,NS,14,18,32,29,Spring2018
1180,SE Flavel & 85th,1761,E,OP,2,4,6,0,Spring2018
1181,SE Flavel & 86th,1762,W,FS,12,1,13,1,Spring2018
1182,SE Flavel & 87th,1763,E,NS,1,9,10,0,Spring2018
1183,SE Flavel & 92nd,1764,E,FS,3,47,50,23,Spring2018
1184,SE Flavel & 92nd,1765,W,FS,38,2,40,2,Spring2018
1185,SE Foster & 120th,1766,E,OP,18,11,29,1,Spring2018
1186,13100 Block SE Foster,1769,W,AT,5,8,13,2,Spring2018
1187,SE Foster & 131st,1770,E,OP,9,5,14,0,Spring2018
1188,SE Foster & 103rd,1772,E,OP,4,3,7,1,Spring2018
1189,11600 Block SE Foster,1773,E,OP,15,11,26,0,Spring2018
1190,11600 Block SE Foster,1774,W,AT,13,23,36,0,Spring2018
1191,SE Foster & Gladstone,1775,E,FS,7,30,37,2,Spring2018
1192,SE Foster & Holgate,1778,W,NS,90,28,118,36,Spring2018
1193,SE Foster & 101st,1779,E,NS,20,3,23,2,Spring2018
1194,SE Foster & 101st,1780,W,NS,2,12,14,1,Spring2018
1195,SE Foster & 103rd,1781,W,NS,4,6,10,1,Spring2018
1196,SE Foster & 107th,1782,E,OP,1,0,1,0,Spring2018
1197,SE Foster & 107th,1783,W,FS,0,1,1,0,Spring2018
1198,SE Foster & 110th Dr,1784,E,FS,10,9,19,1,Spring2018
1199,SE Foster & 111th,1785,W,NS,14,12,26,1,Spring2018
1200,12300 Block SE Foster,1786,E,AT,7,6,13,0,Spring2018
1201,SE Foster & 122nd,1787,W,FS,23,92,115,8,Spring2018
1202,SE Foster & 128th,1788,E,FS,13,14,27,0,Spring2018
1203,SE Foster & 128th,1789,W,FS,12,13,25,1,Spring2018
1204,SE Foster & 134th,1790,E,FS,8,6,14,0,Spring2018
1205,SE Foster & 134th,1791,W,FS,5,7,12,0,Spring2018
1206,SE Foster & Powell,1792,S,FS,61,95,156,21,Spring2018
1207,SE Foster & 52nd,1793,W,NS,74,65,139,22,Spring2018
1208,SE Foster & 52nd,1794,E,FS,59,65,124,18,Spring2018
1209,SE Foster & 56th,1798,W,NS,22,8,30,1,Spring2018
1210,SE Foster & 58th,1799,W,NS,40,5,45,1,Spring2018
1211,SE Foster & 65th,1802,E,FS,25,58,83,10,Spring2018
1212,SE Foster & 65th,1803,W,NS,44,21,65,10,Spring2018
1219,SE Foster & 67th,1804,E,FS,21,60,81,13,Spring2018
1220,SE Foster & 67th,1805,W,NS,52,13,65,5,Spring2018
1221,SE Foster & 69th,1807,W,FS,24,13,37,6,Spring2018
1222,SE Foster & 70th,1808,E,NS,7,23,30,2,Spring2018
1223,SE Foster & 72nd,1810,E,FS,24,91,115,23,Spring2018
1224,SE Foster & 72nd,1811,W,FS,80,27,107,18,Spring2018
1225,SE Foster & 75th,1812,E,OP,3,17,20,2,Spring2018
1226,SE Foster & 77th,1814,E,FS,9,50,59,16,Spring2018
1227,SE Foster & 78th,1815,W,NS,73,16,89,22,Spring2018
1228,SE Foster & 79th,1816,E,FS,6,38,44,7,Spring2018
1229,SE Foster & 82nd,1818,W,FS,252,101,353,47,Spring2018
1230,SE Foster & 82nd,1819,E,NS,41,191,232,46,Spring2018
1231,SE Foster & 85th,1821,E,NS,5,41,46,5,Spring2018
1232,SE Foster & 86th,1823,E,FS,2,36,38,4,Spring2018
1233,SE Foster & 86th,1824,W,FS,39,7,46,2,Spring2018
1234,SE Foster & 88th,1826,W,FS,55,5,60,10,Spring2018
1235,SE Foster & 89th,1827,E,FS,1,30,31,11,Spring2018
1236,SE Foster & 91st,1829,W,FS,32,1,33,7,Spring2018
1237,SE Foster & 94th (I-205 Overpass),1831,W,NS,172,347,519,85,Spring2018
1238,SE Foster & 97th,1832,W,NS,0,13,13,1,Spring2018
1239,NE Fremont & Alameda,1834,E,NS,1,1,2,0,Spring2018
1240,NE Fremont & Alameda,1835,W,FS,2,0,2,0,Spring2018
1241,Fremont & Borthwick,1837,E,NS,7,19,26,0,Spring2018
1242,NE Fremont & Cleveland,1838,E,NS,13,5,18,3,Spring2018
1243,N Fremont & Gantenbein,1841,W,NS,47,57,104,9,Spring2018
1244,NE Fremont & Mallory,1842,E,OP,2,0,2,1,Spring2018
1245,N Fremont & Albina,1843,W,FS,7,41,48,2,Spring2018
1246,NE Fremont & Mallory,1845,W,NS,1,6,7,3,Spring2018
1247,NE Fremont & M L King,1846,E,NS,15,3,18,4,Spring2018
1248,NE Fremont & M L King,1847,W,NS,2,24,26,6,Spring2018
1249,NE Fremont & 12th,1851,E,NS,6,1,7,0,Spring2018
1250,NE Fremont & 11th,1852,W,NS,1,5,6,1,Spring2018
1251,NE Fremont & 138th,1853,W,FS,0,1,1,0,Spring2018
1252,NE Fremont & 15th,1856,E,FS,16,5,21,5,Spring2018
1253,NE Fremont & 15th,1857,W,NS,6,20,26,4,Spring2018
1254,NE Fremont & 18th,1858,E,NS,2,0,2,0,Spring2018
1255,NE Fremont & 18th,1859,W,NS,2,5,7,0,Spring2018
1256,NE Fremont & 21st,1860,E,NS,3,1,4,0,Spring2018
1257,NE Fremont & 21st,1861,W,FS,1,2,3,0,Spring2018
1258,NE Fremont & 24th,1862,W,FS,4,9,13,1,Spring2018
1259,NE Fremont & 24th,1863,E,NS,9,2,11,0,Spring2018
1260,NE Fremont & 27th,1864,W,NS,1,3,4,0,Spring2018
1261,NE Fremont & 27th,1865,E,NS,4,1,5,0,Spring2018
1262,NE Fremont & 31st,1868,E,NS,1,0,1,0,Spring2018
1263,NE Fremont & Edgehill Place,1869,W,NS,1,1,2,0,Spring2018
1264,NE Fremont & 33rd Place,1870,W,OP,2,5,7,0,Spring2018
1265,NE Fremont & 33rd,1871,E,NS,4,5,9,1,Spring2018
1272,NE Fremont & 35th,1872,E,NS,1,0,1,0,Spring2018
1273,NE Fremont & 35th,1873,W,FS,1,2,3,0,Spring2018
1274,NE Fremont & Cesar Chavez Blvd,1874,E,NS,2,2,4,0,Spring2018
1275,NE Fremont & Cesar Chavez Blvd,1875,W,NS,2,1,3,0,Spring2018
1276,NE Fremont & 41st,1876,E,NS,8,17,25,0,Spring2018
1277,NE Fremont & 42nd,1877,W,FS,18,14,32,1,Spring2018
1278,NE Fremont & 48th,1882,E,NS,5,4,9,2,Spring2018
1279,NE Fremont & 48th,1883,W,FS,5,7,12,3,Spring2018
1280,NE Fremont & 51st,1887,W,FS,4,2,6,0,Spring2018
1281,NE Fremont & 54th,1888,E,NS,2,1,3,0,Spring2018
1282,NE Fremont & 54th,1889,W,OP,8,1,9,0,Spring2018
1283,NE Fremont & 57th,1890,E,FS,4,13,17,1,Spring2018
1284,NE Fremont & 57th,1891,W,FS,14,4,18,1,Spring2018
1285,NE Fremont & 61st,1893,W,NS,3,2,5,0,Spring2018
1286,NE Fremont & 61st,1894,E,NS,3,2,5,0,Spring2018
1287,NE Fremont & 64th,1895,E,NS,2,3,5,0,Spring2018
1288,NE Fremont & 64th,1896,W,FS,3,3,6,0,Spring2018
1289,NE Fremont & 67th,1898,W,NS,5,2,7,0,Spring2018
1290,NE Fremont & 7th,1899,W,NS,1,4,5,1,Spring2018
1291,NE Fremont & 7th,1900,E,FS,7,1,8,0,Spring2018
1292,NE Fremont & 69th,1902,W,NS,7,7,14,19,Spring2018
1293,NE Fremont & 71st,1903,W,NS,6,7,13,3,Spring2018
1294,NE Fremont & 74th,1904,E,NS,4,4,8,1,Spring2018
1295,NE Fremont & 74th,1905,W,NS,4,2,6,1,Spring2018
1296,NE Fremont & 77th,1906,E,NS,1,3,4,1,Spring2018
1297,NE Fremont & 77th,1907,W,NS,4,0,4,0,Spring2018
1298,NE Fremont & 80th,1908,E,NS,1,5,6,0,Spring2018
1299,NE Fremont & 80th,1909,W,NS,1,0,1,0,Spring2018
1300,NE Fremont & 82nd,1910,W,FS,26,11,37,5,Spring2018
1301,NE Fremont & 82nd,1911,E,FS,9,23,32,8,Spring2018
1302,NE Fremont & 85th,1912,E,OP,3,2,5,1,Spring2018
1303,NE Fremont & 85th,1913,W,FS,2,3,5,1,Spring2018
1304,NE Fremont & 88th,1916,W,NS,6,4,10,0,Spring2018
1305,NE Fremont & 89th,1917,E,NS,8,6,14,0,Spring2018
1306,NE Fremont Ct & 145th,1919,E,NS,4,3,7,43,Spring2018
1307,4300 Block NW Front ,1921,W,AT,0,2,2,0,Spring2018
1308,4800 Block NW Front ,1922,W,AT,2,7,9,0,Spring2018
1309,4500 Block NW Front ,1924,W,AT,0,0,0,0,Spring2018
1310,4700 Block NW Front ,1925,W,AT,0,1,1,0,Spring2018
1311,SW Naito Parkway & Harrison,1926,N,NS,2,102,104,1,Spring2018
1312,SW Naito Parkway & Harrison,1927,S,NS,57,3,60,1,Spring2018
1313,SW Naito Parkway & Hooker,1929,S,AT,26,26,52,1,Spring2018
1314,SW Naito Parkway & Hooker,1930,N,AT,34,66,100,2,Spring2018
1315,3700 Block NW Front ,1931,W,AT,2,15,17,0,Spring2018
1316,SE Fuller & Sunnyside Dr,1934,N,NS,2,5,7,0,Spring2018
1317,11900 Block SE Fuller (La Salle),1935,N,OP,7,1,8,0,Spring2018
1318,11900 Block SE Fuller (La Salle),1936,S,AT,4,4,8,0,Spring2018
1325,SE Fuller & Southgate ,1939,N,NS,4,4,8,0,Spring2018
1326,SE Fuller & Southgate ,1940,S,FS,4,3,7,0,Spring2018
1327,SW Gaines & 11th ,1945,W,NS,32,38,70,13,Spring2018
1328,SW Gaines & 6th ,1947,W,OP,26,49,75,8,Spring2018
1329,SW Gaines & 9th ,1949,W,OP,32,60,92,1,Spring2018
1330,SW Garden Home & Multnomah,1951,W,NS,2,8,10,4,Spring2018
1331,SW Garden Home & 40th,1954,E,NS,4,1,5,0,Spring2018
1332,SW Garden Home & 42nd,1955,W,OP,1,4,5,0,Spring2018
1333,SW Garden Home & 42nd,1956,E,FS,4,1,5,0,Spring2018
1334,SW Garden Home & 45th,1957,W,NS,2,10,12,0,Spring2018
1335,SW Garden Home & 45th,1958,E,NS,11,3,14,0,Spring2018
1336,SW Garden Home & 47th,1959,E,FS,4,2,6,0,Spring2018
1337,SW Garden Home & 47th,1960,W,NS,1,3,4,0,Spring2018
1338,SW Garden Home & 50th,1961,W,OP,1,9,10,0,Spring2018
1339,SW Garden Home & 50th,1962,E,NS,10,1,11,0,Spring2018
1340,SW Garden Home & 52nd,1963,W,OP,0,3,3,0,Spring2018
1341,SW Garden Home & 52nd,1964,E,NS,2,0,2,0,Spring2018
1342,SW Garden Home & 54th,1965,W,NS,0,3,3,0,Spring2018
1343,SW Garden Home & 54th,1966,E,NS,3,1,4,0,Spring2018
1344,SW Garden Home & 56th,1967,W,FS,0,2,2,0,Spring2018
1345,SW Garden Home & 56th,1968,E,NS,3,0,3,0,Spring2018
1346,SW Garden Home & 57th,1969,W,NS,0,7,7,0,Spring2018
1347,SW Garden Home & 57th,1970,E,OP,9,0,9,0,Spring2018
1348,SW Garden Home & 61st,1971,W,NS,1,8,9,0,Spring2018
1349,SW Garden Home & 61st,1972,E,FS,5,1,6,0,Spring2018
1350,SW Garden Home & 62nd Pl,1973,W,NS,0,9,9,0,Spring2018
1351,SW Garden Home & 62nd Pl,1974,E,OP,9,0,9,0,Spring2018
1352,SW Garden Home & 64th,1975,W,NS,0,3,3,0,Spring2018
1353,SW Garden Home & 64th,1976,E,OP,4,0,4,0,Spring2018
1354,SW Garden Home & 66th,1977,W,OP,1,1,2,0,Spring2018
1355,SW Garden Home & 66th,1978,E,FS,4,0,4,0,Spring2018
1356,SW Garden Home & 67th,1979,W,OP,0,3,3,0,Spring2018
1357,SW Garden Home & 67th,1980,E,NS,2,1,3,0,Spring2018
1358,SW Garden Home & 69th/Multnomah,1981,E,FS,11,2,13,3,Spring2018
1359,SW Garden Home & 71st,1982,W,FS,15,43,58,1,Spring2018
1360,SW Garden Home & 71st,1983,E,NS,30,8,38,0,Spring2018
1361,SE Gladstone & 26th ,1990,W,NS,16,4,20,0,Spring2018
1362,SE Gladstone & 28th ,1991,E,NS,7,20,27,0,Spring2018
1363,Glen Echo & SE Mildred ,1993,E,OP,1,3,4,1,Spring2018
1364,Glen Echo & Mildred ,1994,W,FS,1,2,3,0,Spring2018
1365,NW Glisan & Broadway ,1997,W,FS,80,41,121,32,Spring2018
1366,NE Glisan & Floral ,2000,W,FS,17,2,19,0,Spring2018
1367,NE Glisan & Laddington ,2001,E,NS,0,6,6,0,Spring2018
1368,NE Glisan & Laddington ,2002,W,NS,5,2,7,2,Spring2018
1369,NE Glisan & Laurelhurst ,2003,E,NS,2,16,18,0,Spring2018
1370,12900 Block NE Glisan (Menlo Park ES),2005,E,AT,0,2,2,0,Spring2018
1371,4700 Block NE Glisan ,2009,W,OP,88,58,146,95,Spring2018
1378,NE Glisan & 122nd,2010,E,FS,6,4,10,4,Spring2018
1379,NW Glisan & 10th,2011,W,NS,26,63,89,26,Spring2018
1380,NE Glisan & 102nd,2015,E,FS,5,2,7,4,Spring2018
1381,NE Glisan & 102nd,2016,W,NS,1,4,5,1,Spring2018
1382,NE Glisan & 104th,2017,W,NS,1,1,2,0,Spring2018
1383,NE Glisan & 105th,2018,E,NS,0,0,0,0,Spring2018
1384,NE Glisan & 108th,2020,E,OP,1,1,2,0,Spring2018
1385,NE Glisan & 108th,2021,W,NS,1,0,1,0,Spring2018
1386,NE Glisan & 113th,2024,E,NS,1,1,2,1,Spring2018
1387,NE Glisan & 113th,2025,W,NS,2,0,2,2,Spring2018
1388,NE Glisan & 117th,2028,E,NS,1,1,2,0,Spring2018
1389,NE Glisan & 117th,2029,W,NS,2,0,2,0,Spring2018
1390,NW Glisan & 12th,2030,W,NS,16,58,74,16,Spring2018
1391,NE Glisan & 120th,2032,E,OP,2,4,6,1,Spring2018
1392,NE Glisan & 122nd,2034,W,NS,8,8,16,8,Spring2018
1393,NE Glisan & 126th,2036,E,FS,0,0,0,1,Spring2018
1394,NE Glisan & 128th,2037,W,FS,5,0,5,0,Spring2018
1395,NE Glisan & 133rd,2040,E,NS,1,1,2,0,Spring2018
1396,NE Glisan & 133rd,2041,W,OP,1,0,1,0,Spring2018
1397,NE Glisan & 136th,2042,E,NS,0,2,2,0,Spring2018
1398,NE Glisan & 136th,2043,W,OP,6,0,6,0,Spring2018
1399,NE Glisan & 139th,2044,E,NS,1,4,5,0,Spring2018
1400,NW Glisan & 14th,2046,W,NS,11,59,70,3,Spring2018
1401,NE Glisan & 141st,2047,W,OP,3,1,4,1,Spring2018
1402,NE Glisan & 141st,2048,E,FS,1,3,4,0,Spring2018
1403,NE Glisan & 143rd,2049,E,NS,0,0,0,0,Spring2018
1404,NE Glisan & 143rd,2050,W,OP,0,0,0,0,Spring2018
1405,NE Glisan & 146th,2051,E,NS,0,1,1,0,Spring2018
1406,NE Glisan & 148th,2053,E,FS,0,1,1,1,Spring2018
1407,NE Glisan & 148th,2054,W,FS,1,1,2,0,Spring2018
1408,NE Glisan & 152nd,2057,W,NS,1,0,1,0,Spring2018
1409,NE Glisan & 155th,2058,E,OP,0,2,2,1,Spring2018
1410,NE Glisan & 155th,2059,W,NS,4,1,5,1,Spring2018
1411,NE Glisan & 157th,2060,E,NS,0,2,2,1,Spring2018
1412,NE Glisan & 157th,2061,W,FS,2,0,2,0,Spring2018
1413,NW Glisan & 16th,2062,W,NS,2,15,17,6,Spring2018
1414,NE Glisan & 160th,2063,E,FS,1,3,4,0,Spring2018
1415,NE Glisan & 160th,2064,W,NS,2,0,2,0,Spring2018
1416,NE Glisan & 162nd,2065,E,FS,3,10,13,5,Spring2018
1417,NE Glisan & 162nd,2066,W,FS,8,2,10,1,Spring2018
1418,NE Glisan & 165th,2067,E,NS,1,3,4,1,Spring2018
1419,NE Glisan & 165th,2068,W,NS,3,1,4,1,Spring2018
1420,NE Glisan & 167th Pl,2069,E,NS,0,1,1,0,Spring2018
1421,NE Glisan & 167th Pl,2070,W,NS,0,0,0,0,Spring2018
1422,NE Glisan & 172nd,2073,W,FS,3,0,3,0,Spring2018
1423,NE Glisan & 172nd,2074,E,FS,1,2,3,0,Spring2018
1424,NE Glisan & 176th,2075,W,NS,3,0,3,1,Spring2018
1431,NE Glisan & 176th ,2076,E,FS,0,2,2,0,Spring2018
1432,NE Glisan & 181st ,2081,W,FS,6,3,9,4,Spring2018
1433,NW Glisan & 19th ,2086,W,NS,11,75,86,45,Spring2018
1434,NW Glisan & 21st ,2099,W,NS,16,141,157,31,Spring2018
1435,NE Glisan & 28th,2105,E,FS,44,72,116,8,Spring2018
1436,NE Glisan & 30th,2106,E,FS,8,19,27,4,Spring2018
1437,NE Glisan & 30th,2107,W,NS,24,11,35,5,Spring2018
1438,NE Glisan & 32nd,2108,E,NS,8,13,21,0,Spring2018
1439,NE Glisan & 32nd,2109,W,NS,10,5,15,0,Spring2018
1440,NE Glisan & Cesar Chavez Blvd,2110,E,FS,37,32,69,29,Spring2018
1441,NE Glisan & Cesar Chavez Blvd,2111,W,FS,32,49,81,29,Spring2018
1442,NE Glisan & 43rd,2114,E,NS,3,17,20,1,Spring2018
1443,NE Glisan & 43rd,2115,W,NS,15,4,19,0,Spring2018
1444,NE Glisan & 45th,2117,W,NS,37,13,50,14,Spring2018
1445,NE Glisan & 49th,2119,E,FS,72,98,170,114,Spring2018
1446,NE Glisan & 52nd,2121,W,NS,67,41,108,51,Spring2018
1447,NE Glisan & 53rd,2122,E,NS,21,48,69,24,Spring2018
1448,NE Glisan & 55th,2123,W,NS,16,9,25,6,Spring2018
1449,NE Glisan & 56th,2124,E,FS,10,13,23,4,Spring2018
1450,NE Glisan & 57th,2126,W,NS,10,7,17,7,Spring2018
1451,NE Glisan & 60th,2127,E,NS,36,71,107,36,Spring2018
1452,NE Glisan & 60th,2128,W,NS,68,38,106,44,Spring2018
1453,NE Glisan & 62nd,2129,W,NS,13,1,14,0,Spring2018
1454,NE Glisan & 62nd,2130,E,NS,2,7,9,0,Spring2018
1455,NE Glisan & 65th,2131,E,NS,8,35,43,9,Spring2018
1456,NE Glisan & 65th,2132,W,NS,46,12,58,34,Spring2018
1457,NE Glisan & 67th,2133,W,NS,41,34,75,26,Spring2018
1458,NE Glisan & 67th,2134,E,NS,34,55,89,25,Spring2018
1459,NE Glisan & 71st,2137,W,NS,41,14,55,2,Spring2018
1460,NE Glisan & 71st,2138,E,NS,13,35,48,1,Spring2018
1461,NE Glisan & 73rd,2139,E,FS,9,28,37,3,Spring2018
1462,NE Glisan & 78th,2143,W,NS,35,14,49,9,Spring2018
1463,NE Glisan & 78th,2144,E,NS,11,33,44,7,Spring2018
1464,NE Glisan & 80th,2145,W,NS,30,6,36,5,Spring2018
1465,NE Glisan & 80th,2146,E,NS,4,24,28,5,Spring2018
1466,NE Glisan & 82nd,2147,E,FS,45,108,153,41,Spring2018
1467,NE Glisan & 82nd,2148,W,NS,98,38,136,37,Spring2018
1468,NE Glisan & 85th,2149,W,OP,10,3,13,0,Spring2018
1469,NE Glisan & 86th,2151,E,NS,4,14,18,0,Spring2018
1470,NE Glisan & 90th,2153,W,NS,23,15,38,3,Spring2018
1471,NE Glisan & 92nd,2155,E,FS,17,26,43,5,Spring2018
1472,NE Glisan & 92nd,2156,W,NS,18,19,37,3,Spring2018
1473,NE Glisan & 94th,2158,E,NS,5,9,14,1,Spring2018
1474,N Going & Port Center Way,2161,W,FS,5,39,44,3,Spring2018
1475,NE Grand & Broadway,2165,N,FS,91,25,116,40,Spring2018
1476,SE Grand & E Burnside,2167,N,NS,237,88,325,58,Spring2018
1477,NE Grand & Hoyt ,2169,N,OP,24,24,48,7,Spring2018
1484,SE Grand & Main,2170,N,NS,182,45,227,24,Spring2018
1485,SE Grand & Mill,2171,N,NS,0,3,3,0,Spring2018
1486,NE Grand & Holladay,2175,N,FS,302,137,439,95,Spring2018
1487,NE Grand & Weidler,2178,N,NS,131,57,188,40,Spring2018
1488,N Greeley & Ainsworth,2182,N,NS,2,23,25,1,Spring2018
1489,N Greeley & Ainsworth,2183,S,NS,29,4,33,3,Spring2018
1490,N Greeley & Bryant,2185,N,NS,1,20,21,2,Spring2018
1491,N Greeley & Bryant,2186,S,NS,29,1,30,2,Spring2018
1492,N Greeley & Dekum,2190,N,NS,1,12,13,0,Spring2018
1493,N Greeley & Dekum,2191,S,NS,11,1,12,0,Spring2018
1494,N Greeley & Going Overpass,2195,N,AT,5,12,17,1,Spring2018
1495,N Greeley & Going,2196,S,NS,4,2,6,0,Spring2018
1496,N Greeley & Holman,2197,N,NS,1,14,15,1,Spring2018
1497,N Greeley & Holman,2198,S,NS,19,2,21,1,Spring2018
1498,N Greeley & Jessup,2205,S,NS,16,1,17,3,Spring2018
1499,N Greeley & Jessup,2206,N,NS,2,14,16,2,Spring2018
1500,N Greeley & Killingsworth,2208,N,NS,9,37,46,5,Spring2018
1501,N Greeley & Killingsworth,2209,S,NS,43,14,57,3,Spring2018
1502,N Greeley & Lombard St,2212,N,NS,1,37,38,3,Spring2018
1503,N Greeley & Lombard St,2213,S,FS,40,4,44,3,Spring2018
1504,N Greeley & Rosa Parks Way,2221,N,FS,6,22,28,2,Spring2018
1505,N Greeley & Rosa Parks Way,2222,S,NS,29,3,32,5,Spring2018
1506,N Greeley & Sumner,2226,N,NS,26,61,87,1,Spring2018
1507,N Greeley & Sumner,2227,S,OP,62,28,90,3,Spring2018
1508,SW Greenburg & Cascade,2230,E,OP,40,26,66,12,Spring2018
1509,SW Greenburg & Cascade,2231,S,FS,27,42,69,11,Spring2018
1510,SW Greenburg & Center,2232,N,FS,58,26,84,10,Spring2018
1511,SW Greenburg & Center,2233,S,NS,19,47,66,5,Spring2018
1512,SW Greenburg & North Dakota,2234,N,FS,31,23,54,3,Spring2018
1513,SW Greenburg & North Dakota,2235,S,OP,30,27,57,2,Spring2018
1514,SW Greenburg & 92nd,2237,E,FS,3,9,12,13,Spring2018
1515,SW Greenburg & 90th,2238,W,FS,6,5,11,6,Spring2018
1516,SW Greenburg & 92nd,2239,W,FS,8,8,16,10,Spring2018
1517,SW Greenburg & Lincoln,2240,S,NS,9,6,15,3,Spring2018
1518,SW Greenburg & 95th,2242,W,NS,6,8,14,0,Spring2018
1519,SW Greenburg & 95th,2243,E,FS,8,7,15,0,Spring2018
1520,SW Greenburg & 98th,2245,W,OP,12,14,26,0,Spring2018
1521,SW Greenburg & 98th,2246,E,FS,14,11,25,0,Spring2018
1522,200 Block Greenridge,2247,W,OP,0,7,7,0,Spring2018
1523,200 Block Greenridge,2248,E,AT,7,1,8,0,Spring2018
1524,Greenridge & Greenridge Ct,2249,N,OP,0,0,0,0,Spring2018
1525,Greenridge & Greenridge Ct,2250,S,FS,0,1,1,0,Spring2018
1526,Greenridge & SW Monroe Pkwy,2251,N,NS,0,0,0,0,Spring2018
1527,SW Greenway & Council Crest,2252,N,FS,0,0,0,0,Spring2018
1528,Gresham Transit Center,2253,E,AT,1133,902,2035,341,Spring2018
1529,SW Haines & Lesser,2257,E,NS,2,6,8,0,Spring2018
1530,5500 Block SW Hall,2260,N,AT,22,16,38,31,Spring2018
1537,6200 Block SW Hall ,2261,N,AT,16,14,30,0,Spring2018
1538,7800 Block SW Hall ,2262,N,AT,27,12,39,2,Spring2018
1539,7800 Block SW Hall ,2263,S,AT,14,28,42,2,Spring2018
1540,9800 Block SW Hall ,2264,N,AT,3,2,5,1,Spring2018
1541,SW Hall & Allen ,2266,S,FS,127,63,190,26,Spring2018
1542,SW Hall & Allen ,2267,N,NS,65,100,165,24,Spring2018
1543,3600 Block SW Hall ,2268,E,AT,13,14,27,8,Spring2018
1544,SW Hall & Broadway ,2271,N,FS,3,85,88,13,Spring2018
1545,SW Hall & Cascade ,2272,E,NS,14,31,45,5,Spring2018
1546,SW Hall & Cedar Hills,2273,W,NS,11,20,31,8,Spring2018
1547,SW Hall & Colony ,2274,W,NS,7,5,12,5,Spring2018
1548,SW Hall & Creekside ,2275,W,OP,42,19,61,5,Spring2018
1549,SW Hall & Creekside ,2276,E,FS,7,22,29,1,Spring2018
1550,SW Hall & Cresmoor ,2277,W,NS,5,4,9,1,Spring2018
1551,SW Hall & Denney ,2278,N,FS,21,13,34,2,Spring2018
1552,SW Hall & Denney ,2279,S,FS,14,27,41,1,Spring2018
1553,SW Hall & Green Lane,2280,S,NS,4,6,10,0,Spring2018
1554,SW Hall & Greenburg ,2282,E,FS,2,2,4,0,Spring2018
1555,SW Hall & Greenway ,2283,E,FS,36,72,108,11,Spring2018
1556,SW Hall & Greenway ,2284,W,FS,65,30,95,15,Spring2018
1557,SW Hall & Hart ,2285,N,FS,22,13,35,9,Spring2018
1558,SW Hall & Hart ,2286,S,FS,11,26,37,3,Spring2018
1559,SW Hall & Hemlock ,2287,N,FS,2,0,2,1,Spring2018
1560,SW Hall & Nimbus ,2290,E,FS,17,49,66,8,Spring2018
1561,SW Hall & Ridgecrest ,2291,W,FS,18,8,26,0,Spring2018
1562,SW Hall & Ridgecrest ,2292,E,OP,15,40,55,4,Spring2018
1563,SW Hall & Scholls Ferry,2295,W,NS,82,26,108,10,Spring2018
1564,SW Hall & Scholls Ferry,2296,E,FS,19,59,78,13,Spring2018
1565,SW Hall & Sussex ,2297,N,NS,13,11,24,1,Spring2018
1566,SW Hall & Washington,2298,W,FS,2,0,2,0,Spring2018
1567,SW Hall & Washington,2299,E,FS,5,3,8,3,Spring2018
1568,SW Hall & 13th,2300,N,OP,16,5,21,3,Spring2018
1569,SW Hall & 13th,2301,S,NS,8,26,34,22,Spring2018
1570,SW Hall & 2nd,2302,N,FS,17,47,64,18,Spring2018
1571,SW Hall & 22nd,2303,S,NS,14,21,35,2,Spring2018
1572,SW Hall & 5th,2305,N,NS,26,42,68,25,Spring2018
1573,SW Hall & 88th,2307,W,FS,1,0,1,0,Spring2018
1574,SW Hall & 88th,2308,E,OP,0,0,0,0,Spring2018
1575,SW Hall & 91st,2311,W,FS,0,0,0,0,Spring2018
1576,SW Hall & 91st,2312,E,OP,0,0,0,0,Spring2018
1577,N Halleck & Delaware ,2315,N,OP,10,14,24,6,Spring2018
1578,N Halleck & Delaware ,2316,E,NS,14,10,24,1,Spring2018
1579,N Halleck & Peninsular,2317,W,NS,6,17,23,0,Spring2018
1580,NE Halsey & 148th ,2320,E,FS,5,13,18,8,Spring2018
1581,NE Halsey & 176th ,2322,E,NS,1,8,9,0,Spring2018
1582,NE Halsey & 196th ,2326,W,FS,23,4,27,0,Spring2018
1583,NE Halsey & Market Dr,2327,E,NS,5,24,29,20,Spring2018
1590,23300 Block NE Halsey,2330,E,AT,9,18,27,5,Spring2018
1591,23300 Block NE Halsey,2331,W,AT,15,10,25,7,Spring2018
1592,23900 Block NE Halsey,2333,W,AT,5,1,6,0,Spring2018
1593,2100 Block SW Halsey (Edgefield Manor),2339,E,AT,1,11,12,1,Spring2018
1594,2100 Block SW Halsey (Edgefield Manor),2340,W,OP,9,2,11,0,Spring2018
1595,NE Halsey & Fairview/223rd,2341,E,FS,27,78,105,9,Spring2018
1596,NE Halsey & Fairview/223rd,2342,W,FS,39,6,45,4,Spring2018
1597,NE Halsey & 100th ,2343,W,FS,30,62,92,13,Spring2018
1598,SW Halsey & Halsey Loop,2345,E,FS,0,14,14,1,Spring2018
1599,SW Halsey & Halsey Loop,2346,W,OP,15,0,15,0,Spring2018
1600,NE Halsey & 176th ,2349,W,OP,10,1,11,0,Spring2018
1601,12400 Block NE Halsey,2352,W,OP,27,52,79,23,Spring2018
1602,NE Halsey & Wasco ,2353,E,NS,3,12,15,3,Spring2018
1603,NE 102nd & Halsey ,2354,N,NS,3,1,4,4,Spring2018
1604,10500 Block NE Halsey,2356,E,AT,27,21,48,5,Spring2018
1605,NE Halsey & 108th,2357,E,OP,13,21,34,12,Spring2018
1606,NE Halsey & 111th,2358,E,OP,19,45,64,25,Spring2018
1607,NE Halsey & 114th,2360,E,NS,8,16,24,6,Spring2018
1608,NE Halsey & 114th,2361,W,NS,14,6,20,6,Spring2018
1609,NE Halsey & 119th,2364,E,OP,2,17,19,4,Spring2018
1610,NE Halsey & 119th,2365,W,NS,12,3,15,4,Spring2018
1611,NE Halsey & 122nd,2366,E,FS,113,121,234,59,Spring2018
1612,NE Halsey & 122nd,2367,W,FS,89,53,142,32,Spring2018
1613,NE Halsey & 126th,2368,E,NS,4,14,18,4,Spring2018
1614,NE Halsey & 126th,2369,W,NS,8,3,11,1,Spring2018
1615,NE Halsey & 128th,2370,E,NS,2,8,10,6,Spring2018
1616,NE Halsey & 129th Pl,2373,W,NS,6,0,6,0,Spring2018
1617,NE Halsey & 131st Pl,2374,E,NS,6,31,37,7,Spring2018
1618,NE Halsey & 132nd,2375,W,NS,34,6,40,12,Spring2018
1619,NE Halsey & 136th Pl,2378,E,NS,2,14,16,7,Spring2018
1620,NE Halsey & 136th Pl,2379,W,OP,10,2,12,3,Spring2018
1621,NE Halsey & 140th,2380,E,OP,1,5,6,0,Spring2018
1622,NE Halsey & 141st,2381,W,FS,6,1,7,0,Spring2018
1623,NE Halsey & 143rd,2382,W,FS,5,1,6,0,Spring2018
1624,NE Halsey & 143rd,2383,E,OP,1,9,10,0,Spring2018
1625,NE Halsey & 146th,2384,W,FS,1,0,1,0,Spring2018
1626,NE Halsey & 146th,2385,E,OP,0,1,1,0,Spring2018
1627,NE Halsey & 148th,2386,W,NS,10,5,15,9,Spring2018
1628,NE Halsey & 155th,2389,E,NS,2,14,16,3,Spring2018
1629,NE Halsey & 155th,2390,W,NS,14,2,16,1,Spring2018
1630,NE Halsey & 157th,2391,E,NS,1,6,7,1,Spring2018
1631,NE Halsey & 157th,2392,W,NS,5,1,6,1,Spring2018
1632,NE Halsey & 160th,2393,E,FS,4,18,22,2,Spring2018
1633,NE Halsey & 162nd,2395,W,NS,62,21,83,13,Spring2018
1634,NE Halsey & 162nd,2396,E,NS,23,52,75,12,Spring2018
1635,NE Halsey & 168th Pl,2397,E,NS,2,17,19,0,Spring2018
1636,NE Halsey & 169th,2398,W,NS,18,2,20,1,Spring2018
1643,NE Halsey & 172nd,2399,W,OP,45,12,57,6,Spring2018
1644,NE Halsey & 172nd,2400,E,FS,13,45,58,2,Spring2018
1645,NE Halsey & 181st,2401,E,NS,44,91,135,27,Spring2018
1646,NE Halsey & 186th,2405,E,NS,7,13,20,1,Spring2018
1647,NE Halsey & 186th,2406,W,OP,10,6,16,0,Spring2018
1648,NE Halsey & 192nd,2407,W,FS,17,3,20,1,Spring2018
1649,NE Halsey & 192nd,2408,E,NS,2,18,20,2,Spring2018
1650,NE Halsey & 195th,2409,E,FS,5,19,24,1,Spring2018
1651,NE Halsey & 201st,2410,E,FS,19,33,52,3,Spring2018
1652,NE Halsey & 201st,2411,W,FS,39,21,60,3,Spring2018
1653,NE Halsey & Fairview Parkway,2414,W,NS,9,2,11,1,Spring2018
1654,NE Halsey & Fairview Parkway,2415,E,FS,2,7,9,1,Spring2018
1655,NE Halsey & 227th,2416,E,OP,14,55,69,22,Spring2018
1656,NE Halsey & 230th Ct,2418,E,NS,14,41,55,2,Spring2018
1657,NE Halsey & 230th Ct,2419,W,OP,50,14,64,6,Spring2018
1658,NE Halsey & 238th,2420,W,FS,79,56,135,16,Spring2018
1659,NE Halsey & 238th,2421,E,FS,16,38,54,5,Spring2018
1660,NE Halsey & 244th,2422,E,NS,2,18,20,0,Spring2018
1661,NE Halsey & 244th,2423,W,FS,16,1,17,0,Spring2018
1662,NE Halsey & 49th,2425,W,NS,4,3,7,0,Spring2018
1663,NE Halsey & 50th,2426,E,OP,6,7,13,1,Spring2018
1664,NE Halsey & 53rd,2428,W,NS,11,6,17,1,Spring2018
1665,NE Halsey & 53rd,2429,E,NS,4,17,21,2,Spring2018
1666,NE Halsey & 55th,2430,E,OP,2,7,9,0,Spring2018
1667,NE Halsey & 55th,2431,W,NS,8,1,9,0,Spring2018
1668,NE Halsey & 57th,2432,W,NS,29,21,50,8,Spring2018
1669,NE Halsey & 58th,2434,E,NS,25,37,62,9,Spring2018
1670,NE Halsey & Village St,2436,E,FS,4,14,18,6,Spring2018
1671,NE Halsey & 7th St,2437,W,FS,38,8,46,24,Spring2018
1672,NE Halsey & 60th,2438,W,FS,14,16,30,4,Spring2018
1673,NE Halsey & 60th,2439,E,FS,27,18,45,7,Spring2018
1674,NE Halsey & 63rd,2440,E,NS,16,12,28,5,Spring2018
1675,NE Halsey & 63rd,2441,W,NS,14,10,24,1,Spring2018
1676,NE Halsey & 66th,2442,E,OP,40,43,83,18,Spring2018
1677,NE Halsey & 66th,2443,W,NS,48,36,84,18,Spring2018
1678,NE Halsey & 69th,2445,W,OP,17,15,32,1,Spring2018
1679,NE Halsey & 69th,2446,E,AT,16,16,32,1,Spring2018
1680,NE Halsey & 72nd,2448,E,OP,7,9,16,3,Spring2018
1681,NE Halsey & 74th,2450,E,NS,8,16,24,0,Spring2018
1682,NE Halsey & 74th,2451,W,OP,17,9,26,3,Spring2018
1683,NE Halsey & 76th,2452,E,NS,2,5,7,0,Spring2018
1684,NE Halsey & 76th,2453,W,NS,5,2,7,0,Spring2018
1685,NE Halsey & 78th,2454,E,NS,1,3,4,1,Spring2018
1686,NE Halsey & 79th,2455,W,OP,3,1,4,0,Spring2018
1687,NE Halsey & 86th,2456,E,OP,4,6,10,1,Spring2018
1688,NE Halsey & 86th,2457,W,NS,3,2,5,0,Spring2018
1689,NE Halsey & 88th,2458,E,FS,3,3,6,0,Spring2018
1696,NE Halsey & 90th ,2459,W,FS,2,2,4,6,Spring2018
1697,NE Halsey & 92nd ,2460,E,NS,5,10,15,2,Spring2018
1698,SW Hamilton & 55th Pl,2461,W,FS,0,0,0,0,Spring2018
1699,5700 Block SW Hamilton ,2462,E,AT,1,0,1,0,Spring2018
1700,SW Hamilton & Semler Way,2463,W,NS,0,1,1,0,Spring2018
1701,6200 Block SW Hamilton ,2464,E,AT,2,0,2,0,Spring2018
1702,SW Hamilton & Scholls Ferry,2465,E,FS,0,0,0,0,Spring2018
1703,SW Hamilton & Dosch ,2466,E,NS,0,0,0,0,Spring2018
1704,SW Hamilton & Dosch ,2467,W,NS,18,10,28,0,Spring2018
1705,SW Hamilton & Hamilton Ct,2468,E,FS,1,0,1,0,Spring2018
1706,SW Hamilton & Hamilton Ct,2469,W,OP,0,2,2,0,Spring2018
1707,SW Hamilton & Scholls Ferry,2470,W,NS,0,0,0,0,Spring2018
1708,SW Hamilton & Shattuck ,2471,W,NS,0,1,1,0,Spring2018
1709,SW Hamilton & Shattuck ,2472,E,NS,6,0,6,0,Spring2018
1710,SW Hamilton & 34th,2473,W,FS,0,1,1,0,Spring2018
1711,SW Hamilton & 34th,2474,E,NS,0,0,0,0,Spring2018
1712,SW Hamilton & 36th Pl,2475,W,FS,0,0,0,0,Spring2018
1713,SW Hamilton & 36th Pl,2476,E,OP,0,0,0,0,Spring2018
1714,SW Hamilton & 39th Dr,2477,E,FS,0,0,0,0,Spring2018
1715,SW Hamilton & 39th Dr,2478,W,OP,0,0,0,0,Spring2018
1716,SW Hamilton & 41st,2479,W,NS,0,0,0,0,Spring2018
1717,SW Hamilton & 42nd Pl,2480,E,NS,0,0,0,0,Spring2018
1718,SW Hamilton & 45th,2481,W,OP,0,2,2,0,Spring2018
1719,SW Hamilton & 45th,2482,E,NS,2,0,2,0,Spring2018
1720,SW Hamilton & 47th Dr,2483,W,FS,0,2,2,2,Spring2018
1721,SW Hamilton & 47th,2484,E,FS,3,0,3,0,Spring2018
1722,SW Hamilton & 53rd,2486,E,FS,3,0,3,0,Spring2018
1723,SW Hamilton & 54th Pl,2487,W,FS,0,1,1,0,Spring2018
1724,SW Hamilton & 58th,2490,E,OP,1,0,1,0,Spring2018
1725,SW Hamilton & 60th Pl,2492,E,NS,0,0,0,0,Spring2018
1726,6900 Block SW Hampton ,2494,E,AT,11,58,69,0,Spring2018
1727,SW Hampton & 72nd ,2496,E,FS,3,13,16,1,Spring2018
1728,SE Harmony & Linwood ,2498,E,FS,13,5,18,1,Spring2018
1729,12400 Block SE Harold ,2505,E,AT,0,1,1,0,Spring2018
1730,12400 Block SE Harold ,2506,W,AT,1,1,2,0,Spring2018
1731,12900 Block SE Harold ,2507,W,AT,6,0,6,0,Spring2018
1732,SE Harold & 133rd ,2510,W,OP,4,0,4,0,Spring2018
1733,SE Harold & 92nd ,2512,E,FS,15,13,28,4,Spring2018
1734,SE Harold & 101st ,2517,E,FS,2,14,16,0,Spring2018
1735,SE Harold & 103rd ,2518,E,NS,0,8,8,0,Spring2018
1736,SE Harold & 105th ,2520,E,OP,1,9,10,3,Spring2018
1737,SE Harold & 109th ,2522,E,FS,1,3,4,0,Spring2018
1738,SE Harold & 109th ,2523,W,NS,6,1,7,0,Spring2018
1739,SE Harold & 111th ,2524,E,OP,0,2,2,0,Spring2018
1740,SE Harold & 111th ,2525,W,NS,2,0,2,0,Spring2018
1741,SE Harold & 113th ,2526,E,OP,0,3,3,0,Spring2018
1742,SE Harold & 113th ,2527,W,NS,3,1,4,0,Spring2018
1749,SE Harold & 115th,2528,E,NS,0,4,4,0,Spring2018
1750,SE Harold & 115th,2529,W,NS,5,0,5,0,Spring2018
1751,SE Harold & 118th,2530,E,OP,0,7,7,0,Spring2018
1752,SE Harold & 118th,2531,W,NS,7,0,7,0,Spring2018
1753,SE Harold & 122nd,2534,E,NS,14,21,35,2,Spring2018
1754,SE Harold & 122nd,2535,W,FS,23,14,37,0,Spring2018
1755,SE Harold & 128th,2537,E,NS,2,11,13,5,Spring2018
1756,SE Harold & 128th,2538,W,NS,13,1,14,1,Spring2018
1757,SE Harold & 136th,2539,E,NS,4,19,23,0,Spring2018
1758,SE Harold & 136th,2540,W,FS,23,2,25,0,Spring2018
1759,SE Harold & 52nd,2541,W,NS,50,16,66,1,Spring2018
1760,SE Harold & 54th,2542,E,NS,7,13,20,1,Spring2018
1761,SE Harold & 57th,2544,E,NS,1,10,11,1,Spring2018
1762,SE Harold & 57th,2545,W,FS,14,2,16,0,Spring2018
1763,SE Harold & 60th,2546,E,NS,3,19,22,0,Spring2018
1764,SE Harold & 60th,2547,W,NS,24,4,28,1,Spring2018
1765,SE Harold & 62nd,2548,E,NS,1,14,15,0,Spring2018
1766,SE Harold & 62nd,2549,W,NS,17,2,19,0,Spring2018
1767,SE Harold & 65th,2550,E,NS,3,18,21,0,Spring2018
1768,SE Harold & 67th,2551,E,NS,5,19,24,1,Spring2018
1769,SE Harold & 69th,2552,E,NS,2,10,12,0,Spring2018
1770,SE Harold & 69th,2553,W,FS,13,2,15,1,Spring2018
1771,SE Harold & 72nd,2554,W,NS,48,14,62,4,Spring2018
1772,SE Harold & 72nd,2555,E,FS,16,44,60,4,Spring2018
1773,SE Harold & 74th,2557,E,NS,2,11,13,0,Spring2018
1774,SE Harold & 74th,2558,W,NS,11,1,12,1,Spring2018
1775,SE Harold & 77th,2560,W,NS,13,3,16,0,Spring2018
1776,SE Harold & 79th,2561,E,OP,4,16,20,3,Spring2018
1778,SE Harold & 92nd ,2563,W,NS,14,25,39,5,Spring2018
1779,SE Harold & 97th ,2564,E,NS,4,14,18,0,Spring2018
1780,SE Harold & 97th ,2565,W,NS,16,3,19,0,Spring2018
1781, 200 Block SW Harrison,2566,E,AT,158,24,182,7,Spring2018
1782, 200 Block SW Harrison,2567,W,OP,25,279,304,13,Spring2018
1783, SE Harrison & Hwy 224,2568,E,NS,31,18,49,7,Spring2018
1784,SE Harrison & 24th ,2569,E,OP,36,13,49,5,Spring2018
1785,SE Harrison & 24th ,2570,W,NS,6,21,27,8,Spring2018
1786, 2700 Block SE Harrison,2571,W,OP,12,26,38,1,Spring2018
1787,SE Harrison & 28th ,2572,E,NS,24,9,33,2,Spring2018
1788,SE Harrison & 29th ,2573,W,NS,11,29,40,6,Spring2018
1789,SE Harrison & 31st ,2574,W,NS,46,82,128,36,Spring2018
1790,SE Harrison & 32nd ,2575,E,FS,60,39,99,23,Spring2018
1791,SE Harrison & 34th ,2577,W,NS,10,14,24,4,Spring2018
1792,SE Harrison & 37th ,2578,E,NS,7,12,19,1,Spring2018
1793,SE Harrison & 37th ,2579,W,NS,6,8,14,2,Spring2018
1794,SW Harrison & 4th ,2580,E,NS,336,75,411,42,Spring2018
1795,SE Harrison & 40th ,2582,E,NS,3,12,15,4,Spring2018
1802,SE Harrison & 40th ,2583,W,NS,11,3,14,0,Spring2018
1803,Rose Quarter Transit Center,2592,W,AT,724,1197,1921,258,Spring2018
1804,SE Hawthorne & 6th,2594,E,NS,307,242,549,37,Spring2018
1805,SE Hawthorne & Maple ,2595,E,FS,39,35,74,3,Spring2018
1806,SE Hawthorne & Poplar ,2596,E,NS,15,36,51,3,Spring2018
1807,SE Hawthorne & 9th,2597,E,NS,41,33,74,7,Spring2018
1808,SE Hawthorne & 12th,2599,E,NS,183,184,367,25,Spring2018
1809,SE Hawthorne & 14th,2602,W,FS,46,45,91,1,Spring2018
1810,SE Hawthorne & 16th,2603,E,FS,43,63,106,55,Spring2018
1811,SE Hawthorne & 16th,2604,W,NS,67,45,112,61,Spring2018
1812,SE Hawthorne & 19th,2606,W,FS,68,27,95,6,Spring2018
1813,SE Hawthorne & 20th,2607,E,FS,34,59,93,14,Spring2018
1814,SE Hawthorne & 23rd,2608,E,NS,29,42,71,3,Spring2018
1815,SE Hawthorne & 22nd,2609,W,NS,81,43,124,4,Spring2018
1816,SE Hawthorne & 25th,2611,W,FS,45,17,62,16,Spring2018
1817,SE Hawthorne & 25th,2612,E,FS,19,36,55,10,Spring2018
1818,SE Hawthorne & 27th,2613,W,NS,91,65,156,12,Spring2018
1819,SE Hawthorne & 28th,2614,E,OP,62,135,197,33,Spring2018
1820,SE Hawthorne & 30th,2615,E,NS,29,63,92,3,Spring2018
1821,SE Hawthorne & 30th,2616,W,NS,78,31,109,5,Spring2018
1822,SE Hawthorne & 32nd Pl,2617,E,FS,15,53,68,3,Spring2018
1823,SE Hawthorne & 32nd,2619,W,NS,50,16,66,1,Spring2018
1824,SE Hawthorne & 34th,2620,E,FS,33,77,110,6,Spring2018
1825,SE Hawthorne & 37th,2623,E,FS,50,140,190,36,Spring2018
1826,SE Hawthorne & 37th,2624,W,NS,111,42,153,23,Spring2018
1827,SE Hawthorne & Cesar Chavez Blvd,2625,E,NS,172,239,411,91,Spring2018
1828,SE Hawthorne & Cesar Chavez Blvd,2626,W,FS,232,159,391,127,Spring2018
1829,SE Hawthorne & 41st,2628,E,NS,54,87,141,6,Spring2018
1830,SE Hawthorne & 41st,2629,W,NS,66,39,105,8,Spring2018
1831,SE Hawthorne & 44th,2630,E,NS,18,55,73,4,Spring2018
1832,SE Hawthorne & 44th,2632,W,FS,67,22,89,2,Spring2018
1833,SE Hawthorne & 47th,2633,E,FS,47,79,126,11,Spring2018
1834,SE Hawthorne & 47th,2635,W,OP,58,29,87,7,Spring2018
1835,Hawthorne Bridge ,2641,E,AT,95,117,212,11,Spring2018
1836,Hawthorne Bridge ,2642,W,AT,86,100,186,21,Spring2018
1837,Hawthorne Bridge Ramp & SE M L King,2643,E,FS,32,199,231,36,Spring2018
1838,N Hayden Meadows Dr & Whitaker,2648,E,FS,19,23,42,12,Spring2018
1839,SW Heiney & Binford Lake,2650,S,NS,4,2,6,0,Spring2018
1840,S High & 1st ,2662,N,NS,1,3,4,1,Spring2018
1841,S High & 1st ,2663,S,FS,3,2,5,0,Spring2018
1842,High & 3rd ,2664,N,NS,4,6,10,5,Spring2018
1843,High & 3rd ,2665,S,NS,5,3,8,1,Spring2018
1844,High & 5th ,2666,N,NS,3,5,8,3,Spring2018
1845,SW Highland & Linneman,2667,E,FS,0,0,0,0,Spring2018
1846,SW Highland & Linneman,2668,W,OP,0,0,0,0,Spring2018
1847,SW Highland & 11th St ,2669,N,FS,12,5,17,7,Spring2018
1848,SW Highland & 11th St ,2670,S,FS,4,0,4,1,Spring2018
1855,SW Highland & 14th Dr,2671,E,NS,0,0,0,0,Spring2018
1856,Hillsboro Transit Center,2672,E,AT,130,56,186,8,Spring2018
1857,Holcomb & Apperson ,2674,E,OP,0,1,1,0,Spring2018
1858,Holcomb & Apperson ,2675,W,NS,1,0,1,0,Spring2018
1859,S Holcomb & Hunter Ave,2679,W,NS,1,0,1,0,Spring2018
1860,S Holcomb & Swan Ave,2681,E,NS,0,1,1,0,Spring2018
1861,S Holcomb & Swan Ave,2682,W,NS,2,0,2,0,Spring2018
1862,SE Holgate & 117th,2683,W,NS,19,1,20,0,Spring2018
1863,SE Holgate & 125th,2684,E,FS,0,2,2,0,Spring2018
1864,SE Holgate & 134th Dr,2685,E,NS,111,127,238,84,Spring2018
1865,SE Holgate & 100th,2686,E,FS,3,18,21,2,Spring2018
1866,SE Holgate & 101st,2687,W,FS,19,3,22,0,Spring2018
1867,SE Holgate & 103rd,2690,W,NS,72,13,85,6,Spring2018
1868,SE Holgate & 104th,2691,E,NS,11,68,79,16,Spring2018
1869,SE Holgate & 107th,2692,E,OP,1,7,8,0,Spring2018
1870,SE Holgate & 108th Pl,2695,W,OP,12,2,14,1,Spring2018
1871,SE Holgate & 112th,2696,E,NS,5,47,52,8,Spring2018
1872,SE Holgate & 112th,2697,W,NS,52,11,63,5,Spring2018
1873,SE Holgate & 115th,2699,E,FS,3,27,30,8,Spring2018
1874,SE Holgate & 115th,2700,W,NS,22,3,25,0,Spring2018
1875,SE Holgate & 118th,2701,E,NS,0,23,23,1,Spring2018
1876,SE Holgate & 122nd,2703,E,FS,22,158,180,41,Spring2018
1877,SE Holgate & 122nd,2705,W,FS,99,10,109,26,Spring2018
1878,SE Holgate & 128th,2706,E,NS,1,16,17,2,Spring2018
1879,SE Holgate & 130th,2707,E,FS,1,12,13,20,Spring2018
1880,SE Holgate & 136th,2708,E,NS,16,1,17,0,Spring2018
1881,SE Holgate & 26th,2712,E,NS,18,35,53,2,Spring2018
1882,SE Holgate & 26th,2713,W,NS,30,14,44,2,Spring2018
1883,SE Holgate & 28th,2714,E,FS,41,87,128,3,Spring2018
1884,SE Holgate & 28th,2715,W,NS,99,46,145,7,Spring2018
1885,SE Holgate & 32nd,2718,E,OP,46,56,102,58,Spring2018
1886,SE Holgate & 32nd,2719,W,NS,43,44,87,66,Spring2018
1887,SE Holgate & 34th,2720,E,NS,8,30,38,0,Spring2018
1888,SE Holgate & 34th,2721,W,OP,32,6,38,0,Spring2018
1889,SE Holgate & 36th,2722,E,NS,6,29,35,1,Spring2018
1890,SE Holgate & 36th,2723,W,NS,45,8,53,3,Spring2018
1891,SE Holgate & Cesar Chavez Blvd,2726,E,OP,61,132,193,74,Spring2018
1892,SE Holgate & Cesar Chavez Blvd,2727,W,NS,125,65,190,77,Spring2018
1893,SE Holgate & 41st,2728,E,NS,8,32,40,1,Spring2018
1894,SE Holgate & 41st,2729,W,OP,31,8,39,1,Spring2018
1895,SE Holgate & 45th,2732,E,NS,5,34,39,1,Spring2018
1896,SE Holgate & 45th,2733,W,NS,25,4,29,0,Spring2018
1897,SE Holgate & 47th,2734,E,NS,4,13,17,1,Spring2018
1898,SE Holgate & 47th,2735,W,NS,16,3,19,0,Spring2018
1899,SE Holgate & 49th,2736,E,NS,3,18,21,0,Spring2018
1900,SE Holgate & 49th,2737,W,NS,33,4,37,1,Spring2018
1901,SE Holgate & 52nd,2738,E,FS,36,62,98,9,Spring2018
1908,SE Holgate & 52nd,2739,W,NS,44,33,77,7,Spring2018
1909,SE Holgate & 56th,2740,E,NS,2,8,10,0,Spring2018
1910,SE Holgate & 56th,2741,W,NS,12,2,14,0,Spring2018
1911,SE Holgate & 58th,2742,E,NS,4,28,32,2,Spring2018
1912,SE Holgate & 58th,2743,W,NS,33,6,39,3,Spring2018
1913,SE Holgate & 62nd,2746,E,NS,39,65,104,17,Spring2018
1914,SE Holgate & 62nd,2747,W,OP,56,22,78,5,Spring2018
1915,SE Holgate & 64th,2748,W,NS,29,33,62,13,Spring2018
1916,SE Holgate & 65th,2749,E,NS,16,26,42,10,Spring2018
1917,SE Holgate & 67th,2750,E,FS,12,17,29,2,Spring2018
1918,SE Holgate & 67th,2751,W,NS,20,16,36,1,Spring2018
1919,SE Holgate & 70th,2752,E,NS,7,16,23,2,Spring2018
1920,SE Holgate & 70th,2753,W,NS,18,6,24,1,Spring2018
1921,SE Holgate & 72nd,2754,E,NS,6,19,25,1,Spring2018
1922,SE Holgate & 72nd,2755,W,NS,20,6,26,4,Spring2018
1923,SE Holgate & 74th,2756,W,NS,17,4,21,7,Spring2018
1924,SE Holgate & 75th,2757,E,NS,4,18,22,9,Spring2018
1925,SE Holgate & 77th,2758,E,FS,2,11,13,11,Spring2018
1926,SE Holgate & 77th,2759,W,OP,12,3,15,1,Spring2018
1927,SE Holgate & 79th,2760,E,NS,11,44,55,24,Spring2018
1928,SE Holgate & 79th,2761,W,NS,38,13,51,21,Spring2018
1929,SE Holgate & 83rd,2762,E,NS,175,212,387,155,Spring2018
1930,SE Holgate & 82nd,2763,W,FS,154,102,256,58,Spring2018
1931,SE Holgate & 88th,2767,E,FS,6,31,37,1,Spring2018
1932,SE Holgate & 88th,2768,W,NS,34,8,42,0,Spring2018
1933,NE Hood & 9th,2798,S,OP,0,13,13,3,Spring2018
1934,SW Huber & Capitol Hwy,2804,E,FS,3,3,6,0,Spring2018
1935,SW Huber & 35th,2806,E,NS,3,1,4,0,Spring2018
1936,SW Huber & 40th,2809,W,FS,1,1,2,1,Spring2018
1937,7500 Block SW Hunziker,2810,W,AT,4,3,7,0,Spring2018
1938,8000 Block SW Hunziker,2811,W,AT,5,0,5,0,Spring2018
1939,8000 Block SW Hunziker,2812,E,OP,0,6,6,0,Spring2018
1940,SW Hunziker & Hall,2815,E,FS,3,1,4,1,Spring2018
1941,SW Hunziker & Knoll,2816,W,NS,3,2,5,1,Spring2018
1942,SW Hunziker & 72nd,2817,W,FS,32,8,40,1,Spring2018
1943,SW Hunziker & 72nd,2818,E,NS,7,36,43,11,Spring2018
1944,29800 Block SE Hwy 211,2819,W,AT,0,0,0,0,Spring2018
1945,SE Hwy 211 & Hwy 224,2824,E,FS,1,2,3,0,Spring2018
1946,Molalla & Char Diaz Dr,2827,S,FS,0,3,3,0,Spring2018
1947,Molalla & Lazy Creek Ln,2828,N,OP,14,1,15,7,Spring2018
1948,Molalla & Sebastian Way,2830,E,NS,0,15,15,1,Spring2018
1949,Molalla & Clairmont,2837,N,FS,88,7,95,15,Spring2018
1950,Molalla & Clairmont,2838,S,FS,5,85,90,16,Spring2018
1951,Molalla & Gaffney Ln,2841,N,NS,54,11,65,65,Spring2018
1952,Molalla & Gaffney Ln,2842,S,FS,10,50,60,31,Spring2018
1953,Molalla & Warner-Milne,2866,S,FS,1,14,15,2,Spring2018
1954,10800 Block SE Highway 212,2868,E,AT,1,12,13,1,Spring2018
1961,SE Hwy 224 & Eckert Ln,2870,S,NS,0,3,3,0,Spring2018
1962,15700 Block SE Hwy 224,2872,S,AT,0,9,9,1,Spring2018
1963,15700 Block SE Hwy 224,2873,N,OP,9,0,9,0,Spring2018
1964,SE Hwy 224 & Springwater Rd,2874,W,OP,4,1,5,0,Spring2018
1965,16200 Block SE Hwy 224,2875,E,AT,1,5,6,0,Spring2018
1966,SE Hwy 224 & Amisigger Rd,2876,W,NS,0,0,0,0,Spring2018
1967,SE Hwy 224 & Amisigger Rd,2877,E,OP,0,0,0,0,Spring2018
1968,SE Hwy 224 & Bartlemay,2878,W,FS,1,0,1,0,Spring2018
1969,SE Hwy 224 & Barton Church,2879,E,AT,1,0,1,0,Spring2018
1970,SE Hwy 224 & Barton Church,2880,W,OP,0,1,1,0,Spring2018
1971,SE Hwy 224 & Bakers Ferry Rd,2881,E,FS,3,6,9,1,Spring2018
1972,SE Hwy 224 & Bakers Ferry Rd,2882,W,OP,7,3,10,1,Spring2018
1973,16400 Block SE Hwy 224,2883,E,OP,0,0,0,0,Spring2018
1974,16400 Block SE Hwy 224,2884,W,AT,1,0,1,0,Spring2018
1975,16000 Block SE Hwy 224,2885,S,FS,0,1,1,0,Spring2018
1976,16000 Block SE Hwy 224,2886,N,NS,2,0,2,0,Spring2018
1977,SE Hwy 212 & Evelyn,2888,E,NS,2,22,24,2,Spring2018
1978,SE Hwy 212 & 102nd,2889,W,FS,9,4,13,0,Spring2018
1979,SE Hwy 212 & 130th,2890,W,NS,10,2,12,0,Spring2018
1980,Hwy 212 & Fred Meyer Dc Entr,2891,E,FS,1,15,16,0,Spring2018
1981,11400 Block SE Hwy 212,2892,W,AT,15,1,16,0,Spring2018
1982,SE Hwy 224 & Hwy 212,2895,S,FS,0,1,1,0,Spring2018
1983,SE Hwy 224 & Hwy 212,2896,N,NS,0,0,0,0,Spring2018
1984,SE Hwy 224 & Marna,2898,W,FS,0,0,0,0,Spring2018
1985,10700 Block SE Hwy 212,2899,W,AT,14,1,15,2,Spring2018
1986,SE Hwy 224 & Odell,2900,E,NS,0,1,1,0,Spring2018
1987,SE Hwy 212 & 122nd,2904,E,FS,3,25,28,0,Spring2018
1988,SE Hwy 212 & 122nd,2905,W,FS,15,4,19,0,Spring2018
1989,SE Hwy 212 & 130th,2906,E,NS,1,13,14,0,Spring2018
1990,SE Hwy 224 & 135th,2907,E,FS,4,14,18,0,Spring2018
1991,SE Hwy 224 & 142nd,2908,E,NS,2,14,16,0,Spring2018
1992,SE Hwy 224 & 142nd,2909,W,NS,12,1,13,0,Spring2018
1993,SE Hwy 224 & 152nd,2910,E,OP,0,1,1,0,Spring2018
1994,SE Hwy 224 & 152nd,2911,W,NS,2,0,2,0,Spring2018
1995,SE Hwy 224 & 197th,2912,E,FS,0,0,0,0,Spring2018
1996,SE Hwy 224 & 197th,2913,W,OP,0,0,0,0,Spring2018
1997,SE Hwy 224 & 82nd Dr,2914,E,NS,34,20,54,6,Spring2018
1998,SE Hwy 212 & 82nd Dr,2915,W,NS,10,29,39,2,Spring2018
1999,N Interstate & Albina,2945,S,NS,12,20,32,1,Spring2018
2000,N Interstate & Graham,2962,N,FS,2,3,5,0,Spring2018
2001,N Interstate & Graham,2964,S,OP,2,1,3,0,Spring2018
2002,N Ivanhoe & Baltimore,3008,N,NS,38,5,43,3,Spring2018
2003,N Ivanhoe & Charleston,3009,E,NS,3,45,48,4,Spring2018
2004,Jackson & 12th,3020,S,NS,3,6,9,0,Spring2018
2005,Jackson & 12th,3021,N,NS,7,5,12,1,Spring2018
2006,Jackson & 15th,3024,S,NS,1,1,2,0,Spring2018
2007,Jackson & 15th,3025,N,NS,1,1,2,0,Spring2018
2014,Jean Rd & Bryant,3030,E,NS,1,0,1,0,Spring2018
2015,Jean Rd & Bryant,3031,W,FS,0,1,1,1,Spring2018
2016,Jean Rd & Schalit,3032,E,FS,1,0,1,0,Spring2018
2017,SW Jean Rd & Tualata,3033,W,OP,0,1,1,0,Spring2018
2018,Jean Rd & Schalit,3036,W,FS,0,1,1,0,Spring2018
2019,SW Jean Rd & Tualata,3038,E,FS,1,0,1,0,Spring2018
2020,SW Jefferson & Broadway,3039,W,NS,69,154,223,26,Spring2018
2021,Jefferson & Independence,3040,S,OP,1,10,11,0,Spring2018
2022,Jefferson & Independence,3041,N,NS,6,0,6,0,Spring2018
2023,2 Jefferson Parkway,3043,E,FS,3,1,4,0,Spring2018
2024,SW Jefferson & McNary,3045,S,FS,1,7,8,0,Spring2018
2025,SW Jefferson Pkwy & McNary Pkwy,3046,N,NS,8,0,8,0,Spring2018
2026,Jefferson & Mt Jefferson,3048,N,FS,3,0,3,0,Spring2018
2027,SW Jefferson & 10th,3049,W,NS,155,287,442,85,Spring2018
2028,SW Jefferson & 13th,3051,W,NS,35,93,128,55,Spring2018
2029,SW Jefferson & 16th,3052,W,NS,48,85,133,5,Spring2018
2030,SW Jefferson & 20th,3054,W,NS,39,25,64,7,Spring2018
2031,Jenkins & Bardeen,3056,E,NS,3,3,6,0,Spring2018
2032,SW Jenkins & Ecole,3062,W,NS,5,9,14,0,Spring2018
2033,SW Jenkins & Briggs,3063,W,FS,3,7,10,0,Spring2018
2034,SW Jenkins & Karl Braun,3064,E,FS,9,2,11,26,Spring2018
2035,SW Jenkins & Hocken,3067,E,NS,11,12,23,3,Spring2018
2036,SW Jenkins & Ecole,3069,E,OP,11,4,15,0,Spring2018
2037,N Vancouver & Jessup,3070,N,NS,5,8,13,4,Spring2018
2038,SE Johnson Creek & 42nd,3076,W,FS,8,11,19,0,Spring2018
2039,SE Johnson Creek & Brookside,3077,N,FS,22,8,30,1,Spring2018
2040,SE Johnson Creek & Brookside,3078,S,OP,7,14,21,1,Spring2018
2041,SE Johnson Creek & Springwater Corridor,3079,N,NS,16,5,21,5,Spring2018
2042,SE Johnson Creek & Springwater Corridor,3080,S,FS,7,26,33,6,Spring2018
2043,SE Johnson Creek & 32nd,3081,W,NS,1,2,3,0,Spring2018
2044,SE Johnson Creek & 36th,3082,W,OP,2,5,7,15,Spring2018
2045,SE Johnson Creek & 36th,3083,E,NS,5,3,8,17,Spring2018
2046,SE Johnson Creek & 42nd,3086,E,FS,11,7,18,0,Spring2018
2047,NE Kane & 18th Ct,3091,N,OP,16,10,26,6,Spring2018
2048,NE Kane & Division,3092,N,FS,51,43,94,57,Spring2018
2049,NE Kane & Division,3093,S,NS,58,54,112,70,Spring2018
2050,NE Kane & SE Stark,3094,N,NS,5,6,11,3,Spring2018
2051,NE Kane & 15th,3097,N,FS,32,40,72,35,Spring2018
2052,NE Kane & 18th Ct,3099,S,NS,26,24,50,37,Spring2018
2053,SE Kane & 2nd,3100,N,OP,0,3,3,0,Spring2018
2054,SE Kane & 2nd,3101,S,FS,4,2,6,0,Spring2018
2055,NE Kane & 2nd Ct,3102,N,OP,4,4,8,2,Spring2018
2056,NE Kane & 23rd,3104,S,FS,28,27,55,1,Spring2018
2057,NE Kane & 23rd,3105,N,FS,31,30,61,1,Spring2018
2058,NE Kane & 8th,3106,S,FS,2,0,2,1,Spring2018
2059,NE Kane & 8th,3107,N,NS,0,2,2,0,Spring2018
2060,SW Kelly & Corbett,3116,N,NS,23,32,55,10,Spring2018
2067,50 Block Kerr Parkway,3125,S,AT,1,7,8,0,Spring2018
2068,50 Block Kerr Parkway,3126,N,OP,7,3,10,0,Spring2018
2069,Kerr & Boones Ferry Rd,3127,S,NS,4,9,13,16,Spring2018
2070,Kerr & Independence,3129,N,FS,0,0,0,0,Spring2018
2071,Kerr & Jefferson Pkwy,3132,N,FS,6,5,11,0,Spring2018
2072,Kerr & McNary,3133,N,FS,5,3,8,0,Spring2018
2073,Kerr & Tanglewood,3134,E,FS,2,1,3,0,Spring2018
2074,Kerr & Tanglewood,3135,W,FS,2,3,5,0,Spring2018
2075,Kerr & The Grotto,3137,S,FS,4,5,9,1,Spring2018
2076,Kerr & The Grotto,3138,N,OP,8,5,13,13,Spring2018
2077,Kerr & Touchstone,3141,E,NS,5,19,24,0,Spring2018
2078,4500 Block NE Killingsworth,3144,E,AT,27,25,52,1,Spring2018
2079,5700 Block NE Killingsworth,3145,E,AT,8,9,17,0,Spring2018
2080,NE Killingsworth & 60th,3146,E,NS,80,62,142,17,Spring2018
2081,6300 Block NE Killingsworth,3147,W,AT,28,34,62,2,Spring2018
2082,NE Killingsworth & 64th,3148,E,FS,46,29,75,2,Spring2018
2083,7700 Block NE Killingsworth,3149,W,AT,1,2,3,0,Spring2018
2084,N Killingsworth & Albina,3153,E,NS,272,54,326,43,Spring2018
2085,N Killingsworth & Albina,3154,W,NS,59,269,328,46,Spring2018
2086,N Killingsworth & Commercial,3156,E,NS,113,16,129,10,Spring2018
2087,N Killingsworth & Commercial,3157,W,FS,27,218,245,20,Spring2018
2088,N Killingsworth & Concord,3158,E,NS,16,2,18,0,Spring2018
2089,N Killingsworth & Concord,3159,W,NS,2,17,19,1,Spring2018
2090,N Killingsworth & Delaware,3160,E,NS,12,1,13,0,Spring2018
2091,N Killingsworth & Delaware,3161,W,NS,1,19,20,2,Spring2018
2092,N Killingsworth & Denver,3162,E,NS,21,4,25,3,Spring2018
2093,N Killingsworth & Denver,3163,W,NS,4,20,24,1,Spring2018
2094,NE Killingsworth & Garfield,3165,E,NS,11,35,46,11,Spring2018
2095,N Greeley & Willamette,3167,S,NS,3,38,41,6,Spring2018
2096,N Killingsworth & Interstate,3169,E,FS,253,59,312,38,Spring2018
2097,N Killingsworth & Interstate,3170,W,NS,49,223,272,47,Spring2018
2098,N Killingsworth & Kerby,3171,E,NS,149,34,183,8,Spring2018
2099,N Killingsworth & Michigan,3173,E,NS,34,7,41,2,Spring2018
2100,N Killingsworth & Michigan,3174,W,NS,7,29,36,1,Spring2018
2101,N Killingsworth & Gay Ave,3179,E,NS,18,1,19,0,Spring2018
2102,N Killingsworth & Omaha,3180,W,NS,2,21,23,0,Spring2018
2103,N Killingsworth & Vancouver,3183,E,NS,92,35,127,27,Spring2018
2104,N Killingsworth & Vancouver,3184,W,NS,63,143,206,38,Spring2018
2105,8100 Block NE Killingsworth,3185,E,AT,53,15,68,6,Spring2018
2106,7600 Block NE Killingsworth,3186,E,AT,7,3,10,1,Spring2018
2107,NE Killingsworth & 31st,3189,W,NS,10,23,33,0,Spring2018
2108,NE Killingsworth & 33rd,3191,E,FS,113,92,205,25,Spring2018
2109,NE Killingsworth & 33rd,3192,W,FS,74,95,169,27,Spring2018
2110,NE Killingsworth & 35th,3193,E,NS,5,3,8,2,Spring2018
2111,NE Killingsworth & 35th,3194,W,NS,6,14,20,6,Spring2018
2112,NE Killingsworth & 36th,3195,E,NS,9,12,21,18,Spring2018
2113,NE Killingsworth & 36th,3196,W,NS,12,8,20,21,Spring2018
2120,NE Killingsworth & Cesar Chavez Blvd,3197,W,NS,10,6,16,2,Spring2018
2121,NE Killingsworth & Cesar Chavez Blvd,3198,E,NS,4,9,13,1,Spring2018
2122,NE Killingsworth & 42nd,3199,E,FS,158,134,292,29,Spring2018
2123,NE Killingsworth & 42nd,3200,W,NS,134,162,296,32,Spring2018
2124,NE Killingsworth & 46th Pl,3201,W,OP,23,22,45,1,Spring2018
2125,NE Killingsworth & 49th,3202,E,FS,33,34,67,14,Spring2018
2126,NE Killingsworth & 49th,3203,W,OP,28,21,49,22,Spring2018
2127,NE Killingsworth & 52nd,3204,E,FS,39,39,78,13,Spring2018
2128,NE Killingsworth & 52nd,3205,W,OP,52,51,103,35,Spring2018
2129,NE Killingsworth & 54th,3207,W,OP,28,29,57,11,Spring2018
2130,NE Killingsworth & 55th,3208,E,NS,33,34,67,2,Spring2018
2131,NE Killingsworth & 57th,3209,W,OP,11,10,21,0,Spring2018
2132,NE Killingsworth & 60th,3210,W,NS,65,80,145,7,Spring2018
2133,NE Killingsworth & 72nd,3211,E,FS,99,42,141,48,Spring2018
2134,NE Killingsworth & 72nd,3212,W,NS,40,93,133,56,Spring2018
2135,NE Killingsworth & 75th,3215,W,NS,2,8,10,0,Spring2018
2136,NE Killingsworth & 82nd,3216,W,FS,17,52,69,6,Spring2018
2137,N Kilpatrick & Brandon,3218,W,NS,7,9,16,4,Spring2018
2138,N Kilpatrick & Brandon,3219,E,NS,8,13,21,4,Spring2018
2139,N Kilpatrick & Denver,3221,W,FS,71,50,121,35,Spring2018
2140,N Kilpatrick & Denver,3222,E,NS,57,71,128,27,Spring2018
2141,7100 Block SE King,3224,E,AT,10,13,23,0,Spring2018
2142,7900 Block SE King,3226,E,AT,5,25,30,4,Spring2018
2143,SE King & Fuller,3228,W,OP,202,27,229,36,Spring2018
2144,SE King & Bell,3229,W,NS,125,27,152,17,Spring2018
2145,SE King & Bell,3230,E,OP,10,58,68,8,Spring2018
2146,SE King & Hollywood,3231,E,OP,11,9,20,0,Spring2018
2147,SE King & Hollywood,3232,W,FS,8,9,17,1,Spring2018
2148,SE King & Home,3233,E,FS,10,12,22,0,Spring2018
2149,SE King & Linwood,3234,E,FS,36,35,71,5,Spring2018
2150,SE King & Linwood,3235,W,NS,36,35,71,7,Spring2018
2151,SW King & Salmon,3236,N,NS,3,2,5,0,Spring2018
2152,SE King & Stanley,3237,W,NS,20,16,36,15,Spring2018
2153,SE King & Stanley,3238,E,NS,14,24,38,14,Spring2018
2154,SE King & 47th,3242,E,NS,4,7,11,0,Spring2018
2155,SE King & 47th,3243,W,OP,7,2,9,0,Spring2018
2156,SE King & 52nd,3245,E,NS,2,4,6,0,Spring2018
2157,SE King & 52nd,3246,W,OP,4,2,6,0,Spring2018
2158,SE King & 66th,3249,W,NS,11,8,19,0,Spring2018
2159,SE King & 66th,3250,E,NS,9,9,18,0,Spring2018
2160,SE King & 74th,3251,E,NS,10,17,27,6,Spring2018
2161,SE King & 77th,3254,W,OP,10,5,15,4,Spring2018
2162,SW Kingston & Japanese Garden,3276,N,OP,11,7,18,1,Spring2018
2163,SW Knight & Kingston,3277,S,FS,0,0,0,0,Spring2018
2164,SW Kingston & Tichner,3279,N,NS,1,0,1,0,Spring2018
2165,SW Knights & Kingston,3291,N,NS,1,0,1,0,Spring2018
2166,Kruse Way & Carman,3293,E,NS,11,3,14,0,Spring2018
2173,Kruse Way & Carman,3294,W,NS,2,11,13,0,Spring2018
2174,Kruse Way & Kruse Oaks,3295,E,FS,8,4,12,10,Spring2018
2175,Kruse Way & Kruse Oaks,3296,W,FS,3,12,15,14,Spring2018
2176,Kruse Way & Daniel Way,3297,W,NS,2,6,8,0,Spring2018
2177,Kruse Way & Kruse Woods,3298,E,FS,4,2,6,6,Spring2018
2178,Kruse Way & Mercantile,3299,E,FS,4,0,4,0,Spring2018
2179,Kruse Way & Westlake Dr,3300,W,FS,1,7,8,9,Spring2018
2180,SE Ladd & Division,3301,N,FS,9,2,11,0,Spring2018
2181,SE Ladd & Hawthorne,3303,N,NS,12,39,51,1,Spring2018
2182,SE Ladd & Ladd Circle,3304,S,NS,10,6,16,0,Spring2018
2183,SE Ladd & Ladd Circle,3305,N,NS,16,8,24,0,Spring2018
2184,SE Ladd & Lavender,3307,N,NS,4,3,7,0,Spring2018
2185,SE Ladd & Lavender,3308,S,NS,3,4,7,0,Spring2018
2186,SE Ladd & Palm St,3309,S,NS,5,10,15,1,Spring2018
2187,SE Ladd & Palm,3310,N,NS,10,7,17,0,Spring2018
2188,SE Ladd & 16th,3311,E,NS,8,6,14,0,Spring2018
2189,SE Ladd & 16th,3312,W,NS,6,8,14,0,Spring2018
2190,N Lagoon & Anchor,3315,N,NS,19,52,71,1,Spring2018
2191,N Lagoon & Ballast,3316,N,OP,0,4,4,0,Spring2018
2192,N Lagoon & Commerce,3317,N,NS,0,5,5,0,Spring2018
2193,N Dolphin & Channel,3318,S,NS,1,6,7,0,Spring2018
2194,5500 Block N Lagoon (at Gate 18),3319,N,OP,0,1,1,0,Spring2018
2195,SE Lake & 33rd Pl,3321,W,OP,2,3,5,0,Spring2018
2196,6300 Block SE Lake,3322,S,AT,1,0,1,0,Spring2018
2197,6200 Block SE Lake,3323,N,AT,1,1,2,0,Spring2018
2198,6400 Block SE Lake,3324,S,AT,1,1,2,1,Spring2018
2199,SE Lake & Boss,3325,E,FS,0,1,1,2,Spring2018
2200,SE Lake & Boss,3326,W,OP,0,0,0,0,Spring2018
2201,SE Lake & Harmony,3328,E,NS,1,2,3,0,Spring2018
2202,SE Lake & Harmony,3329,N,NS,0,1,1,0,Spring2018
2203,SE Lake & Kuehn Rd,3330,E,FS,0,0,0,0,Spring2018
2204,SE Lake & Lena/51st,3332,W,NS,1,0,1,0,Spring2018
2205,SE Lake & Mintone,3334,W,FS,0,0,0,0,Spring2018
2206,SE Lake & Oatfield,3335,E,FS,1,0,1,0,Spring2018
2207,SE Lake & Oatfield,3336,E,NS,2,3,5,0,Spring2018
2208,6600 Block SE Lake,3337,N,AT,1,1,2,1,Spring2018
2209,6500 Block SE Lake,3338,S,AT,1,2,3,0,Spring2018
2210,SE Lake & Rusk,3339,E,NS,2,1,3,0,Spring2018
2211,SE Lake & Rusk,3340,W,OP,3,2,5,0,Spring2018
2212,SE Lake & Where Else Ln,3343,E,FS,1,2,3,0,Spring2018
2213,SE Lake & 23rd,3344,E,OP,9,1,10,1,Spring2018
2214,SE Lake & 23rd,3345,W,FS,5,9,14,0,Spring2018
2215,SE Lake & 28th,3347,W,OP,1,2,3,1,Spring2018
2216,SE Lake & 28th,3348,E,NS,2,1,3,0,Spring2018
2217,SE Lake & 31st Pl,3349,E,NS,2,2,4,6,Spring2018
2218,SE Lake & 31st Pl,3350,W,OP,2,1,3,0,Spring2018
2219,SE Lake & 34th,3352,W,NS,0,1,1,0,Spring2018
2226,SE Lake & 36th,3353,E,OP,0,0,0,0,Spring2018
2227,SE Lake & 36th,3354,W,FS,1,1,2,0,Spring2018
2228,SE Lake & 51st,3356,E,FS,0,1,1,0,Spring2018
2229,Lake Oswego Transit Center,3363,S,AT,113,9,122,23,Spring2018
2230,4400 Block Lakeview,3364,W,AT,1,3,4,0,Spring2018
2231,N Interstate & Larrabee,3365,N,FS,6,1,7,0,Spring2018
2232,SW Laurelwood & Laurel,3367,N,OP,62,0,62,0,Spring2018
2233,NW Leahy & Alpenglow Way,3376,W,FS,0,0,0,0,Spring2018
2234,NW Leahy & Oak,3377,E,NS,1,0,1,0,Spring2018
2235,NW Leahy & 101st,3378,E,NS,0,0,0,0,Spring2018
2236,NW Leahy & 101st,3379,W,OP,0,0,0,0,Spring2018
2237,NW Leahy & 95th,3383,E,FS,0,0,0,0,Spring2018
2238,NW Leahy & 97th,3385,E,NS,1,0,1,0,Spring2018
2239,12100 Block SW Lesser,3387,N,AT,0,0,0,0,Spring2018
2240,12000 Block SW Lesser,3388,S,OP,0,0,0,0,Spring2018
2241,SW Lesser & Haines,3389,S,NS,5,3,8,10,Spring2018
2242,SW Lesser & 60th,3392,S,OP,3,1,4,0,Spring2018
2243,SW Lesser & 60th,3393,E,FS,2,2,4,0,Spring2018
2244,300 Block SW Lincoln,3397,E,AT,186,58,244,20,Spring2018
2245,SW Lincoln & 1st,3398,W,FS,53,198,251,9,Spring2018
2246,SE Lincoln & 57th,3403,E,NS,8,4,12,6,Spring2018
2247,SE Lincoln & 57th,3404,W,OP,5,11,16,7,Spring2018
2248,Linn & A V Davis,3407,S,NS,12,27,39,37,Spring2018
2249,Linn & Charman,3408,S,FS,4,5,9,0,Spring2018
2250,Linn & Charman,3409,N,OP,4,4,8,0,Spring2018
2251,Linn & Ethel,3410,N,NS,24,12,36,27,Spring2018
2252,Linn & Holmes,3411,S,NS,2,21,23,2,Spring2018
2253,Linn & Holmes,3412,N,NS,9,4,13,0,Spring2018
2254,Linn & Narain,3413,N,FS,6,3,9,1,Spring2018
2255,Linn & Oak,3414,S,NS,11,17,28,1,Spring2018
2256,Linn & Park,3415,S,FS,2,9,11,1,Spring2018
2257,Linn & Pearl,3416,N,FS,18,8,26,1,Spring2018
2258,Linn & Williams,3418,N,NS,40,4,44,16,Spring2018
2259,SE Linn & 13th,3419,W,NS,10,1,11,0,Spring2018
2260,SE Linn & 16th,3421,W,NS,5,1,6,1,Spring2018
2261,Linn & 4th,3422,S,NS,2,7,9,0,Spring2018
2262,Linn & 4th,3423,N,OP,4,5,9,4,Spring2018
2263,SE Linwood & Montgomery,3424,S,OP,0,0,0,0,Spring2018
2264,SE Linwood & Montgomery,3425,N,NS,0,0,0,0,Spring2018
2265,11600 Block SE Linwood,3426,N,OP,1,0,1,0,Spring2018
2266,11600 Block SE Linwood,3427,S,AT,1,2,3,0,Spring2018
2267,12300 Block SE Linwood,3428,N,OP,5,3,8,0,Spring2018
2268,12300 Block SE Linwood,3429,S,AT,8,4,12,0,Spring2018
2269,SE Linwood & Furnberg,3430,N,NS,1,1,2,0,Spring2018
2270,SE Linwood & Furnberg,3431,S,OP,1,1,2,0,Spring2018
2271,11900 Block SE Linwood (Linwood Sch),3432,N,OP,3,2,5,0,Spring2018
2272,11900 Block SE Linwood (Linwood Sch),3433,S,AT,1,2,3,0,Spring2018
2279,SE Linwood & Monroe,3434,N,FS,2,1,3,0,Spring2018
2280,SE Linwood & Monroe,3435,S,NS,1,1,2,0,Spring2018
2281,SW Locust & Hall,3438,W,NS,3,3,6,1,Spring2018
2282,SW Locust & Hall,3439,E,FS,5,2,7,2,Spring2018
2283,SW Locust & 80th,3440,E,NS,0,0,0,0,Spring2018
2284,SW Locust & 82nd,3441,W,FS,0,1,1,0,Spring2018
2285,SW Locust & 82nd,3442,E,NS,2,0,2,0,Spring2018
2286,N Lombard & Mississippi,3451,E,NS,22,17,39,7,Spring2018
2287,N Lombard & Albina,3452,W,NS,12,35,47,4,Spring2018
2288,N Lombard & Albina,3453,E,FS,46,23,69,3,Spring2018
2289,SW Lombard & Allen,3454,S,NS,21,74,95,25,Spring2018
2290,SW Lombard & Allen,3455,N,FS,95,24,119,4,Spring2018
2291,N Lombard & Buchanan,3462,W,FS,7,33,40,29,Spring2018
2292,N Lombard & Buchanan,3464,E,FS,36,7,43,48,Spring2018
2293,N Lombard & Burlington,3465,E,OP,286,108,394,131,Spring2018
2294,N Lombard & Burrage,3471,E,FS,40,13,53,24,Spring2018
2295,N Lombard & Burrage,3472,W,NS,6,23,29,9,Spring2018
2296,N Lombard & Charleston,3474,E,FS,134,53,187,36,Spring2018
2297,N Lombard & Chautauqua,3478,W,NS,11,18,29,3,Spring2018
2298,N Lombard & Chautauqua,3479,E,NS,16,11,27,3,Spring2018
2299,N Lombard & Clarendon,3480,W,NS,9,12,21,1,Spring2018
2300,N Lombard & Delaware,3483,W,NS,18,32,50,7,Spring2018
2301,N Lombard & Delaware,3484,E,NS,22,12,34,1,Spring2018
2302,N Lombard & Denver,3485,W,NS,122,99,221,50,Spring2018
2303,N Lombard & Denver,3486,E,NS,13,25,38,12,Spring2018
2304,N Lombard & Dwight,3487,W,NS,9,15,24,3,Spring2018
2305,N Lombard & Fenwick,3489,E,NS,55,52,107,30,Spring2018
2306,N Lombard & Fiske,3491,W,NS,24,51,75,14,Spring2018
2307,N Lombard & Gilbert,3494,W,FS,3,44,47,5,Spring2018
2308,N Lombard & Gilbert,3496,E,OP,84,14,98,24,Spring2018
2309,N Lombard & Hodge,3498,W,NS,20,37,57,22,Spring2018
2310,N Lombard & Hodge,3500,E,NS,22,14,36,20,Spring2018
2311,N Lombard & Huron,3501,E,NS,26,16,42,20,Spring2018
2312,N Lombard & Huron,3502,W,FS,13,20,33,25,Spring2018
2313,N Lombard & Ida,3503,E,NS,164,82,246,24,Spring2018
2314,N Lombard & Ida,3504,W,NS,78,204,282,70,Spring2018
2315,N Lombard Transit Center,3506,E,NS,497,766,1263,293,Spring2018
2316,N Lombard Transit Center,3507,W,FS,764,472,1236,251,Spring2018
2317,N Lombard & John,3509,W,NS,69,191,260,87,Spring2018
2318,N Lombard & Jordan,3511,E,NS,50,32,82,14,Spring2018
2319,N Lombard & McKenna,3518,W,NS,4,15,19,0,Spring2018
2320,N Lombard & Mississippi,3521,W,NS,37,29,66,11,Spring2018
2321,N Lombard & Oswego,3532,E,OP,31,4,35,11,Spring2018
2322,N Lombard & Oswego,3534,W,NS,4,37,41,9,Spring2018
2323,N Lombard & Peninsular,3535,W,NS,92,155,247,53,Spring2018
2324,N Lombard & Portsmouth,3537,E,FS,48,40,88,29,Spring2018
2325,N Lombard & Portsmouth,3538,W,NS,42,46,88,26,Spring2018
2332,13200 Block N Lombard,3540,N,AT,1,0,1,0,Spring2018
2333,13200 Block N Lombard,3541,S,OP,0,0,0,0,Spring2018
2334,NE Lombard & Rodney,3546,W,NS,9,4,13,0,Spring2018
2335,NE Lombard & Rodney,3547,E,FS,5,9,14,0,Spring2018
2336,N Lombard & Russet,3548,W,FS,4,9,13,2,Spring2018
2337,N Lombard & Tyler,3554,E,FS,59,19,78,42,Spring2018
2338,N Lombard & Tyler,3555,W,NS,20,55,75,45,Spring2018
2339,NE Lombard & M L King,3557,W,FS,101,22,123,22,Spring2018
2340,NE Lombard & M L King,3558,E,NS,13,90,103,22,Spring2018
2341,N Lombard & Van Houten,3559,E,NS,19,15,34,5,Spring2018
2342,N Lombard & Vancouver,3561,W,FS,36,31,67,6,Spring2018
2343,N Lombard & Vancouver,3562,E,NS,27,37,64,8,Spring2018
2344,N Lombard & Villard,3563,E,NS,69,57,126,36,Spring2018
2345,N Lombard & Wabash,3564,E,NS,27,17,44,7,Spring2018
2346,N Lombard & Wabash,3566,W,FS,18,35,53,8,Spring2018
2347,N Lombard & Wall,3569,W,NS,11,42,53,8,Spring2018
2348,N Lombard & Wall,3570,E,NS,59,13,72,7,Spring2018
2349,N Lombard & Wayland,3574,E,NS,5,3,8,0,Spring2018
2350,N Lombard & Westanna,3575,W,NS,23,52,75,24,Spring2018
2351,N Lombard & Westanna,3576,E,NS,39,20,59,28,Spring2018
2352,N Lombard & Woolsey,3578,E,NS,17,13,30,7,Spring2018
2353,SW Lombard & 12th,3580,N,NS,11,2,13,0,Spring2018
2354,SW Lombard & 12th,3581,S,OP,2,15,17,1,Spring2018
2355,SW Lombard & 2nd,3582,N,NS,8,16,24,8,Spring2018
2356,SW Lombard & 5th,3583,N,NS,12,13,25,0,Spring2018
2357,SW Lombard & 5th,3584,S,NS,11,11,22,2,Spring2018
2358,SW Lombard & 9th,3585,N,NS,17,4,21,22,Spring2018
2359,SW Lombard & 9th,3586,S,NS,6,19,25,28,Spring2018
2360,Longview & Holcomb,3588,S,NS,30,22,52,19,Spring2018
2361,SW Macadam & Boundary,3603,N,NS,110,10,120,16,Spring2018
2362,SW Macadam & Boundary,3604,S,NS,14,107,121,17,Spring2018
2363,SW Macadam & Gaines,3611,N,NS,25,10,35,1,Spring2018
2364,SW Macadam & Hamilton Ct,3612,S,OP,3,33,36,0,Spring2018
2365,SW Macadam & Hamilton Ct,3613,N,NS,29,4,33,1,Spring2018
2366,SW Macadam & Nebraska,3614,S,NS,3,50,53,4,Spring2018
2367,SW Macadam & Julia,3615,S,FS,2,25,27,0,Spring2018
2368,SW Macadam & Julia,3616,N,OP,39,2,41,0,Spring2018
2369,SW Macadam & Nebraska,3619,N,NS,50,3,53,2,Spring2018
2370,SW Macadam & Nevada,3620,S,NS,13,61,74,1,Spring2018
2371,SW Macadam & Nevada,3622,N,OP,59,10,69,1,Spring2018
2372,SW Macadam & Pendleton,3623,N,NS,75,3,78,1,Spring2018
2373,SW Macadam & Pendleton,3624,S,NS,3,64,67,0,Spring2018
2374,SE Madison & Grand,3633,W,NS,249,365,614,57,Spring2018
2375,SW Madison & 1st,3635,E,NS,822,95,917,53,Spring2018
2376,SE Madison & 11th,3637,W,NS,183,134,317,22,Spring2018
2377,SW Madison & 4th,3639,E,NS,952,159,1111,99,Spring2018
2378,SE Madison & 7th,3641,W,NS,24,58,82,5,Spring2018
2385,SE Main & Beta,3652,E,NS,0,0,0,0,Spring2018
2386,SW Main & Burnham,3653,W,OP,21,18,39,3,Spring2018
2387,SW Main & Burnham,3654,E,NS,37,29,66,2,Spring2018
2388,SW Main & Scoffins,3655,E,NS,99,49,148,20,Spring2018
2389,SW Main & Commercial,3656,S,NS,116,88,204,18,Spring2018
2390,SE Main & Milport,3657,N,NS,5,12,17,0,Spring2018
2391,SE Main & Mailwell,3658,N,FS,4,2,6,0,Spring2018
2392,SE Main & Milport,3661,S,FS,7,3,10,0,Spring2018
2393,SE Main & Scott,3668,S,NS,1,1,2,0,Spring2018
2394,SW Main & Pacific Hwy,3669,N,NS,105,6,111,19,Spring2018
2395,SW Railroad & Washington,3670,N,OP,63,56,119,17,Spring2018
2396,SE Main & Scott,3672,N,OP,0,1,1,1,Spring2018
2397,SW Main & Scoffins,3673,W,NS,111,332,443,39,Spring2018
2398,N Main & NE 10th,3683,N,NS,1,18,19,5,Spring2018
2399,E Main & NE 12th,3687,W,FS,0,8,8,2,Spring2018
2400,E Main & SE 12th,3688,E,NS,8,1,9,3,Spring2018
2401,Main & 13th,3690,N,FS,1,0,1,1,Spring2018
2402,Main & 15th,3693,N,NS,0,0,0,0,Spring2018
2403,E Main & SE 18th,3711,W,OP,4,4,8,0,Spring2018
2404,E Main & SE 18th,3712,E,FS,5,5,10,0,Spring2018
2405,N Main & NE 2nd,3715,N,NS,6,50,56,11,Spring2018
2406,E Main & SE 24th,3716,W,NS,5,2,7,0,Spring2018
2407,E Main & SE 24th,3717,E,NS,4,6,10,0,Spring2018
2408,E Main & SE 26th,3718,W,OP,12,5,17,2,Spring2018
2409,E Main & SE 28th,3719,E,NS,7,11,18,1,Spring2018
2410,SE Main & 3rd,3720,S,NS,0,15,15,2,Spring2018
2411,400 Block SE Main (Estacada City Hall),3724,S,AT,58,43,101,8,Spring2018
2412,N Main & NE 5th,3725,N,NS,2,9,11,5,Spring2018
2413,Main & 8th St,3727,W,NS,16,20,36,6,Spring2018
2414,SW Martinazzi & Boones Ferry,3778,N,NS,29,2,31,4,Spring2018
2415,SW Martinazzi & Seneca,3779,S,NS,4,32,36,2,Spring2018
2416,13700 Block SE McLoughlin,3780,N,AT,3,6,9,5,Spring2018
2417,SE McLoughlin & Boardman,3781,N,FS,47,20,67,6,Spring2018
2418,SE McLoughlin & Chestnut,3782,N,NS,7,6,13,1,Spring2018
2419,SE McLoughlin & Concord,3783,N,FS,77,59,136,26,Spring2018
2420,SE McLoughlin & Courtney,3784,N,FS,46,39,85,32,Spring2018
2421,SE McLoughlin & Holly Farm Mall,3789,N,AT,18,16,34,7,Spring2018
2422,SE McLoughlin & Hull Ave,3790,N,FS,26,10,36,2,Spring2018
2423,SE McLoughlin & Jennings,3791,N,FS,55,25,80,7,Spring2018
2424,SE McLoughlin & Maple,3792,N,NS,23,10,33,3,Spring2018
2425,SE McLoughlin & Naef,3794,N,FS,36,14,50,3,Spring2018
2426,SE McLoughlin & Oak Grove,3795,N,FS,164,141,305,89,Spring2018
2427,SE Ochoco & McLoughlin,3797,W,NS,4,11,15,1,Spring2018
2428,SE McLoughlin & Park Ave,3798,N,FS,45,329,374,60,Spring2018
2429,SE McLoughlin & Risley,3799,N,FS,21,15,36,7,Spring2018
2430,SE McLoughlin & Roethe,3800,N,FS,148,49,197,19,Spring2018
2431,SE McLoughlin & Silver Springs,3801,N,NS,7,13,20,5,Spring2018
2438,SE McLoughlin & Silverleaf,3802,N,OP,13,11,24,2,Spring2018
2439,SE McLoughlin & Vineyard,3807,N,FS,42,28,70,13,Spring2018
2440,12200 Block SE McLoughlin,3810,N,AT,7,10,17,1,Spring2018
2441,600 Block McVey,3811,E,OP,0,0,0,0,Spring2018
2442,600 Block McVey,3812,W,AT,0,0,0,0,Spring2018
2443,McVey & Cornell,3813,W,NS,0,3,3,0,Spring2018
2444,McVey & Cornell,3814,E,FS,2,0,2,0,Spring2018
2445,McVey & Maple,3815,E,NS,2,0,2,0,Spring2018
2446,McVey & Lakefront,3816,W,NS,0,1,1,0,Spring2018
2447,McVey & Oak,3817,W,FS,0,1,1,0,Spring2018
2448,McVey & Oak,3818,E,FS,0,0,0,0,Spring2018
2449,SE McKinley & Jefferson,3825,N,OP,1,3,4,1,Spring2018
2450,13700 Block SE McLoughlin,3827,S,OP,10,9,19,3,Spring2018
2451,SE McLoughlin & Boardman,3829,S,FS,18,36,54,4,Spring2018
2452,SE McLoughlin & Chestnut,3830,S,FS,4,11,15,1,Spring2018
2453,McLoughlin & Clackamette Dr,3831,S,NS,34,60,94,29,Spring2018
2454,16000 Block SE McLoughlin,3832,S,AT,9,21,30,6,Spring2018
2455,SE McLoughlin & Concord,3833,S,FS,57,78,135,23,Spring2018
2456,SE McLoughlin & Courtney,3834,S,NS,37,44,81,33,Spring2018
2457,SE McLoughlin & Hull Ave,3838,S,FS,7,22,29,1,Spring2018
2458,SE McLoughlin & Jennings,3839,S,FS,23,54,77,12,Spring2018
2459,SE McLoughlin & Maple,3840,S,NS,12,36,48,12,Spring2018
2460,SE McLoughlin & Meldrum,3841,S,NS,5,17,22,3,Spring2018
2461,McLoughlin & Oregon City Shopping Center,3842,N,AT,69,43,112,31,Spring2018
2462,SE McLoughlin & Oak Grove,3843,S,FS,119,158,277,92,Spring2018
2463,SE Frontage Rd & Ochoco St,3846,S,FS,15,4,19,1,Spring2018
2464,SE McLoughlin & Park Ave,3848,S,NS,366,46,412,49,Spring2018
2465,SE McLoughlin & Risley,3849,S,FS,10,23,33,8,Spring2018
2466,SE McLoughlin & River Rd,3850,S,FS,15,13,28,6,Spring2018
2467,SE McLoughlin & Roethe,3851,S,FS,53,130,183,23,Spring2018
2468,SE McLoughlin & Silver Springs,3852,S,OP,24,15,39,4,Spring2018
2469,SE McLoughlin & Silverleaf,3853,S,NS,20,18,38,4,Spring2018
2470,8500 Block SE McLoughlin,3854,S,AT,1,2,3,7,Spring2018
2471,SE McLoughlin & Vineyard,3857,S,FS,23,32,55,11,Spring2018
2472,SE McLoughlin & Lakewood,3860,S,OP,2,5,7,1,Spring2018
2473,McNary & Churchill Downs,3862,E,FS,2,0,2,0,Spring2018
2474,McNary & Condolea,3863,W,FS,1,3,4,0,Spring2018
2475,McNary & Condolea,3864,E,OP,4,0,4,0,Spring2018
2476,Meridian Park Hospital Rd & SW 65th,3867,N,NS,2,0,2,0,Spring2018
2477,Meridian Park Hospital Main Stop,3868,N,AT,54,61,115,8,Spring2018
2478,13500 Block SW Millikan,3892,E,OP,10,6,16,2,Spring2018
2479,SE Milwaukie & Center,3908,N,FS,39,27,66,41,Spring2018
2480,SE Milwaukie & Center,3909,S,NS,28,43,71,36,Spring2018
2481,SE Milwaukie & Claybourne,3911,S,NS,18,51,69,15,Spring2018
2482,SE Milwaukie & Claybourne,3912,N,NS,38,16,54,28,Spring2018
2483,SE Milwaukie & Haig,3916,S,NS,16,17,33,3,Spring2018
2484,SE Milwaukie & Haig,3917,N,NS,23,19,42,11,Spring2018
2491,SE Milwaukie & Insley,3921,S,OP,6,18,24,2,Spring2018
2492,SE Milwaukie & Insley,3922,N,FS,21,8,29,1,Spring2018
2493,SE Milwaukie & Long,3928,S,FS,9,17,26,2,Spring2018
2494,SE Milwaukie & Long,3929,N,OP,16,7,23,1,Spring2018
2495,SE Milwaukie & Mall,3931,S,NS,9,22,31,5,Spring2018
2496,SE Milwaukie & Mall,3932,N,NS,25,13,38,5,Spring2018
2497,SE Milwaukie & Mitchell,3933,N,FS,48,16,64,37,Spring2018
2498,SE Milwaukie & Mitchell,3935,S,OP,13,46,59,34,Spring2018
2499,SE Milwaukie & Ramona,3938,S,NS,5,35,40,0,Spring2018
2500,SE Milwaukie & Ramona,3940,N,OP,39,5,44,0,Spring2018
2501,SE Milwaukie & Tolman,3946,S,NS,10,57,67,5,Spring2018
2502,SE Milwaukie & Tolman,3947,N,NS,41,10,51,4,Spring2018
2503,N Mississippi & Beech,3955,N,NS,18,54,72,4,Spring2018
2504,N Mississippi & Failing,3957,S,FS,137,69,206,12,Spring2018
2505,N Mississippi & Failing,3958,N,NS,43,74,117,6,Spring2018
2506,N Mississippi & Mason,3966,N,FS,33,60,93,15,Spring2018
2507,N Mississippi & Mason,3967,S,NS,44,34,78,14,Spring2018
2508,N Mississippi & Skidmore,3976,N,FS,15,27,42,7,Spring2018
2509,N Mississippi & Skidmore,3977,S,NS,33,22,55,7,Spring2018
2510,Molalla & Beverly,3981,S,FS,1,1,2,0,Spring2018
2511,Molalla & Hilda,3983,N,NS,4,5,9,1,Spring2018
2512,Molalla & Hillcrest,3984,N,NS,1,1,2,1,Spring2018
2513,Molalla & Holmes,3985,S,FS,2,5,7,3,Spring2018
2514,Molalla & Pearl,3989,S,NS,2,19,21,4,Spring2018
2515,Molalla & Pearl,3990,N,NS,18,4,22,3,Spring2018
2516,Molalla & Warner,3992,S,NS,2,1,3,0,Spring2018
2517,Molalla & Willamette,3993,S,FS,2,2,4,1,Spring2018
2518,Molalla & Willamette,3994,N,NS,4,3,7,3,Spring2018
2519,Monroe & Boones Ferry Rd,3995,W,FS,1,6,7,0,Spring2018
2520,Monroe & Boones Ferry Rd,3996,E,NS,4,1,5,0,Spring2018
2521,SW Monroe & Greenridge,3997,E,NS,1,0,1,0,Spring2018
2522,NE Morris & 111th,4011,W,NS,3,0,3,0,Spring2018
2523,NE Morris & 117th,4012,E,NS,0,4,4,4,Spring2018
2524,SE Morrison & Grand,4013,W,NS,114,133,247,38,Spring2018
2525,SE Morrison & 12th,4014,W,FS,152,115,267,66,Spring2018
2526,SE Morrison & 14th,4016,W,NS,77,32,109,5,Spring2018
2527,SE Morrison & 16th,4019,W,NS,67,14,81,2,Spring2018
2528,SE Morrison & 18th,4022,W,NS,37,10,47,14,Spring2018
2529,SE Morrison & 20th,4023,W,NS,125,29,154,7,Spring2018
2530,SE Morrison & 9th,4026,W,NS,48,28,76,11,Spring2018
2531,Morrison Bridge,4028,E,AT,6,25,31,2,Spring2018
2532,Morrison Bridge,4029,W,AT,13,9,22,0,Spring2018
2533,10000 Block SE Mt Scott,4032,E,AT,0,5,5,5,Spring2018
2534,9900 Block SE Mt Scott,4033,W,AT,3,0,3,0,Spring2018
2535,SE Mt Scott & 103rd,4035,W,NS,6,3,9,10,Spring2018
2536,SE Mt Scott & 105th,4036,E,OP,2,16,18,8,Spring2018
2537,SE Mt Scott & 105th,4037,W,FS,8,1,9,0,Spring2018
2544,SE Mt Scott & Aspen Summit,4039,E,FS,1,7,8,0,Spring2018
2545,SE Mt Scott & 98th,4040,W,NS,2,0,2,8,Spring2018
2546,NE Multnomah & Grand,4042,E,FS,73,120,193,29,Spring2018
2547,NE Multnomah & Grand,4043,W,NS,62,78,140,31,Spring2018
2548,NE Multnomah & 11th,4044,W,OP,108,52,160,33,Spring2018
2549,NE Multnomah & 13th,4045,W,OP,112,256,368,58,Spring2018
2550,NE Multnomah & 13th,4047,E,FS,153,51,204,23,Spring2018
2551,NE Multnomah & 16th,4048,E,NS,4,12,16,3,Spring2018
2552,NE Multnomah & 16th,4049,W,NS,12,5,17,2,Spring2018
2553,NE Multnomah & 19th,4050,E,OP,1,6,7,0,Spring2018
2554,SW Multnomah & 45th,4052,W,FS,2,1,3,0,Spring2018
2555,NE Multnomah & 9th,4055,E,NS,24,66,90,14,Spring2018
2556,3600 Block SW Murray,4057,S,AT,11,6,17,1,Spring2018
2557,3900 Block SW Murray,4060,N,AT,2,1,3,0,Spring2018
2558,5300 Block SW Murray,4062,S,AT,13,15,28,11,Spring2018
2559,SW Murray & Bonnie Brae,4064,S,NS,2,7,9,0,Spring2018
2560,SW Murray & Bonnie Brae,4065,N,NS,15,4,19,0,Spring2018
2561,SW Murray & Butner,4066,N,FS,10,15,25,1,Spring2018
2562,SW Murray & Butner,4067,S,FS,18,13,31,2,Spring2018
2563,SW Murray & Farmington,4068,S,FS,53,20,73,7,Spring2018
2564,SW Murray & Farmington,4069,N,FS,28,43,71,6,Spring2018
2565,SW Murray & Linda,4077,N,OP,8,9,17,4,Spring2018
2566,SW Murray & Linda,4078,S,NS,6,5,11,0,Spring2018
2567,NW Murray & Milburn,4080,S,NS,10,7,17,0,Spring2018
2568,NW Murray & Science Park Dr,4085,N,FS,9,52,61,3,Spring2018
2569,NW Murray & Science Park Dr,4086,S,NS,56,18,74,6,Spring2018
2570,SW Murray & Tualatin Valley Hwy,4087,N,NS,16,40,56,2,Spring2018
2571,SW Murray & Tualatin Valley Hwy,4088,S,FS,37,11,48,1,Spring2018
2572,SW Murray & Walker,4090,N,FS,20,27,47,9,Spring2018
2573,SW Murray & Walker,4091,S,NS,36,19,55,6,Spring2018
2574,SW Murray & 6th,4095,N,NS,19,13,32,12,Spring2018
2575,SW Nebraska & Corbett,4102,W,NS,2,0,2,0,Spring2018
2576,SW Nebraska & Virginia,4103,E,NS,3,2,5,0,Spring2018
2577,SW Nevada Ct & 54th,4104,W,OP,3,1,4,0,Spring2018
2578,NW Nicolai & 27th,4105,E,NS,4,3,7,0,Spring2018
2579,SW Oak & Armco Ave,4116,E,NS,55,15,70,13,Spring2018
2580,SW Oak & 17th,4119,E,FS,73,44,117,19,Spring2018
2581,SE Oak & 7th,4123,E,NS,67,41,108,25,Spring2018
2582,SE Oak & 9th,4125,E,NS,21,52,73,11,Spring2018
2583,14100 Block SE Oatfield,4136,S,AT,1,2,3,0,Spring2018
2584,SE Oatfield & Oak Grove,4137,N,OP,6,11,17,2,Spring2018
2585,16800 Block SE Oatfield,4138,S,OP,0,0,0,0,Spring2018
2586,16800 Block SE Oatfield,4139,N,AT,0,0,0,0,Spring2018
2587,Oatfield & Stone Oaks Ct,4140,S,OP,0,2,2,0,Spring2018
2588,SE Oatfield & Alchar Dr,4141,W,FS,1,1,2,0,Spring2018
2589,SE Oatfield & Aldercrest,4142,E,NS,2,1,3,0,Spring2018
2590,SE Oatfield & Allan,4143,N,NS,2,0,2,0,Spring2018
2597,SE Oatfield & Allan,4144,S,OP,0,1,1,0,Spring2018
2598,Oatfield & Stone Oaks Ct,4145,N,NS,4,1,5,0,Spring2018
2599,SE Oatfield & Clayson,4146,S,NS,1,2,3,0,Spring2018
2600,SE Oatfield & Clayson,4147,N,OP,2,1,3,0,Spring2018
2601,Oatfield & Collins Crest,4148,S,NS,2,3,5,0,Spring2018
2602,SE Oatfield & Concord,4149,S,NS,4,7,11,1,Spring2018
2603,SE Oatfield & Concord,4150,N,FS,4,5,9,1,Spring2018
2604,SE Oatfield & Courtney,4151,S,NS,3,1,4,0,Spring2018
2605,Oatfield & E Exeter,4154,S,NS,3,7,10,0,Spring2018
2606,Oatfield & Glen Echo,4159,E,NS,7,4,11,0,Spring2018
2607,SE Oatfield & Guilford,4160,S,OP,1,0,1,0,Spring2018
2608,SE Oatfield & Guilford,4161,N,FS,1,1,2,0,Spring2018
2609,Oatfield & E Hereford,4164,S,FS,3,7,10,0,Spring2018
2610,SE Oatfield & Hill,4165,S,OP,0,2,2,4,Spring2018
2611,SE Oatfield & Hill,4166,N,FS,1,0,1,0,Spring2018
2612,SE Oatfield & Jennings,4169,N,NS,2,1,3,0,Spring2018
2613,SE Oatfield & Jennings,4170,S,NS,0,2,2,0,Spring2018
2614,Oatfield & E Kenmore,4171,S,FS,1,4,5,0,Spring2018
2615,SE Oatfield & Loeffelman Rd,4172,S,OP,1,3,4,0,Spring2018
2616,SE Oatfield & Loeffelman Rd,4173,N,FS,2,1,3,0,Spring2018
2617,SE Oatfield & McNary,4174,N,FS,3,1,4,0,Spring2018
2618,SE Oatfield & McNary,4175,S,OP,1,2,3,0,Spring2018
2619,SE Oatfield & Naef,4176,S,OP,0,1,1,0,Spring2018
2620,SE Oatfield & Naef,4177,N,NS,1,1,2,0,Spring2018
2621,SE Oatfield & Oak Grove,4178,S,NS,11,9,20,4,Spring2018
2622,SE Oatfield & Oakland,4179,S,OP,0,2,2,0,Spring2018
2623,SE Oatfield & Oakland,4180,N,FS,3,0,3,0,Spring2018
2624,Oatfield & Oakridge,4181,E,OP,2,5,7,2,Spring2018
2625,Oatfield & Oakridge,4182,W,NS,4,3,7,1,Spring2018
2626,SE Oatfield & Oatfield Ct,4183,S,OP,0,0,0,0,Spring2018
2627,SE Oatfield & Oatfield Ct,4184,N,FS,0,0,0,0,Spring2018
2628,SE Oatfield & Park,4185,S,FS,4,1,5,0,Spring2018
2629,SE Oatfield & Park,4186,N,NS,1,23,24,0,Spring2018
2630,Oatfield & Park Way,4187,W,NS,5,5,10,0,Spring2018
2631,SE Oatfield & Pinehurst,4188,N,FS,0,1,1,0,Spring2018
2632,SE Oatfield & Raymond,4189,S,FS,0,0,0,0,Spring2018
2633,SE Oatfield & Raymond,4190,N,OP,1,0,1,0,Spring2018
2634,Oatfield & Ridgegate,4191,N,NS,5,2,7,0,Spring2018
2635,SE Oatfield & Risley,4192,S,FS,0,1,1,0,Spring2018
2636,SE Oatfield & Risley,4193,N,NS,1,1,2,0,Spring2018
2637,SE Oatfield & Roethe,4194,S,NS,4,12,16,0,Spring2018
2638,SE Oatfield & Roethe,4195,N,FS,5,7,12,0,Spring2018
2639,SE Oatfield & Silver Springs,4198,S,OP,0,1,1,0,Spring2018
2640,SE Oatfield & Silver Springs,4199,N,FS,1,0,1,0,Spring2018
2641,SE Oatfield & Thiessen,4200,N,NS,3,1,4,0,Spring2018
2642,SE Oatfield & Thiessen,4201,S,OP,1,4,5,1,Spring2018
2643,Oatfield & 82nd Dr,4204,E,NS,2,2,4,0,Spring2018
2650,SW Oleson & Alden,4205,S,NS,2,7,9,14,Spring2018
2651,SW Oleson & Garden Home,4206,N,NS,23,15,38,1,Spring2018
2652,SW Oleson & Garden Home,4207,S,FS,10,6,16,0,Spring2018
2653,SW Oleson & Hall,4208,E,FS,8,1,9,2,Spring2018
2654,SW Oleson & Hall,4209,S,NS,1,7,8,0,Spring2018
2655,SW Oleson & Obrien,4210,S,NS,0,1,1,0,Spring2018
2656,SW Oleson & Rustling Leaves Pl,4214,E,FS,2,1,3,0,Spring2018
2657,SW Oleson & Rustling Leaves Pl,4215,W,OP,1,2,3,0,Spring2018
2658,SW Oleson & 80th,4216,N,NS,8,2,10,2,Spring2018
2659,SW Oleson & Skyhar Dr,4217,S,NS,2,5,7,0,Spring2018
2660,SW Oleson & 89th,4218,W,NS,0,2,2,0,Spring2018
2661,SW Oleson & 91st,4219,E,NS,9,2,11,1,Spring2018
2662,SW Oleson & 91st,4220,W,OP,1,6,7,0,Spring2018
2663,SE Orient Dr & Welch Rd,4230,S,FS,0,1,1,0,Spring2018
2664,SE Orient Dr & 14th,4231,S,FS,0,2,2,0,Spring2018
2665,SE Orient Dr & Welch Rd,4243,N,FS,0,0,0,0,Spring2018
2666,11500 Block SW Pacific Hwy,4248,E,AT,8,6,14,0,Spring2018
2667,SW Pacific Hwy & 72nd,4249,W,FS,39,40,79,11,Spring2018
2668,11700 Block SW Pacific Hwy,4252,E,OP,3,8,11,1,Spring2018
2669,11700 Block SW Pacific Hwy,4253,W,AT,4,3,7,1,Spring2018
2670,13400 Block SW Pacific Hwy,4254,W,AT,7,22,29,9,Spring2018
2671,SW Pacific Hwy & McDonald/Gaarde,4255,E,FS,90,14,104,17,Spring2018
2672,16400 Block SW Pacific Hwy,4257,S,AT,0,4,4,1,Spring2018
2673,SW Pacific Hwy & Fischer,4258,S,FS,9,66,75,6,Spring2018
2674,17000 Block SW Pacific Hwy,4259,N,AT,11,3,14,0,Spring2018
2675,SW Pacific Hwy & 124th,4260,W,OP,6,58,64,7,Spring2018
2676,Pacific Ave & A St,4264,W,NS,1,92,93,21,Spring2018
2677,SW Pacific Hwy & Beef Bend,4266,N,OP,15,1,16,0,Spring2018
2678,SW Pacific Hwy & Beef Bend,4267,S,FS,0,17,17,2,Spring2018
2679,SW Pacific Hwy & Bull Mtn,4270,N,NS,30,4,34,2,Spring2018
2680,SW Pacific Hwy & Bull Mtn,4271,S,FS,4,37,41,4,Spring2018
2681,3900 Block Pacific Ave,4272,E,AT,31,8,39,7,Spring2018
2682,SW Pacific Hwy & Canterbury,4273,S,NS,8,43,51,4,Spring2018
2683,SW Pacific Hwy & Canterbury,4274,N,FS,46,8,54,3,Spring2018
2684,Pacific Ave & Cedar,4275,W,NS,2,92,94,10,Spring2018
2685,SW Pacific Hwy & Cipole,4276,E,NS,11,2,13,8,Spring2018
2686,SW Pacific Hwy & Cipole,4277,W,FS,0,9,9,7,Spring2018
2687,Pacific Ave & College Way,4278,W,NS,2,103,105,18,Spring2018
2688,Pacific Ave & Mountain View Ln,4279,W,NS,7,32,39,4,Spring2018
2689,Pacific Ave & Elm,4280,W,NS,4,51,55,41,Spring2018
2690,SW Pacific Hwy & 72nd,4284,E,FS,41,34,75,12,Spring2018
2691,SW Pacific Hwy & Gaarde/McDonald,4286,W,NS,15,77,92,18,Spring2018
2692,10000 Block NE Pacific St,4287,E,AT,140,4,144,71,Spring2018
2693,10000 Block NE Pacific St,4288,W,OP,6,171,177,86,Spring2018
2694,3800 Block Pacific Ave,4289,W,AT,16,36,52,5,Spring2018
2695,SW Pacific Hwy & Hall,4290,E,FS,54,4,58,5,Spring2018
2696,Pacific Ave & Hawthorne,4291,W,NS,5,56,61,24,Spring2018
2703,SW Pacific Hwy & Hazelbrook,4293,N,NS,41,4,45,8,Spring2018
2704,Pacific Ave & Maple,4294,E,NS,80,15,95,23,Spring2018
2705,Pacific Ave & Maple,4295,W,OP,7,71,78,20,Spring2018
2706,Pacific Ave & Oak,4298,E,NS,41,6,47,31,Spring2018
2707,Pacific Ave & Oak,4299,W,FS,14,53,67,44,Spring2018
2708,SW Pacific Hwy & Pacific Dr,4300,W,NS,0,9,9,1,Spring2018
2709,SW Pacific Hwy & 130th,4301,E,FS,7,0,7,0,Spring2018
2710,SW Pacific Hwy & Park,4304,E,NS,7,2,9,0,Spring2018
2711,SW Pacific Hwy & 78th,4305,W,NS,31,38,69,7,Spring2018
2712,Pacific Ave & Quince,4306,E,FS,36,8,44,7,Spring2018
2713,Pacific Ave & Quince,4307,W,FS,6,36,42,10,Spring2018
2714,SW Pacific Hwy & Royal Villa Dr,4308,N,NS,58,5,63,5,Spring2018
2715,2900 Block Pacific Ave,4309,W,AT,39,143,182,68,Spring2018
2716,SW Pacific Hwy & School,4310,W,FS,9,24,33,2,Spring2018
2717,Pacific Ave & Mountain View Ln,4311,E,NS,25,13,38,3,Spring2018
2718,SW Pacific Hwy & 124th,4316,E,FS,21,3,24,1,Spring2018
2719,SW Pacific Hwy & Walnut,4317,E,NS,34,14,48,2,Spring2018
2720,SW Pacific Hwy & Walnut,4318,W,NS,26,37,63,4,Spring2018
2721,SW Pacific Hwy & Warner,4319,W,NS,1,50,51,6,Spring2018
2722,SW Pacific Hwy & Watkins,4320,W,FS,2,11,13,2,Spring2018
2723,SW Pacific Hwy & Watkins,4321,E,OP,8,4,12,0,Spring2018
2724,N Adair & Yew,4322,W,NS,25,100,125,2,Spring2018
2725,Pacific Ave & Yew,4323,E,OP,95,25,120,3,Spring2018
2726,SW Pacific Hwy & 65th,4326,W,FS,22,54,76,2,Spring2018
2727,SW Pacific Hwy & 68th,4327,E,FS,26,19,45,0,Spring2018
2728,SW Pacific Hwy & 69th,4328,W,NS,11,26,37,1,Spring2018
2729,SW Pacific Hwy & 71st,4329,W,FS,7,23,30,3,Spring2018
2730,SW Palatine Hill & Palatine Hill/Palater,4334,W,NS,1,0,1,0,Spring2018
2731,SW Palatine Hill & Riverside,4336,S,FS,0,25,25,1,Spring2018
2732,SW Park Pl & St Clair,4340,W,NS,2,7,9,1,Spring2018
2733,SW Park Pl & Douglas,4341,E,NS,2,1,3,0,Spring2018
2734,SW Park Pl & Green,4343,W,FS,1,1,2,0,Spring2018
2735,SW Park Pl & King,4345,E,NS,0,0,0,0,Spring2018
2736,SW Park Pl & Lewis & Clark,4346,W,NS,0,0,0,0,Spring2018
2737,SW Rose Garden Way & Wright,4351,W,FS,2,1,3,0,Spring2018
2738,10200 Block SW Park Way,4366,E,OP,0,2,2,1,Spring2018
2739,SW Park Way & Cedar Hills,4369,W,FS,0,0,0,0,Spring2018
2740,SW Park Way & Cedar Hills,4370,E,NS,0,4,4,0,Spring2018
2741,SW Park Way & Dellwood,4371,W,NS,0,0,0,0,Spring2018
2742,SW Park Way & Dellwood,4372,E,NS,0,1,1,0,Spring2018
2743,SW Park Way & Devonshire,4374,E,OP,0,0,0,0,Spring2018
2744,SW Park Way & Hicrest,4376,E,NS,1,0,1,0,Spring2018
2745,SW Park Way & Hilldale,4377,W,NS,0,0,0,0,Spring2018
2746,SW Park Way & Huntington,4378,W,NS,0,0,0,0,Spring2018
2747,SW Park Way & Huntington,4379,E,NS,1,0,1,0,Spring2018
2748,SW Park Way & Parkwood,4380,W,NS,0,1,1,0,Spring2018
2749,SW Park Way & Parkwood,4381,E,NS,0,1,1,0,Spring2018
2756,SW Park Way & Tremont,4382,W,NS,0,0,0,0,Spring2018
2757,SW Park Way & Walker,4383,W,NS,0,0,0,0,Spring2018
2758,SW Park Way & Walker,4384,E,FS,0,0,0,0,Spring2018
2759,SW Park Way & Wynwood,4385,W,NS,0,0,0,0,Spring2018
2760,SW Park Way & Wynwood,4386,E,NS,0,0,0,0,Spring2018
2761,13500 Block SW Park Way,4387,W,AT,0,0,0,0,Spring2018
2762,SW Patrick & Council Crest,4410,W,NS,0,0,0,0,Spring2018
2763,3400 Block SW Patton,4413,W,AT,0,1,1,0,Spring2018
2764,SW Patton & Greenway,4415,E,FS,11,0,11,0,Spring2018
2765,SW Patton & Homar,4416,E,OP,5,0,5,0,Spring2018
2766,SW Patton & Montgomery,4417,W,FS,0,6,6,0,Spring2018
2767,SW Patton & Old Orchard,4419,W,OP,0,2,2,0,Spring2018
2768,SW Patton & Old Orchard,4420,E,NS,1,0,1,0,Spring2018
2769,SW Patton & Patton Ct,4422,E,OP,0,0,0,0,Spring2018
2770,SW Patton & Patton Ln,4423,W,OP,0,4,4,0,Spring2018
2771,SW Patton & Patton Ln,4424,E,FS,4,0,4,0,Spring2018
2772,PCC Drive & Springville,4426,S,NS,14,1,15,0,Spring2018
2773,PCC Lower Drive (G St) & H St,4427,E,NS,0,4,4,0,Spring2018
2774,PCC Rock Creek Main Stop,4429,S,AT,588,568,1156,23,Spring2018
2775,PCC Sylvania Main Stop,4431,S,AT,550,555,1105,108,Spring2018
2776,N Peninsular & Farragut,4432,N,FS,1,28,29,1,Spring2018
2777,N Peninsular & Farragut,4433,S,NS,36,2,38,0,Spring2018
2778,N Peninsular & Halleck,4434,N,NS,1,8,9,0,Spring2018
2779,N Peninsular & Halleck,4435,S,NS,21,12,33,4,Spring2018
2780,N Peninsular & Russet,4437,S,FS,47,10,57,7,Spring2018
2781,N Peninsular & Watts,4438,N,FS,0,17,17,0,Spring2018
2782,N Peninsular & Watts,4439,S,NS,23,0,23,0,Spring2018
2783,N Philadelphia & Ivanhoe,4440,E,NS,0,85,85,4,Spring2018
2784,N Philadelphia & Syracuse,4441,W,NS,50,2,52,2,Spring2018
2785,SW Pine & 2nd,4451,S,NS,0,10,10,0,Spring2018
2786,SW Pine & 2nd,4452,N,NS,7,0,7,2,Spring2018
2787,N Rosa Parks Way & Albina,4455,E,NS,18,11,29,3,Spring2018
2788,Portland Ave & W Arlington,4456,S,NS,3,4,7,3,Spring2018
2789,N Rosa Parks Way & Boston,4457,E,NS,11,2,13,2,Spring2018
2790,N Rosa Parks Way & Congress,4458,W,FS,2,15,17,1,Spring2018
2791,N Rosa Parks Way & Congress,4459,E,OP,10,3,13,1,Spring2018
2792,N Rosa Parks Way & Curtis,4461,E,NS,6,2,8,1,Spring2018
2793,Portland Ave & W Dartmouth,4462,S,NS,1,4,5,0,Spring2018
2794,Portland Ave & E Dartmouth,4463,N,NS,25,5,30,3,Spring2018
2795,N Rosa Parks Way & Delaware,4464,W,NS,2,15,17,3,Spring2018
2796,N Rosa Parks Way & Denver,4465,W,NS,4,12,16,1,Spring2018
2797,N Rosa Parks Way & Denver,4466,E,NS,10,5,15,0,Spring2018
2798,Portland Ave & W Fairfield,4467,S,NS,0,1,1,0,Spring2018
2799,Portland Ave & E Fairfield,4468,N,NS,1,0,1,0,Spring2018
2800,N Rosa Parks Way & Greeley,4470,E,FS,9,9,18,5,Spring2018
2801,N Rosa Parks Way & Greeley,4471,W,NS,10,16,26,8,Spring2018
2802,Portland Ave & E Hereford,4472,N,NS,3,0,3,0,Spring2018
2809,N Rosa Parks Way & Interstate,4473,W,NS,56,31,87,25,Spring2018
2810,N Rosa Parks Way & Interstate,4474,E,FS,22,42,64,16,Spring2018
2811,Portland Ave & W Ipswich,4475,S,NS,0,1,1,1,Spring2018
2812,N Rosa Parks Way & Vancouver,4485,W,FS,10,23,33,2,Spring2018
2813,N Rosa Parks Way & Vancouver,4486,E,NS,29,8,37,1,Spring2018
2814,N Portsmouth & Amherst,4491,S,NS,0,8,8,0,Spring2018
2815,N Portsmouth & Depauw,4492,N,FS,15,0,15,0,Spring2018
2816,N Portsmouth & Lombard St,4494,S,NS,4,38,42,22,Spring2018
2817,N Portsmouth & Lombard St,4495,N,NS,47,4,51,15,Spring2018
2818,N Portsmouth & Oberlin,4496,S,NS,1,12,13,0,Spring2018
2819,N Portsmouth & Princeton,4497,N,NS,15,0,15,0,Spring2018
2820,N Portsmouth & Syracuse,4498,S,NS,0,10,10,0,Spring2018
2821,N Portsmouth & Willis,4501,N,NS,40,1,41,0,Spring2018
2822,N Portsmouth & Yale,4502,N,NS,12,0,12,0,Spring2018
2823,10800 Block SE Powell,4503,W,AT,25,8,33,4,Spring2018
2824,10800 Block SE Powell,4504,E,AT,8,33,41,4,Spring2018
2825,SE Powell & 151st,4506,W,FS,39,10,49,0,Spring2018
2826,2900 Block W Powell,4507,E,AT,13,16,29,2,Spring2018
2827,2900 Block W Powell,4508,W,OP,17,9,26,0,Spring2018
2828,W Powell & NW Bella Vista,4513,E,OP,1,2,3,0,Spring2018
2829,W Powell & SW Birdsdale,4515,E,NS,11,16,27,6,Spring2018
2830,W Powell & NW Birdsdale,4516,W,FS,15,14,29,4,Spring2018
2831,E Powell & SE Burnside,4518,W,FS,13,4,17,7,Spring2018
2832,E Powell & SE Cleveland,4520,E,NS,4,2,6,4,Spring2018
2833,E Powell & NE Cleveland,4521,W,FS,3,5,8,0,Spring2018
2834,W Powell & SW Duniway,4522,E,OP,111,131,242,32,Spring2018
2835,W Powell & SW Duniway,4523,W,FS,20,58,78,72,Spring2018
2836,E Powell & NE Hogan,4528,W,NS,3,1,4,2,Spring2018
2837,E Powell & SE Hogan,4529,E,NS,1,4,5,1,Spring2018
2838,E Powell & NE Liberty,4531,E,OP,2,3,5,3,Spring2018
2839,SE Powell & Meadowland Center,4534,E,AT,24,41,65,12,Spring2018
2840,SE Powell & Milwaukie,4537,E,NS,71,60,131,15,Spring2018
2841,SE Powell & Milwaukie,4538,W,FS,195,311,506,83,Spring2018
2842,SE Powell & Milwaukie,4539,N,NS,65,59,124,12,Spring2018
2843,SE Powell & Powell Garage Dr,4542,E,FS,54,69,123,10,Spring2018
2844,SE Powell & Powell Garage Dr,4543,W,FS,65,91,156,7,Spring2018
2845,E Powell & SE Rene,4545,E,FS,13,34,47,7,Spring2018
2846,E Powell & SE Rene,4546,W,OP,20,6,26,1,Spring2018
2847,W Powell & SW Towle,4552,E,FS,10,16,26,6,Spring2018
2848,W Powell & NW Towle,4553,W,FS,11,13,24,5,Spring2018
2849,W Powell & Village Drive,4554,W,FS,34,14,48,4,Spring2018
2850,W Powell & SW Wallula,4555,E,FS,5,9,14,7,Spring2018
2851,W Powell & NW Wallula,4556,W,NS,6,4,10,5,Spring2018
2852,W Powell & SW Walters,4557,E,FS,5,13,18,1,Spring2018
2853,W Powell & SW Walters,4558,W,FS,5,4,9,3,Spring2018
2854,10000 Block SE Powell,4561,W,AT,5,5,10,0,Spring2018
2855,SE Powell & 102nd,4562,E,FS,9,15,24,2,Spring2018
2862,SE Powell & 102nd,4563,W,NS,2,2,4,0,Spring2018
2863,SE Powell & 104th,4564,E,FS,8,17,25,1,Spring2018
2864,SE Powell & 104th,4565,W,OP,17,12,29,0,Spring2018
2865,SE Powell & 112th,4566,W,FS,82,36,118,27,Spring2018
2866,SE Powell & 112th,4567,E,FS,33,74,107,24,Spring2018
2867,SE Powell & 116th,4568,E,OP,4,15,19,0,Spring2018
2868,SE Powell & 116th,4569,W,NS,20,3,23,0,Spring2018
2869,SE Powell & 119th,4570,W,NS,28,7,35,1,Spring2018
2870,SE Powell & 119th,4571,E,NS,10,63,73,5,Spring2018
2871,SE Powell & 122nd,4572,W,FS,177,70,247,30,Spring2018
2872,SE Powell & 122nd,4573,E,FS,168,199,367,61,Spring2018
2873,SE Powell & 124th,4575,W,FS,23,94,117,28,Spring2018
2874,SE Powell & 127th Pl,4576,W,FS,36,11,47,22,Spring2018
2875,SE Powell & 129th,4578,W,NS,44,11,55,8,Spring2018
2876,SE Powell & 130th,4580,E,NS,12,50,62,6,Spring2018
2877,SE Powell & 132nd,4581,W,OP,64,10,74,2,Spring2018
2878,SE Powell & 132nd,4582,E,FS,8,48,56,20,Spring2018
2879,SE Powell & 134th,4583,W,NS,134,22,156,36,Spring2018
2880,SE Powell & 134th,4584,E,OP,7,25,32,9,Spring2018
2881,SE Powell & 136th,4585,E,NS,22,94,116,15,Spring2018
2882,SE Powell & 136th,4586,W,NS,15,19,34,10,Spring2018
2883,SE Powell & 138th,4587,W,NS,15,7,22,4,Spring2018
2884,SE Powell & 138th,4588,E,OP,8,22,30,4,Spring2018
2885,SE Powell & 140th,4591,W,NS,28,5,33,4,Spring2018
2886,SE Powell & 141st,4592,E,NS,3,19,22,0,Spring2018
2887,SE Powell & 143rd,4593,E,NS,4,16,20,1,Spring2018
2888,SE Powell & 145th,4595,W,NS,22,7,29,2,Spring2018
2889,SE Powell & 145th,4596,E,FS,5,20,25,1,Spring2018
2890,SE Powell & 148th,4597,W,FS,50,22,72,3,Spring2018
2891,SE Powell & 148th,4598,E,FS,25,61,86,3,Spring2018
2892,SE Powell & 151st,4599,E,FS,8,20,28,3,Spring2018
2893,SE Powell & 154th,4600,E,FS,7,14,21,1,Spring2018
2894,SE Powell & 157th,4602,E,OP,3,15,18,23,Spring2018
2895,SE Powell & 157th,4603,W,NS,15,4,19,2,Spring2018
2896,SE Powell & 160th,4606,E,FS,10,19,29,1,Spring2018
2897,SE Powell & 160th,4607,W,NS,26,9,35,6,Spring2018
2898,SE Powell & 164th,4609,W,NS,33,10,43,2,Spring2018
2899,SE Powell & Naegeli ,4610,E,FS,6,24,30,2,Spring2018
2900,SE Powell & 166th,4611,W,NS,24,6,30,1,Spring2018
2901,SE Powell & 168th,4612,E,OP,11,42,53,3,Spring2018
2902,SE Powell & 168th,4613,W,FS,37,9,46,4,Spring2018
2903,SE Powell & 170th,4614,W,NS,42,20,62,7,Spring2018
2904,SE Powell & 174th,4615,E,FS,24,74,98,31,Spring2018
2905,SE Powell & 174th,4616,W,NS,86,30,116,38,Spring2018
2906,W Powell & SW 181st,4617,W,OP,124,66,190,42,Spring2018
2907,W Powell & SW Highland,4618,E,FS,116,143,259,91,Spring2018
2908,W Powell & Powell Loop,4620,E,FS,7,9,16,1,Spring2018
2915,W Powell & Powell Loop,4621,W,FS,12,8,20,2,Spring2018
2916,SE Powell & 21st ,4622,E,FS,73,101,174,11,Spring2018
2917,SE Powell & 21st ,4623,W,NS,98,53,151,17,Spring2018
2918,SE Powell & 24th ,4625,E,OP,32,18,50,2,Spring2018
2919,SE Powell & 24th ,4626,W,FS,82,23,105,6,Spring2018
2920,SE Powell & 26th ,4627,E,NS,147,176,323,16,Spring2018
2921,SE Powell & 28th ,4631,W,NS,218,263,481,49,Spring2018
2922,SE Powell Valley & 282nd,4633,E,NS,2,2,4,0,Spring2018
2923,E Powell & SE 3rd ,4638,N,FS,0,0,0,0,Spring2018
2924,E Powell & SE 3rd ,4639,S,OP,0,2,2,0,Spring2018
2925,SE Powell & 33rd,4643,W,FS,73,33,106,8,Spring2018
2926,SE Powell & 33rd,4644,E,NS,42,75,117,7,Spring2018
2927,SE Powell & 34th,4646,W,OP,60,84,144,24,Spring2018
2928,SE Powell & 34th,4647,E,FS,93,74,167,31,Spring2018
2929,SE Powell & 36th Pl,4648,E,FS,14,39,53,1,Spring2018
2930,SE Powell & 36th,4649,W,FS,40,16,56,3,Spring2018
2931,SE Powell & Cesar Chavez Blvd,4651,E,FS,176,298,474,70,Spring2018
2932,SE Powell & Cesar Chavez Blvd,4653,W,FS,264,147,411,53,Spring2018
2933,SE Powell & 40th,4654,W,NS,10,23,33,5,Spring2018
2934,SE Powell & 42nd,4656,E,NS,24,41,65,4,Spring2018
2935,SE Powell & 43rd,4657,W,NS,38,19,57,2,Spring2018
2936,SE Powell & 47th,4662,E,OP,16,48,64,1,Spring2018
2937,SE Powell & 47th,4663,W,FS,19,8,27,1,Spring2018
2938,SE Powell & 49th,4664,W,NS,79,44,123,10,Spring2018
2939,SE Powell & 50th/Foster,4666,E,FS,70,145,215,13,Spring2018
2940,SE Powell & 52nd,4667,E,FS,116,118,234,18,Spring2018
2941,SE Powell & 52nd,4668,W,FS,131,98,229,17,Spring2018
2942,SE Powell & 58th,4674,W,NS,46,19,65,3,Spring2018
2943,SE Powell & 60th,4675,E,FS,15,34,49,4,Spring2018
2944,SE Powell & 62nd,4676,W,FS,21,11,32,2,Spring2018
2945,SE Powell & 65th,4679,E,FS,15,63,78,15,Spring2018
2946,SE Powell & 67th,4680,E,FS,17,28,45,6,Spring2018
2947,SE Powell & 67th,4681,W,FS,43,19,62,3,Spring2018
2948,SE Powell & 69th,4682,E,FS,12,26,38,1,Spring2018
2949,SE Powell & 69th,4683,W,FS,32,12,44,5,Spring2018
2950,SE Powell & 71st,4684,W,NS,79,22,101,5,Spring2018
2951,SE Powell & 72nd,4686,E,NS,22,71,93,32,Spring2018
2952,SE Powell & 79th,4691,E,OP,19,125,144,33,Spring2018
2953,SE Powell & 79th,4692,W,FS,98,11,109,27,Spring2018
2954,SE Powell & 82nd,4693,E,FS,339,314,653,98,Spring2018
2955,SE Powell & 82nd,4695,W,FS,263,223,486,82,Spring2018
2956,SE Powell & 84th,4698,W,FS,18,86,104,9,Spring2018
2957,SE Powell & 86th,4699,E,FS,47,92,139,5,Spring2018
2958,SE Powell & 87th,4700,W,FS,95,48,143,7,Spring2018
2959,SE Powell & 9th,4701,E,NS,2,35,37,1,Spring2018
2960,SE Powell & 9th,4702,W,FS,25,6,31,3,Spring2018
2961,SE Powell & 90th Pl,4704,E,OP,10,27,37,6,Spring2018
2968,SE Powell & 90th Pl ,4706,W,FS,18,8,26,3,Spring2018
2969,SE Powell & 92nd ,4707,E,FS,216,97,313,30,Spring2018
2970,SE Powell & 92nd ,4709,W,FS,102,97,199,29,Spring2018
2971,2800 Block SE Powell Valley,4713,E,AT,5,16,21,9,Spring2018
2972,2800 Block SE Powell Valley,4714,W,AT,7,6,13,5,Spring2018
2973,SE Powell Valley & Hale,4715,E,OP,0,5,5,1,Spring2018
2974,SE Powell Valley & Dogwood,4718,E,FS,1,0,1,0,Spring2018
2975,SE Powell Valley & Dogwood,4719,W,NS,0,1,1,0,Spring2018
2976,SE Powell Valley & Robin,4720,W,OP,8,1,9,1,Spring2018
2977,NE Prescott & 102nd ,4724,E,NS,34,13,47,6,Spring2018
2978,10600 Block NE Prescott,4725,E,AT,6,6,12,0,Spring2018
2979,10700 Block NE Prescott,4726,W,OP,6,5,11,1,Spring2018
2980,9400 Block NE Prescott,4727,E,AT,11,6,17,2,Spring2018
2981,NE Prescott & 102nd,4730,W,FS,19,37,56,10,Spring2018
2982,NE Prescott & 105th,4731,E,NS,35,16,51,1,Spring2018
2983,NE Prescott & 105th,4732,W,NS,15,32,47,2,Spring2018
2984,NE Prescott & 110th,4733,E,NS,8,5,13,1,Spring2018
2985,NE Prescott & 110th,4734,W,OP,6,6,12,0,Spring2018
2986,NE Prescott & 112th,4735,E,NS,12,6,18,1,Spring2018
2987,NE Prescott & 112th,4736,W,NS,6,13,19,3,Spring2018
2988,NE Prescott & 115th,4737,E,FS,11,7,18,2,Spring2018
2989,NE Prescott & 115th,4738,W,NS,8,13,21,6,Spring2018
2990,NE Prescott & 118th,4739,E,OP,4,4,8,1,Spring2018
2991,NE Prescott & 118th,4740,W,NS,4,8,12,1,Spring2018
2992,NE Prescott & 121st Pl,4741,E,NS,23,10,33,3,Spring2018
2993,NE Prescott & 64th,4744,E,NS,4,15,19,0,Spring2018
2994,NE Prescott & 64th,4745,W,NS,20,8,28,0,Spring2018
2995,NE Prescott & 68th,4748,E,NS,16,25,41,35,Spring2018
2996,NE Prescott & 68th,4749,W,FS,25,15,40,16,Spring2018
2997,NE Prescott & 72nd,4752,E,NS,13,22,35,6,Spring2018
2998,NE Prescott & 72nd,4753,W,NS,25,12,37,10,Spring2018
2999,NE Prescott & 77th,4756,E,NS,2,10,12,1,Spring2018
3000,NE Prescott & 77th,4757,W,NS,17,3,20,1,Spring2018
3001,NE Prescott & 82nd,4760,E,NS,21,50,71,6,Spring2018
3002,NE Prescott & 82nd,4761,W,FS,42,17,59,10,Spring2018
3003,NE Prescott & 85th,4762,E,NS,3,3,6,0,Spring2018
3004,NE Prescott & 84th,4763,W,FS,5,7,12,0,Spring2018
3005,NE Prescott & 88th,4764,E,NS,3,7,10,20,Spring2018
3006,NE Prescott & 92nd,4766,E,FS,15,1,16,1,Spring2018
3007,NE Prescott & 92nd,4767,W,NS,1,23,24,3,Spring2018
3008,NE Prescott & 97th,4769,E,OP,4,1,5,0,Spring2018
3009,NE Prescott & 99th,4770,E,NS,3,3,6,1,Spring2018
3010,12600 Block NE Prescott Dr,4772,E,OP,1,9,10,0,Spring2018
3011,NE Prescott Dr & 125th Pl,4773,W,NS,15,1,16,1,Spring2018
3012,NE Prescott Dr & 129th Pl,4774,E,NS,3,10,13,0,Spring2018
3013,NE Prescott Dr & 129th Pl,4775,W,OP,11,0,11,0,Spring2018
3014,NE Prescott Dr & 131st Pl,4776,E,NS,1,11,12,2,Spring2018
3021,NE Prescott Dr & 131st Pl,4777,W,NS,10,0,10,3,Spring2018
3022,NE Prescott Dr & 132nd Pl,4778,W,OP,19,0,19,1,Spring2018
3023,NE Prescott Dr & 133rd,4779,E,NS,2,17,19,8,Spring2018
3024,Railroad & 7th,4784,N,NS,5,12,17,1,Spring2018
3025,NW Thurman & 22nd,4788,W,NS,0,8,8,0,Spring2018
3026,SW Ravensview & Terrace,4799,E,NS,5,0,5,0,Spring2018
3027,SW Redondo & Santa Monica,4801,S,OP,0,1,1,0,Spring2018
3028,NE Regents & 26th,4811,E,NS,2,8,10,0,Spring2018
3029,NE Regents & Ridgewood Dr,4812,W,NS,9,2,11,0,Spring2018
3030,SE Rex & 28th,4813,W,NS,6,0,6,0,Spring2018
3031,SE Rex & 32nd,4816,E,NS,2,16,18,3,Spring2018
3032,N Richmond & Syracuse,4817,N,NS,20,45,65,18,Spring2018
3033,N Richmond & Syracuse,4818,S,NS,197,195,392,105,Spring2018
3034,12500 Block SE River Rd,4819,N,AT,6,2,8,0,Spring2018
3035,12500 Block SE River Rd,4820,S,AT,1,5,6,0,Spring2018
3036,12600 Block SE River Rd,4821,S,OP,1,3,4,0,Spring2018
3037,14000 Block SE River Rd,4822,N,AT,1,0,1,0,Spring2018
3038,14100 Block SE River Rd,4823,S,AT,0,0,0,0,Spring2018
3039,17300 Block SE River Rd,4824,S,AT,0,2,2,0,Spring2018
3040,SE River Rd & Anspach,4831,N,NS,1,0,1,0,Spring2018
3041,SE River Rd & Anspach,4832,S,OP,2,1,3,0,Spring2018
3042,SE River Rd & Boardman,4833,N,NS,2,0,2,0,Spring2018
3043,SE River Rd & Boardman,4834,S,FS,1,4,5,0,Spring2018
3044,SE River Rd & Britton,4835,N,OP,4,0,4,0,Spring2018
3045,SE River Rd & Britton,4836,S,NS,0,3,3,0,Spring2018
3046,SE River Rd & Concord,4837,N,NS,3,0,3,0,Spring2018
3047,SE River Rd & Concord,4838,S,OP,1,2,3,0,Spring2018
3048,SE River Rd & Cooke,4839,S,FS,0,1,1,0,Spring2018
3049,SE River Rd & Courtney,4840,N,NS,3,2,5,0,Spring2018
3050,SE River Rd & Courtney,4841,S,NS,1,3,4,1,Spring2018
3051,SE River Rd & Laurelwood,4844,N,OP,1,0,1,0,Spring2018
3052,SE River Rd & Evergreen,4846,N,NS,5,1,6,2,Spring2018
3053,SE River Rd & Evergreen,4847,S,OP,2,9,11,1,Spring2018
3054,SE River Rd & Hull Ave,4849,N,NS,0,1,1,0,Spring2018
3055,SE River Rd & Hull Ave,4850,S,FS,1,1,2,0,Spring2018
3056,SE River Rd & Jennings,4851,N,NS,2,0,2,0,Spring2018
3057,SE River Rd & Jennings,4852,S,NS,0,1,1,0,Spring2018
3058,SE River Rd & Juniper Dr,4853,N,OP,1,0,1,0,Spring2018
3059,SE River Rd & Juniper Dr,4854,S,NS,0,2,2,0,Spring2018
3060,SE River Rd & Maple,4857,N,NS,3,2,5,0,Spring2018
3061,SE River Rd & Maple,4858,S,FS,2,3,5,0,Spring2018
3062,SE River Rd & Meldrum,4860,N,NS,2,0,2,0,Spring2018
3063,SE River Rd & Meldrum,4861,S,NS,1,1,2,0,Spring2018
3064,SE River Rd & Mulberry,4862,N,OP,1,0,1,0,Spring2018
3065,SE River Rd & Mulberry,4863,S,FS,0,1,1,0,Spring2018
3066,SE River Rd & Naef,4864,N,FS,1,0,1,0,Spring2018
3067,SE River Rd & Oak Grove,4865,N,NS,19,6,25,1,Spring2018
3074,SE River Rd & Oak Grove,4866,S,FS,7,15,22,0,Spring2018
3075,SE River Rd & Parkview Circle,4867,N,NS,3,1,4,0,Spring2018
3076,SE River Rd & River Dr,4870,N,OP,3,1,4,0,Spring2018
3077,SE River Rd & River Dr,4871,S,NS,1,1,2,0,Spring2018
3078,SE River Rd & River Forest,4874,S,FS,2,3,5,0,Spring2018
3079,SE River Rd & River Glen Ct,4875,N,OP,0,0,0,0,Spring2018
3080,SE River Rd & River Glen Ct,4876,S,FS,0,0,0,0,Spring2018
3081,SE River Rd & Cooke,4878,N,OP,0,0,0,0,Spring2018
3082,SE River Rd & Roethe,4879,N,NS,0,0,0,0,Spring2018
3083,SE River Rd & Roethe,4880,S,OP,0,1,1,0,Spring2018
3084,SE River Rd & Rogers,4881,N,NS,1,1,2,0,Spring2018
3085,SE River Rd & Rosebrier,4883,N,NS,1,1,2,0,Spring2018
3086,SE River Rd & Rosebrier,4884,S,OP,1,0,1,0,Spring2018
3087,SE River Rd & Swain,4888,N,FS,3,0,3,0,Spring2018
3088,SE River Rd & Swain,4889,S,OP,0,2,2,0,Spring2018
3089,SE River Rd & Torbank,4891,N,NS,7,3,10,1,Spring2018
3090,SE River Rd & Wren,4892,N,NS,2,1,3,0,Spring2018
3091,SW Riverside & Briarwood,4894,S,OP,0,2,2,0,Spring2018
3092,SW Riverside & Briarwood,4895,N,NS,2,0,2,0,Spring2018
3093,SW Riverside & Elk Rock,4896,N,FS,0,1,1,0,Spring2018
3094,SW Riverside & Greenwood,4897,N,OP,1,0,1,0,Spring2018
3095,SW Riverside & Breyman,4898,S,NS,0,2,2,0,Spring2018
3096,SW Riverside & Midvale,4899,S,FS,1,0,1,0,Spring2018
3097,SW Riverside & Military,4900,S,NS,1,3,4,0,Spring2018
3098,SW Riverside & Military,4901,N,NS,3,1,4,0,Spring2018
3099,SW Riverside & Palatine Hill,4902,S,FS,0,1,1,0,Spring2018
3100,SW Riverside & Palatine Hill,4904,N,OP,1,0,1,0,Spring2018
3101,SW Riverside & Radcliffe,4905,S,FS,0,3,3,0,Spring2018
3102,SW Riverside & Riverdale,4906,S,NS,1,4,5,0,Spring2018
3103,SW Riverside & Riverdale,4908,N,OP,4,1,5,0,Spring2018
3104,SW Riverside & Riverwood,4909,S,OP,0,0,0,0,Spring2018
3105,SW Riverside & Riverwood,4910,N,NS,0,0,0,0,Spring2018
3106,N Riverside Way & 33rd Dr,4912,E,NS,0,19,19,0,Spring2018
3107,SE Roots & 79th,4934,W,FS,0,0,0,0,Spring2018
3108,SE Roots & Hearthwood Dr,4935,E,NS,1,2,3,3,Spring2018
3109,SE Roots & Johnson,4937,W,NS,3,1,4,2,Spring2018
3110,SE Roots & Lark,4938,W,NS,2,1,3,0,Spring2018
3111,SE Roots & Rickshire,4939,E,OP,1,0,1,0,Spring2018
3112,SE Roots & Rickshire,4941,W,NS,0,0,0,0,Spring2018
3113,SE Webster & Roots,4943,N,FS,1,0,1,2,Spring2018
3114,SE Roots & 79th,4945,E,NS,0,0,0,0,Spring2018
3115,SE Roots & 81st,4946,E,FS,4,2,6,0,Spring2018
3116,13600 Block NE Rose Parkway,4955,E,AT,1,2,3,0,Spring2018
3117,NE Rose Parkway & 141st,4958,E,NS,2,1,3,0,Spring2018
3118,NE Rose Parkway & 143rd,4960,E,OP,1,4,5,1,Spring2018
3119,Ross Island Bridge,4964,E,AT,26,20,46,1,Spring2018
3120,NE Sacramento & 142nd,4979,E,NS,0,1,1,0,Spring2018
3127,NE Sacramento & 142nd,4980,W,FS,1,0,1,0,Spring2018
3128,NE Sacramento & 146th Dr,4982,W,NS,2,0,2,1,Spring2018
3129,NE Sacramento & Brazee Ct,4984,W,NS,2,0,2,0,Spring2018
3130,NE Sacramento & 132nd,4987,W,NS,5,0,5,0,Spring2018
3131,NE Sacramento & 134th Pl,4988,E,NS,0,1,1,0,Spring2018
3132,NE Sacramento & 138th Pl,4990,E,NS,1,4,5,10,Spring2018
3133,NE Sacramento & 138th Pl,4991,W,NS,4,0,4,8,Spring2018
3134,14600 Block NE Sacramento,4993,E,OP,5,5,10,1,Spring2018
3135,NE Sacramento & 148th,4994,E,NS,0,0,0,0,Spring2018
3136,7800 Block SW Sagert,4999,E,AT,0,4,4,0,Spring2018
3137,SW Sagert & Wampanoag,5001,E,FS,0,14,14,1,Spring2018
3138,SW Sagert & 70th,5002,E,FS,0,24,24,1,Spring2018
3139,SW Sagert & 72nd,5003,E,FS,0,6,6,0,Spring2018
3140,SW Sagert & 86th,5004,E,NS,3,3,6,0,Spring2018
3141,SW Salmon & 19th,5006,E,FS,2,17,19,0,Spring2018
3142,SW Salmon & Park,5007,E,NS,109,81,190,22,Spring2018
3143,SW Salmon & 10th,5009,E,NS,107,55,162,54,Spring2018
3144,SW Salmon & 12th,5012,E,FS,73,72,145,56,Spring2018
3145,SW Salmon & 14th,5014,E,NS,69,90,159,5,Spring2018
3146,SW Salmon & 16th,5016,E,OP,2,68,70,0,Spring2018
3147,SW Salmon & 20th,5018,W,FS,6,4,10,0,Spring2018
3148,SW Salmon & 20th,5019,E,NS,2,2,4,0,Spring2018
3149,SW Salmon & 5th,5020,E,NS,512,532,1044,106,Spring2018
3150,NW Barnes & Saltzman,5025,S,FS,42,11,53,15,Spring2018
3151,SW Sam Jackson Pk & Campus Dr,5027,E,NS,76,22,98,12,Spring2018
3152,SW Sam Jackson Pk & OHSU,5028,E,AT,565,332,897,94,Spring2018
3153,SW Sam Jackson Pk & US Veterans,5032,E,FS,445,529,974,55,Spring2018
3154,NE San Rafael & 125th,5033,E,FS,1,0,1,0,Spring2018
3155,NE San Rafael & 125th,5034,W,FS,2,2,4,0,Spring2018
3156,NE San Rafael & 122nd,5035,E,FS,6,4,10,7,Spring2018
3157,NE San Rafael & 122nd,5036,W,NS,3,6,9,0,Spring2018
3158,NE San Rafael & 128th,5037,E,OP,0,1,1,0,Spring2018
3159,NE San Rafael & 132nd,5039,E,NS,0,2,2,0,Spring2018
3160,NE Sandy & Flanders,5044,E,NS,52,78,130,24,Spring2018
3161,NE Sandy & Fremont,5045,E,NS,20,32,52,16,Spring2018
3162,NE Sandy & Grotto,5046,E,AT,5,13,18,3,Spring2018
3163,NE Sandy & Imperial,5048,E,FS,7,14,21,9,Spring2018
3164,NE Sandy & Lawrence,5049,E,FS,9,24,33,4,Spring2018
3165,NE Sandy & Parkrose Transit Center,5050,W,AT,0,345,345,1,Spring2018
3166,NE Sandy & Prescott,5051,E,FS,3,32,35,4,Spring2018
3167,NE Sandy & Prescott,5052,W,FS,14,3,17,4,Spring2018
3168,NE Sandy & Sacramento,5054,E,FS,7,29,36,3,Spring2018
3169,NE Sandy & 14th,5058,W,NS,56,35,91,12,Spring2018
3170,NE Sandy & 16th,5060,W,NS,80,36,116,24,Spring2018
3171,NE Sandy & 18th,5061,E,NS,76,98,174,40,Spring2018
3172,NE Sandy & 18th,5062,W,FS,102,61,163,62,Spring2018
3173,NE Sandy & 20th,5063,W,NS,104,71,175,28,Spring2018
3180,NE Sandy & 24th,5066,E,FS,46,73,119,6,Spring2018
3181,NE Sandy & 24th,5067,W,NS,50,31,81,4,Spring2018
3182,NE Sandy & 26th,5068,W,FS,11,12,23,1,Spring2018
3183,NE Sandy & 28th,5069,W,NS,58,54,112,19,Spring2018
3184,NE Sandy & 28th,5070,E,NS,44,64,108,14,Spring2018
3185,NE Sandy & 31st,5076,E,FS,17,40,57,7,Spring2018
3186,NE Sandy & 31st,5077,W,FS,29,15,44,5,Spring2018
3187,NE Sandy & 33rd,5079,E,FS,47,85,132,60,Spring2018
3188,NE Sandy & 33rd,5080,W,NS,81,47,128,60,Spring2018
3189,NE Sandy & 35th,5081,W,FS,17,10,27,3,Spring2018
3190,NE Sandy & 42nd,5087,E,FS,170,222,392,86,Spring2018
3191,NE Sandy & 44th,5091,E,FS,32,26,58,11,Spring2018
3192,NE Sandy & 47th,5093,W,NS,46,13,59,7,Spring2018
3193,NE Sandy & 47th,5094,E,FS,19,44,63,4,Spring2018
3194,NE Sandy & 50th,5097,E,FS,7,25,32,4,Spring2018
3195,NE Sandy & 50th,5098,W,FS,24,7,31,3,Spring2018
3196,NE Sandy & 52nd,5100,W,FS,30,9,39,2,Spring2018
3197,NE Sandy & 54th,5102,E,OP,7,46,53,1,Spring2018
3198,NE Sandy & 54th,5103,W,NS,46,9,55,1,Spring2018
3199,NE Sandy & 57th,5104,E,NS,21,127,148,38,Spring2018
3200,NE Sandy & 57th,5105,W,NS,112,31,143,35,Spring2018
3201,NE Sandy & 59th,5107,W,NS,15,3,18,1,Spring2018
3202,NE Sandy & 60th,5110,E,FS,4,19,23,2,Spring2018
3203,NE Sandy & 62nd,5112,E,FS,7,41,48,1,Spring2018
3204,NE Sandy & 62nd,5113,W,NS,28,7,35,3,Spring2018
3205,NE Sandy & 64th,5114,W,NS,43,3,46,1,Spring2018
3206,NE Sandy & 65th,5115,E,NS,4,25,29,1,Spring2018
3207,NE Sandy & 67th,5118,E,NS,4,55,59,6,Spring2018
3208,NE Sandy & 67th,5119,W,NS,39,4,43,2,Spring2018
3209,NE Sandy & 69th,5122,W,OP,85,37,122,41,Spring2018
3210,NE Sandy & 70th,5123,E,FS,32,116,148,55,Spring2018
3211,NE Sandy & Fremont,5125,W,FS,69,25,94,36,Spring2018
3212,NE Sandy & 74th,5127,W,NS,34,12,46,8,Spring2018
3213,NE Sandy & 77th,5132,E,NS,2,31,33,1,Spring2018
3214,NE Sandy & 77th,5133,W,NS,32,2,34,1,Spring2018
3215,NE Sandy & 79th,5135,E,FS,6,48,54,1,Spring2018
3216,NE Sandy & 79th,5136,W,FS,50,9,59,2,Spring2018
3217,NE Sandy & 82nd,5138,E,FS,90,139,229,46,Spring2018
3218,NE Sandy & 82nd,5139,W,NS,147,98,245,35,Spring2018
3219,NE Sandy & 86th,5140,W,FS,23,3,26,2,Spring2018
3220,NE Sandy & 88th,5144,W,FS,20,6,26,8,Spring2018
3221,NE Sandy & 91st,5145,W,NS,26,3,29,1,Spring2018
3222,NE Sandy & 92nd,5146,E,NS,0,10,10,1,Spring2018
3223,2500 Block of NE Saratoga,5148,W,AT,96,95,191,20,Spring2018
3224,NE Saratoga & Dekum,5150,S,NS,15,1,16,1,Spring2018
3225,4900 Block SW Scholls Ferry,5152,W,AT,2,21,23,1,Spring2018
3226,5000 Block SW Scholls Ferry,5153,W,AT,17,33,50,4,Spring2018
3233,5900 Block SW Scholls Ferry (Crosswalk),5155,S,OP,0,1,1,0,Spring2018
3234,5900 Block SW Scholls Ferry (Crosswalk),5156,N,AT,1,0,1,0,Spring2018
3235,6700 Block SW Scholls Ferry,5157,S,AT,15,34,49,0,Spring2018
3236,6700 Block SW Scholls Ferry,5158,N,AT,17,9,26,0,Spring2018
3237,7700 Block SW Scholls Ferry,5159,S,AT,3,5,8,12,Spring2018
3238,8600 Block SW Scholls Ferry,5160,N,AT,22,5,27,1,Spring2018
3239,8600 Block SW Scholls Ferry,5161,S,OP,4,37,41,1,Spring2018
3240,SW Scholls Ferry & Allen,5162,N,FS,29,9,38,0,Spring2018
3241,SW Scholls Ferry & Cascade,5164,S,FS,7,7,14,0,Spring2018
3242,SW Scholls Ferry & Conestoga,5165,E,OP,21,23,44,2,Spring2018
3243,SW Scholls Ferry & Conestoga,5166,W,FS,16,17,33,12,Spring2018
3244,SW Scholls Ferry & Crestwood,5167,S,FS,0,5,5,0,Spring2018
3245,SW Scholls Ferry & Crestwood,5168,N,OP,4,1,5,0,Spring2018
3246,SW Scholls Ferry & Crystal,5169,S,NS,1,6,7,0,Spring2018
3247,SW Scholls Ferry & Crystal,5170,N,OP,5,2,7,11,Spring2018
3248,SW Scholls Ferry & Merry,5171,S,OP,3,15,18,0,Spring2018
3249,SW Scholls Ferry & Dogwood Lane,5172,W,NS,0,0,0,0,Spring2018
3250,SW Scholls Ferry & Eagle,5173,N,FS,3,1,4,13,Spring2018
3251,SW Scholls Ferry & Heather,5175,N,FS,21,11,32,10,Spring2018
3252,SW Scholls Ferry & Heather,5176,S,FS,10,18,28,9,Spring2018
3253,SW Scholls Ferry & Marjorie,5180,S,NS,3,10,13,1,Spring2018
3254,SW Scholls Ferry & Marjorie,5181,N,OP,13,3,16,1,Spring2018
3255,SW Scholls Ferry & Merry,5182,N,NS,18,4,22,1,Spring2018
3256,SW Scholls Ferry & BH Hwy,5184,W,FS,19,53,72,6,Spring2018
3257,SW Scholls Ferry & Montclair,5185,E,NS,1,2,3,0,Spring2018
3258,SW Scholls Ferry & Stephen Lane,5186,E,NS,9,6,15,0,Spring2018
3259,SW Scholls Ferry & Nicol,5187,E,FS,12,7,19,0,Spring2018
3260,SW Scholls Ferry & Nicol,5188,W,OP,6,14,20,0,Spring2018
3261,SW Scholls Ferry & Nimbus,5189,W,FS,28,29,57,4,Spring2018
3262,SW Scholls Ferry & Nimbus,5190,E,FS,27,40,67,3,Spring2018
3263,5200 Block SW Scholls Ferry,5192,W,AT,2,2,4,1,Spring2018
3264,5100 Block SW Scholls Ferry,5193,E,AT,35,18,53,3,Spring2018
3265,4400 Block SW Scholls Ferry,5194,N,OP,0,0,0,0,Spring2018
3266,SW Scholls Ferry & Seymour,5195,S,OP,0,0,0,0,Spring2018
3267,SW Scholls Ferry & Seymour,5196,N,FS,0,0,0,0,Spring2018
3268,SW Scholls Ferry & Springwood,5197,E,FS,20,8,28,1,Spring2018
3269,6800 Block SW Scholls Ferry,5198,S,AT,0,0,0,0,Spring2018
3270,4400 Block SW Scholls Ferry,5199,S,AT,0,0,0,0,Spring2018
3271,SW Scholls Ferry & 86th,5200,S,OP,0,2,2,0,Spring2018
3272,SW Scholls Ferry & 86th,5201,N,FS,1,0,1,0,Spring2018
3273,SW Scholls Ferry & 88th,5202,W,OP,0,2,2,0,Spring2018
3274,SW Scholls Ferry & 88th,5203,E,FS,1,0,1,0,Spring2018
3275,SW Scholls Ferry & 90th,5204,E,NS,12,2,14,0,Spring2018
3276,SW Scholls Ferry & 90th,5205,W,OP,2,10,12,0,Spring2018
3277,SW Scholls Ferry & 92nd,5206,E,FS,8,1,9,0,Spring2018
3278,SW Scholls Ferry & 92nd,5207,W,FS,3,23,26,0,Spring2018
3279,SW Shattuck & 60th,5221,N,NS,5,6,11,0,Spring2018
3286,SW Shattuck & 63rd,5222,E,FS,0,0,0,0,Spring2018
3287,NE Shaver & 135th,5223,E,OP,3,8,11,2,Spring2018
3288,NE Shaver & 102nd,5225,W,NS,4,2,6,1,Spring2018
3289,NE Shaver & 105th,5226,E,NS,1,9,10,3,Spring2018
3290,NE Shaver & 105th,5227,W,NS,11,1,12,5,Spring2018
3291,NE Shaver & 109th,5228,E,NS,2,8,10,4,Spring2018
3292,NE Shaver & 109th,5229,W,NS,9,4,13,2,Spring2018
3293,NE Shaver & 112th,5230,E,NS,1,5,6,1,Spring2018
3294,NE Shaver & 112th,5231,W,NS,5,1,6,0,Spring2018
3295,NE Shaver & 114th,5232,E,NS,0,5,5,0,Spring2018
3296,NE Shaver & 122nd,5234,E,NS,11,12,23,9,Spring2018
3297,NE Shaver & 122nd,5235,W,NS,15,11,26,11,Spring2018
3298,NE Shaver & 134th,5236,W,OP,1,0,1,0,Spring2018
3299,NE Shaver & 135th,5237,W,FS,5,0,5,0,Spring2018
3300,NE Shaver & 138th,5238,W,FS,8,0,8,0,Spring2018
3301,SW Sheridan & 4th,5239,E,FS,25,15,40,1,Spring2018
3302,SW Sherwood & Sherwood Middle School,5244,N,AT,2,0,2,3,Spring2018
3303,21900 Block N Sherwood Blvd,5245,S,AT,0,4,4,3,Spring2018
3304,N Sherwood Blvd & NW Gleneagle,5246,S,NS,0,5,5,0,Spring2018
3305,N Sherwood & SW 10th,5247,N,OP,4,0,4,0,Spring2018
3306,SW Sherwood Blvd & NW 12th St,5248,S,NS,0,6,6,1,Spring2018
3307,N Sherwood & SW Century,5249,N,NS,7,1,8,0,Spring2018
3308,NE Skidmore & 122nd,5250,E,NS,74,20,94,5,Spring2018
3309,NE Skidmore & 29th,5253,E,NS,33,1,34,0,Spring2018
3310,1700 Block South Shore,5285,W,AT,0,0,0,0,Spring2018
3311,1800 Block South Shore (Park & Ride),5286,W,AT,0,1,1,0,Spring2018
3312,1800 Block South Shore (Park & Ride),5287,E,OP,1,1,2,0,Spring2018
3313,2500 Block South Shore,5288,W,AT,0,0,0,0,Spring2018
3314,3800 Block South Shore,5289,W,AT,0,0,0,0,Spring2018
3315,4100 Block South Shore,5290,W,AT,0,0,0,0,Spring2018
3316,4100 Block South Shore,5291,S,OP,0,0,0,0,Spring2018
3317,4300 Block South Shore,5292,N,AT,0,0,0,0,Spring2018
3318,South Shore & Blue Heron,5293,N,FS,0,0,0,0,Spring2018
3319,South Shore & Canyon,5294,E,FS,1,0,1,0,Spring2018
3320,South Shore & Cedar Ct,5295,W,FS,0,2,2,0,Spring2018
3321,South Shore & Fernwood,5296,W,OP,0,1,1,0,Spring2018
3322,South Shore & Cedar Rd,5297,W,OP,1,1,2,22,Spring2018
3323,South Shore & Edgecliff,5298,W,FS,0,0,0,0,Spring2018
3324,South Shore & Fernwood,5299,E,NS,1,0,1,0,Spring2018
3325,South Shore & Greenbrier,5300,W,FS,0,1,1,0,Spring2018
3326,South Shore & Greentree,5301,W,OP,1,2,3,0,Spring2018
3327,South Shore & Greentree,5302,E,NS,2,0,2,0,Spring2018
3328,South Shore & Kelok,5303,E,NS,0,0,0,0,Spring2018
3329,South Shore & Lakeridge,5304,E,FS,2,0,2,0,Spring2018
3330,Lakeview & South Shore,5305,E,NS,0,0,0,0,Spring2018
3331,South Shore & Maple,5306,W,FS,0,0,0,0,Spring2018
3332,McVey & Parrish,5307,E,NS,2,1,3,0,Spring2018
3339,South Shore & Patton,5309,W,NS,1,4,5,0,Spring2018
3340,South Shore & Canal Circle,5311,E,FS,0,0,0,0,Spring2018
3341,SE Sparrow & 22nd,5312,E,FS,0,0,0,0,Spring2018
3342,SW Spring & Vista,5313,W,NS,12,0,12,0,Spring2018
3343,SW Spring Garden & 11th,5314,E,NS,0,5,5,0,Spring2018
3344,SW Spring Garden & 14th,5315,E,NS,0,5,5,0,Spring2018
3345,SW Spring Garden & 14th,5316,W,NS,7,0,7,1,Spring2018
3346,SW Spring Garden & 17th,5317,E,NS,1,12,13,0,Spring2018
3347,SW Spring Garden & 17th,5318,W,NS,14,1,15,0,Spring2018
3348,SW 19th & Spring Garden,5319,N,FS,1,1,2,0,Spring2018
3349,NW Springville & 185th,5320,W,NS,0,0,0,0,Spring2018
3350,6600 Block NW St Helens,5328,S,AT,3,1,4,0,Spring2018
3351,6600 Block NW St Helens,5329,N,OP,1,2,3,0,Spring2018
3352,6800 Block NW St Helens,5330,N,OP,1,2,3,0,Spring2018
3353,NW St Helens & Milepost 8,5332,N,AT,0,0,0,0,Spring2018
3354,NW St Helens & Milepost 8,5333,S,FS,0,0,0,0,Spring2018
3355,NW St Helens & Bridge,5336,S,NS,4,0,4,0,Spring2018
3356,NW St Helens & Doane,5338,N,FS,0,1,1,0,Spring2018
3357,NW St Helens & Doane,5339,S,OP,1,0,1,0,Spring2018
3358,11400 Block NW St Helens,5341,N,AT,2,5,7,1,Spring2018
3359,11400 Block NW St Helens,5342,S,OP,1,0,1,0,Spring2018
3360,NW St Helens & Harbor,5344,S,NS,1,0,1,0,Spring2018
3361,NW St Helens & Hoge,5345,N,OP,0,2,2,0,Spring2018
3362,NW St Helens & Hoge,5346,S,FS,2,0,2,0,Spring2018
3363,9400 Block NW St Helens,5350,N,AT,0,1,1,0,Spring2018
3364,NW St Helens & Front,5352,N,NS,2,5,7,0,Spring2018
3365,NW St Helens & Front,5353,S,OP,5,2,7,0,Spring2018
3366,NW St Helens & 105th,5354,N,FS,0,0,0,0,Spring2018
3367,NW St Helens & 105th,5355,S,FS,1,0,1,0,Spring2018
3368,NW St Helens & 107th,5356,N,NS,0,5,5,4,Spring2018
3369,NW St Helens & 107th,5357,S,OP,6,0,6,4,Spring2018
3370,NW St Helens & 109th,5358,N,NS,0,1,1,0,Spring2018
3371,NW St Helens & 111th,5359,N,OP,3,4,7,0,Spring2018
3372,NW St Helens & 56th,5361,N,OP,1,0,1,0,Spring2018
3373,NW St Helens & 56th,5362,S,NS,1,0,1,0,Spring2018
3374,N St Louis & New York,5373,E,NS,10,4,14,0,Spring2018
3375,N St Louis & Seneca,5374,W,NS,2,16,18,19,Spring2018
3376,N St Louis & Smith,5375,W,NS,1,12,13,0,Spring2018
3377,N St Louis & Smith,5376,E,NS,9,2,11,1,Spring2018
3378,St Vincent Hospital Dr & Barnes,5377,S,NS,7,7,14,3,Spring2018
3379,St Vincent Hospital East Pavilion,5378,W,AT,76,86,162,57,Spring2018
3380,St Vincent Hospital Main Stop,5379,W,AT,59,53,112,31,Spring2018
3381,NE Stanton & 117th,5384,W,NS,3,1,4,5,Spring2018
3382,NE Stanton & 121st,5385,W,NS,3,0,3,0,Spring2018
3383,NE Stanton & 122nd,5386,E,NS,0,4,4,0,Spring2018
3384,SE Stark & 182nd,5390,W,OP,58,53,111,17,Spring2018
3385,21000 Block SE Stark,5391,W,AT,14,7,21,8,Spring2018
3392,21000 Block SE Stark,5392,E,NS,5,16,21,7,Spring2018
3393,SE Stark & 215th,5393,W,OP,10,3,13,0,Spring2018
3394,9200 Block SE Stark,5394,W,AT,44,20,64,7,Spring2018
3395,SE Stark & 139th,5395,W,FS,71,25,96,20,Spring2018
3396,SE Stark & NE Hale,5397,E,NS,14,84,98,22,Spring2018
3397,SE Stark & SW McGinnis,5398,W,FS,57,15,72,13,Spring2018
3398,SE Stark & NE Kelly,5404,E,NS,4,4,8,6,Spring2018
3399,SE Stark & 238th,5407,W,NS,31,9,40,20,Spring2018
3400,SE Stark & Mt Hood Comm College Entrance,5408,E,FS,0,1,1,1,Spring2018
3401,SE Stark & SW Corbeth Lane,5409,W,NS,2,0,2,0,Spring2018
3402,SE Stark & Medical Center,5410,E,NS,31,41,72,54,Spring2018
3403,SE Stark & NE Rene,5411,W,OP,26,11,37,8,Spring2018
3404,SE Stark & 105th,5414,W,FS,36,59,95,17,Spring2018
3405,SE Stark & 108th,5415,W,NS,27,45,72,8,Spring2018
3406,SE Stark & 111th,5416,E,NS,11,11,22,22,Spring2018
3407,SE Stark & 111th,5417,W,NS,12,6,18,15,Spring2018
3408,SE Stark & 113th,5418,E,FS,5,17,22,1,Spring2018
3409,SE Stark & 113th,5419,W,NS,13,6,19,6,Spring2018
3410,SE Stark & 117th,5421,E,NS,10,27,37,1,Spring2018
3411,SE Stark & 117th,5422,W,FS,33,11,44,11,Spring2018
3412,SE Stark & 119th,5423,E,NS,8,28,36,19,Spring2018
3413,SE Stark & 119th,5424,W,NS,23,8,31,5,Spring2018
3414,SE Stark & 122nd,5425,E,FS,156,126,282,66,Spring2018
3415,SE Stark & 122nd,5426,W,NS,116,169,285,58,Spring2018
3416,SE Stark & 130th,5431,E,FS,34,58,92,14,Spring2018
3417,SE Stark & 133rd,5432,E,OP,35,56,91,15,Spring2018
3418,SE Stark & 133rd,5433,W,FS,58,40,98,17,Spring2018
3419,SE Stark & 139th,5436,E,FS,24,69,93,17,Spring2018
3420,SE Stark & 143rd,5439,E,OP,19,48,67,7,Spring2018
3421,SE Stark & 146th,5442,W,FS,19,9,28,12,Spring2018
3422,SE Stark & 148th,5443,W,NS,53,35,88,7,Spring2018
3423,SE Stark & 148th,5444,E,FS,50,66,116,18,Spring2018
3424,SE Stark & 151st,5445,E,FS,10,15,25,1,Spring2018
3425,SE Stark & 151st,5446,W,NS,19,10,29,8,Spring2018
3426,SE Stark & 155th,5448,E,FS,8,30,38,13,Spring2018
3427,SE Stark & 160th,5452,E,FS,38,106,144,40,Spring2018
3428,SE Stark & 160th,5453,W,FS,72,34,106,27,Spring2018
3429,SE Stark & 162nd,5454,E,FS,75,72,147,80,Spring2018
3430,SE Stark & 162nd,5455,W,NS,94,66,160,62,Spring2018
3431,SE Stark & 165th,5457,W,FS,14,11,25,7,Spring2018
3432,SE Stark & 166th Pl,5458,E,NS,17,18,35,8,Spring2018
3433,SE Stark & 167th,5459,W,NS,18,8,26,7,Spring2018
3434,SE Stark & 174th,5461,E,NS,22,45,67,6,Spring2018
3435,SE Stark & 174th,5462,W,OP,46,26,72,3,Spring2018
3436,SE Stark & 176th Pl,5463,E,NS,5,15,20,2,Spring2018
3437,SE Stark & 176th Pl,5464,W,OP,9,4,13,0,Spring2018
3438,SE Stark & 179th,5465,E,NS,19,40,59,21,Spring2018
3445,SE Stark & 179th,5466,W,OP,80,28,108,36,Spring2018
3446,SE Stark & 182nd,5467,E,NS,61,94,155,24,Spring2018
3447,SE Stark & 185th,5468,E,FS,18,20,38,7,Spring2018
3448,SE Stark & 185th,5469,W,NS,8,17,25,4,Spring2018
3449,SE Stark & 192nd,5471,E,OP,18,20,38,15,Spring2018
3450,SE Stark & 192nd,5472,W,NS,17,19,36,12,Spring2018
3451,SE Stark & 196th,5475,E,OP,19,25,44,7,Spring2018
3452,SE Stark & 197th Dr,5476,W,NS,12,11,23,4,Spring2018
3453,SE Stark & 199th,5477,E,NS,11,13,24,9,Spring2018
3454,SE Stark & 202nd,5478,E,FS,28,29,57,26,Spring2018
3455,SE Stark & 202nd,5479,W,FS,29,26,55,24,Spring2018
3456,SE Stark & 205th,5480,E,FS,13,17,30,10,Spring2018
3457,SE Stark & 205th Pl,5481,W,FS,29,14,43,23,Spring2018
3458,SE Stark & 212th,5484,W,OP,7,4,11,3,Spring2018
3459,SE Stark & 217th,5487,E,NS,13,21,34,7,Spring2018
3460,SE Stark & 217th,5488,W,OP,25,13,38,7,Spring2018
3461,SE Stark & 220th,5489,E,OP,5,14,19,1,Spring2018
3462,SE Stark & 223rd,5491,E,FS,59,61,120,23,Spring2018
3463,SE Stark & 223rd,5492,W,FS,54,65,119,25,Spring2018
3464,SE Stark & NE Cleveland,5493,W,FS,18,9,27,14,Spring2018
3465,SE Stark & NE Cleveland,5494,E,NS,10,16,26,10,Spring2018
3466,SE Stark & NE 242nd,5495,E,FS,44,102,146,59,Spring2018
3467,SE Stark & 80th,5498,W,NS,47,9,56,2,Spring2018
3468,SE Stark & 82nd,5499,W,FS,135,89,224,33,Spring2018
3469,SE Stark & 88th,5502,W,NS,13,3,16,1,Spring2018
3470,SE Stark & 90th,5503,W,NS,32,8,40,1,Spring2018
3471,N State & B Ave,5505,N,FS,21,1,22,0,Spring2018
3472,N State & B Ave,5506,S,NS,1,29,30,2,Spring2018
3473,N State & D Ave,5507,S,FS,1,12,13,0,Spring2018
3474,N State & E Ave,5508,N,OP,3,1,4,2,Spring2018
3475,N State & Foothills,5509,N,FS,36,10,46,1,Spring2018
3476,N State & Foothills,5510,S,OP,10,25,35,1,Spring2018
3477,S State & Middlecrest,5511,S,NS,9,26,35,5,Spring2018
3478,S State & North Shore,5512,N,OP,18,6,24,3,Spring2018
3479,N State & North Shore,5513,S,NS,7,10,17,2,Spring2018
3480,S State & Wilbur,5514,N,NS,28,10,38,5,Spring2018
3481,SE Steele & 30th,5515,E,OP,10,20,30,0,Spring2018
3482,SE Steele & 30th,5516,W,FS,26,6,32,0,Spring2018
3483,SE Steele & 28th,5517,W,NS,17,7,24,1,Spring2018
3484,SE Steele & 32nd,5518,W,NS,14,2,16,0,Spring2018
3485,SE Steele & 33rd,5519,E,OP,4,16,20,0,Spring2018
3486,SE Steele & 35th,5520,E,NS,2,9,11,0,Spring2018
3487,SE Steele & 34th,5521,W,NS,12,3,15,0,Spring2018
3488,SE Steele & 36th Pl,5522,E,OP,1,4,5,0,Spring2018
3489,SE Steele & 36th Pl,5523,W,FS,9,0,9,0,Spring2018
3490,SE Steele & Cesar Chavez Blvd,5524,E,NS,15,46,61,1,Spring2018
3491,SE Steele & Cesar Chavez Blvd,5525,W,NS,29,19,48,1,Spring2018
3498,SE Steele & 41st,5526,E,NS,2,19,21,0,Spring2018
3499,SE Steele & 41st,5527,W,NS,18,2,20,0,Spring2018
3500,SE Steele & 44th,5529,E,NS,2,20,22,2,Spring2018
3501,SE Steele & 44th,5530,W,NS,16,2,18,1,Spring2018
3502,SE Steele & 47th,5531,E,FS,3,23,26,1,Spring2018
3503,SE Steele & 50th,5532,E,NS,2,14,16,0,Spring2018
3504,SE Steele & 50th,5533,W,FS,11,3,14,0,Spring2018
3505,SE Steele & 52nd,5534,E,NS,12,46,58,0,Spring2018
3506,SE Steele & 52nd,5535,W,FS,25,3,28,0,Spring2018
3507,SE Strawberry & Stanhelma,5536,W,FS,1,3,4,0,Spring2018
3508,SE Strawberry & Cason,5537,E,NS,3,0,3,0,Spring2018
3509,SE Strawberry & Fragrance,5538,W,NS,1,2,3,1,Spring2018
3510,SE Strawberry & Stanhelma,5539,E,FS,3,0,3,0,Spring2018
3511,SE Strawberry & Stratford,5540,W,NS,0,4,4,0,Spring2018
3512,SE Strawberry & Webster,5541,W,NS,3,3,6,3,Spring2018
3513,SE Strawberry & Wiles Ct,5542,E,NS,1,1,2,2,Spring2018
3514,SE Strawberry & 82nd Dr,5543,E,NS,8,4,12,1,Spring2018
3515,1500 Block SW Sunset Blvd,5552,N,AT,1,0,1,0,Spring2018
3516,SW Sunset Blvd & Boundary,5553,N,NS,0,1,1,0,Spring2018
3517,SW Sunset Blvd & Boundary,5554,S,NS,0,0,0,0,Spring2018
3518,SW Sunset Blvd & Dosch,5556,W,NS,0,1,1,0,Spring2018
3519,SW Sunset Blvd & Dosch,5557,E,FS,1,0,1,0,Spring2018
3520,SW Sunset Blvd & Dosch Park Ln,5558,E,FS,1,0,1,0,Spring2018
3521,SW Sunset Blvd & Mitchell,5562,W,OP,0,1,1,0,Spring2018
3522,SW Sunset Blvd & Mitchell,5563,E,FS,1,0,1,0,Spring2018
3523,SW Sunset Blvd & Richardson,5564,N,NS,0,0,0,0,Spring2018
3524,SW Sunset Blvd & Richardson,5565,S,FS,0,0,0,0,Spring2018
3525,SW Sunset Blvd & 18th Dr,5566,S,FS,1,0,1,0,Spring2018
3526,SW Sunset Blvd & 18th Dr,5567,N,FS,0,1,1,0,Spring2018
3527,SW Sunset Blvd & 19th,5568,N,FS,0,1,1,0,Spring2018
3528,SW Sunset Blvd & 25th,5569,S,OP,1,0,1,0,Spring2018
3529,SW Sunset Blvd & 26th,5570,E,FS,2,0,2,0,Spring2018
3530,SW Sunset Blvd & 26th Dr,5571,W,OP,0,1,1,0,Spring2018
3531,SW Sunset Blvd & 27th,5572,W,FS,0,1,1,0,Spring2018
3532,SW Sunset Blvd & 27th,5573,E,OP,1,0,1,0,Spring2018
3533,SW Sunset Blvd & 29th,5574,W,NS,0,0,0,0,Spring2018
3534,SW Sunset Blvd & 31st Dr,5575,W,OP,0,0,0,0,Spring2018
3535,SW Sunset Blvd & 31st Dr,5576,E,FS,0,0,0,0,Spring2018
3536,SW Tualatin Valley Hwy & 214th,5586,W,NS,43,31,74,3,Spring2018
3537,SE Tualatin Valley Hwy & Sunset Esplnd,5588,W,AT,67,49,116,32,Spring2018
3538,SW Tualatin Valley Hwy & Market Centre,5590,E,OP,51,39,90,9,Spring2018
3539,SW Tualatin Valley Hwy & Aloha Villa,5592,W,AT,3,10,13,0,Spring2018
3540,18882-19040 SW Tualatin Valley Hwy,5593,E,AT,10,14,24,0,Spring2018
3541,18882-19040 SW Tualatin Valley Hwy,5594,W,OP,24,20,44,1,Spring2018
3542,SW Tualatin Valley Hwy & 141st,5595,W,NS,9,7,16,0,Spring2018
3543,SW Tualatin Valley Hwy & Hocken,5597,E,NS,20,58,78,17,Spring2018
3544,SE Tualatin Valley Hwy & Minter Bridge,5598,E,NS,108,148,256,65,Spring2018
3551,SW Tualatin Valley Hwy & Murray,5599,W,FS,96,31,127,15,Spring2018
3552,SW Tualatin Valley Hwy & Murray,5600,E,NS,19,84,103,8,Spring2018
3553,SW Tualatin Valley Hwy & Market Centre,5601,W,AT,35,66,101,16,Spring2018
3554,SE Tualatin Valley Hwy & River Rd,5602,E,FS,23,27,50,9,Spring2018
3555,SW Tualatin Valley Hwy & St Marys Home,5603,E,OP,6,7,13,0,Spring2018
3556,SW Tualatin Valley Hwy & St Marys Home,5604,W,AT,4,9,13,0,Spring2018
3557,SE Tualatin Valley Hwy & 24th,5606,E,FS,36,24,60,12,Spring2018
3558,SE Tualatin Valley Hwy & 40th,5609,E,OP,1,2,3,0,Spring2018
3559,SE Tualatin Valley Hwy & Sunset Esplnd,5611,E,OP,69,79,148,42,Spring2018
3560,SE Tualatin Valley Hwy & 24th,5612,W,FS,40,76,116,40,Spring2018
3561,SE Tualatin Valley Hwy & Brookwood,5614,E,FS,67,50,117,16,Spring2018
3562,SE Tualatin Valley Hwy & 11th,5615,N,FS,23,39,62,10,Spring2018
3563,SE Tualatin Valley Hwy & 13th,5616,W,NS,34,30,64,14,Spring2018
3564,SW Tualatin Valley Hwy & 142nd,5617,E,NS,6,16,22,0,Spring2018
3565,SW Tualatin Valley Hwy & 160th,5618,E,FS,51,30,81,7,Spring2018
3566,SW Tualatin Valley Hwy & Millikan Blvd,5619,W,NS,32,52,84,6,Spring2018
3567,SW Tualatin Valley Hwy & 170th,5620,E,FS,121,71,192,19,Spring2018
3568,SW Tualatin Valley Hwy & 170th,5621,W,FS,74,131,205,17,Spring2018
3569,SW Tualatin Valley Hwy & 174th,5622,W,NS,8,16,24,0,Spring2018
3570,SW Tualatin Valley Hwy & 174th,5623,E,OP,20,11,31,0,Spring2018
3571,SW Tualatin Valley Hwy & 178th,5624,E,OP,72,42,114,23,Spring2018
3572,SW Tualatin Valley Hwy & 178th,5625,W,FS,42,68,110,19,Spring2018
3573,SW Tualatin Valley Hwy & 185th,5628,E,FS,109,170,279,32,Spring2018
3574,SW Tualatin Valley Hwy & 185th,5629,W,FS,179,117,296,32,Spring2018
3575,SW Tualatin Valley Hwy & 192nd,5633,W,FS,24,27,51,1,Spring2018
3576,SW Tualatin Valley Hwy & 192nd,5634,E,OP,10,14,24,0,Spring2018
3577,SW Tualatin Valley Hwy & 198th,5635,W,FS,81,65,146,26,Spring2018
3578,SW Tualatin Valley Hwy & 209th,5637,E,NS,34,37,71,2,Spring2018
3579,SW Tualatin Valley Hwy & 209th,5638,W,NS,23,22,45,1,Spring2018
3580,SE Tualatin Valley Hwy & Cypress,5639,W,FS,130,95,225,53,Spring2018
3581,SW Tualatin Valley Hwy & 214th,5642,E,OP,11,19,30,1,Spring2018
3582,SE Tualatin Valley Hwy & Cornelius Pass,5643,E,FS,32,30,62,3,Spring2018
3583,SE Tualatin Valley Hwy & 75th,5644,W,NS,31,41,72,4,Spring2018
3584,SE Tualatin Valley Hwy & 67th,5650,W,FS,34,87,121,32,Spring2018
3585,SE Tualatin Valley Hwy & 67th (229th),5651,E,NS,67,32,99,26,Spring2018
3586,SE Tualatin Valley Hwy & SW 234th,5652,E,NS,92,111,203,31,Spring2018
3587,SE Tualatin Valley Hwy & Century,5653,W,NS,102,91,193,29,Spring2018
3588,SE Tualatin Valley Hwy & Imlay,5654,W,NS,14,13,27,2,Spring2018
3589,SE Tualatin Valley Hwy & Imlay,5655,E,OP,4,10,14,0,Spring2018
3590,SE Tacoma & 13th,5664,E,FS,5,40,45,0,Spring2018
3591,SE Tacoma & 13th,5665,W,FS,39,5,44,0,Spring2018
3592,SE Tacoma & 17th,5668,E,FS,3,20,23,1,Spring2018
3593,SE Tacoma & 17th,5669,W,FS,22,3,25,1,Spring2018
3594,SE Tacoma & 7th,5675,W,NS,19,2,21,1,Spring2018
3595,SE Tacoma & 7th,5676,E,FS,2,20,22,1,Spring2018
3596,SW Talbot & Patton,5679,E,FS,2,2,4,0,Spring2018
3597,SW Talbot & Patton,5680,W,NS,6,0,6,0,Spring2018
3604,SW Talbot Terrace & Greenway,5681,E,NS,0,0,0,0,Spring2018
3605,SW Talbot & Talbot Terrace ,5682,N,FS,0,0,0,0,Spring2018
3606,SW Taylors Ferry & Dolph ,5687,S,FS,0,1,1,0,Spring2018
3607,SW Taylors Ferry & Marigold ,5688,N,FS,0,0,0,0,Spring2018
3608,SW Taylors Ferry & Marigold ,5689,S,NS,0,0,0,0,Spring2018
3609,1400 Block SW Taylors Ferry ,5690,E,AT,1,0,1,0,Spring2018
3610,2200 Block SW Taylors Ferry ,5691,E,AT,2,0,2,0,Spring2018
3611,2200 Block SW Taylors Ferry ,5692,W,AT,0,0,0,0,Spring2018
3612,7100 Block SW Taylors Ferry ,5693,W,OP,0,0,0,0,Spring2018
3613,7100 Block SW Taylors Ferry ,5694,E,AT,1,0,1,0,Spring2018
3614,SW Taylors Ferry & 78th Pl,5695,E,FS,2,0,2,0,Spring2018
3615,SW Taylors Ferry & 78th Pl,5696,W,NS,1,1,2,0,Spring2018
3616,SW Taylors Ferry & Capitol Hwy,5697,W,NS,13,1,14,0,Spring2018
3617,SW Taylors Ferry & Dolph ,5699,N,OP,2,0,2,0,Spring2018
3618,SW Taylors Ferry & Fulton Park Blvd,5700,S,NS,0,0,0,0,Spring2018
3619,SW Taylors Ferry & Riverview,5703,E,OP,0,0,0,0,Spring2018
3620,SW Taylors Ferry & Riverview,5704,S,AT,0,0,0,0,Spring2018
3621,SW Taylors Ferry & Riverview (2nd),5705,W,AT,0,1,1,0,Spring2018
3622,SW Taylors Ferry & Terwilliger,5706,E,NS,11,11,22,0,Spring2018
3623,SW Taylors Ferry & 10th,5707,E,NS,3,2,5,0,Spring2018
3624,SW Taylors Ferry & 10th,5708,W,NS,2,4,6,0,Spring2018
3625,SW Taylors Ferry & 11th,5709,W,NS,9,3,12,0,Spring2018
3626,SW Taylors Ferry & 11th,5710,E,NS,1,0,1,0,Spring2018
3627,SW Taylors Ferry & Taylors Ferry Ct,5711,W,OP,0,1,1,0,Spring2018
3628,SW Taylors Ferry & Taylors Ferry Ct,5712,E,FS,1,0,1,0,Spring2018
3629,SW Taylors Ferry & 17th,5713,W,FS,1,1,2,0,Spring2018
3630,SW Taylors Ferry & 17th,5714,E,OP,1,0,1,0,Spring2018
3631,SW Taylors Ferry & 19th,5715,W,FS,0,0,0,0,Spring2018
3632,SW Taylors Ferry & 19th,5716,E,OP,0,0,0,0,Spring2018
3633,SW Taylors Ferry & 2nd,5717,E,OP,1,0,1,0,Spring2018
3634,SW Taylors Ferry & 2nd,5718,W,NS,0,2,2,0,Spring2018
3635,SW Taylors Ferry & 23rd Dr,5719,S,FS,1,2,3,0,Spring2018
3636,SW Taylors Ferry & 26th,5720,W,NS,0,2,2,0,Spring2018
3637,SW Taylors Ferry & 26th,5721,E,FS,1,0,1,0,Spring2018
3638,SW Taylors Ferry & 28th,5722,W,FS,0,0,0,1,Spring2018
3639,SW Taylors Ferry & 28th,5723,E,OP,0,0,0,0,Spring2018
3640,SW Taylors Ferry & 30th,5724,W,FS,0,0,0,0,Spring2018
3641,SW Taylors Ferry & 30th,5725,E,OP,0,0,0,0,Spring2018
3642,SW Taylors Ferry & 46th,5726,W,FS,0,0,0,0,Spring2018
3643,SW Taylors Ferry & 46th,5727,E,OP,0,0,0,0,Spring2018
3644,SW Taylors Ferry & 48th,5728,W,NS,0,0,0,0,Spring2018
3645,SW Taylors Ferry & 48th,5729,E,NS,0,0,0,0,Spring2018
3646,SW Taylors Ferry & 49th,5730,W,NS,0,0,0,0,Spring2018
3647,SW Taylors Ferry & 52nd,5732,W,FS,0,2,2,0,Spring2018
3648,SW Taylors Ferry & 52nd,5733,E,FS,2,0,2,0,Spring2018
3649,SW Taylors Ferry & 53rd,5734,W,FS,0,0,0,0,Spring2018
3650,SW Taylors Ferry & 53rd,5735,E,FS,1,0,1,0,Spring2018
3657,SW Taylors Ferry & 55th,5736,W,NS,1,3,4,0,Spring2018
3658,SW Taylors Ferry & 55th,5737,E,FS,3,1,4,0,Spring2018
3659,SW Taylors Ferry & 57th,5738,W,OP,0,0,0,0,Spring2018
3660,SW Taylors Ferry & 57th,5739,E,NS,0,0,0,0,Spring2018
3661,SW Taylors Ferry & 60th,5740,W,OP,0,1,1,0,Spring2018
3662,SW Taylors Ferry & 60th,5741,E,NS,3,0,3,0,Spring2018
3663,SW Taylors Ferry & 62nd,5742,E,FS,5,0,5,0,Spring2018
3664,SW Taylors Ferry & 62nd,5743,W,NS,0,6,6,0,Spring2018
3665,SW Taylors Ferry & 65th,5745,E,FS,1,0,1,0,Spring2018
3666,SW Taylors Ferry & 66th,5746,E,FS,1,0,1,0,Spring2018
3667,SW Taylors Ferry & 69th,5747,W,OP,1,2,3,0,Spring2018
3668,SW Taylors Ferry & 69th,5748,E,FS,3,2,5,0,Spring2018
3669,SW Taylors Ferry & 7th,5749,W,NS,15,11,26,0,Spring2018
3670,SW Taylors Ferry & 74th,5752,E,FS,2,0,2,0,Spring2018
3671,SW Taylors Ferry & 80th,5754,W,NS,0,0,0,0,Spring2018
3672,SW Terwilliger & Maplecrest,5779,E,NS,3,7,10,0,Spring2018
3673,SW Terwilliger & Alice,5780,S,FS,1,5,6,0,Spring2018
3674,SW Terwilliger & Alice,5781,N,OP,4,1,5,0,Spring2018
3675,SW Terwilliger & Bancroft,5782,S,AT,0,0,0,0,Spring2018
3676,SW Terwilliger & Bancroft Terrace,5783,W,FS,0,0,0,0,Spring2018
3677,SW Terwilliger & Burlingame Terr,5785,S,FS,0,1,1,0,Spring2018
3678,SW Terwilliger & Caldew,5786,N,OP,6,0,6,0,Spring2018
3679,SW Terwilliger & Caldew,5787,S,FS,0,7,7,0,Spring2018
3680,SW Terwilliger & Capitol Hwy,5788,N,NS,6,0,6,0,Spring2018
3681,SW Terwilliger & Capitol Hwy,5789,S,NS,0,3,3,0,Spring2018
3682,SW Terwilliger & Carson,5790,N,NS,4,9,13,0,Spring2018
3683,SW Terwilliger & Chestnut,5791,N,NS,10,0,10,0,Spring2018
3684,SW Terwilliger & Chestnut,5792,S,FS,0,10,10,0,Spring2018
3685,9800 Block SW Terwilliger,5794,S,AT,2,5,7,0,Spring2018
3686,SW Terwilliger & Hamilton,5795,E,FS,1,0,1,0,Spring2018
3687,SW Terwilliger & Hamilton Terrace,5796,N,FS,0,0,0,0,Spring2018
3688,SW Terwilliger & L&C Law School,5797,W,OP,1,0,1,0,Spring2018
3689,SW Terwilliger & Lobelia,5798,N,NS,3,0,3,0,Spring2018
3690,SW Terwilliger & Lobelia,5799,S,NS,0,2,2,0,Spring2018
3691,SW Terwilliger & Nebraska,5800,N,FS,0,0,0,0,Spring2018
3692,SW Terwilliger & Primrose,5801,N,NS,7,0,7,0,Spring2018
3693,SW Terwilliger & Primrose,5802,S,FS,0,6,6,0,Spring2018
3694,SW Terwilliger & Ralston Dr,5803,N,NS,0,0,0,0,Spring2018
3695,SW Terwilliger & Sam Jackson,5804,S,FS,27,7,34,3,Spring2018
3696,SW Terwilliger & Taylors Ferry,5806,N,NS,5,1,6,0,Spring2018
3697,SW Terwilliger & Taylors Ferry,5807,S,FS,4,8,12,0,Spring2018
3698,SW Terwilliger & 6th,5808,S,NS,1,6,7,0,Spring2018
3699,SW Terwilliger & Troy,5809,N,FS,5,0,5,0,Spring2018
3700,SW Terwilliger & Westwood,5811,N,OP,0,0,0,0,Spring2018
3701,SW Terwilliger & Westwood,5812,S,FS,0,0,0,0,Spring2018
3702,SW Terwilliger & 2nd,5813,W,FS,19,6,25,0,Spring2018
3703,SW Terwilliger & 6th,5814,N,OP,8,1,9,0,Spring2018
3710,SW Terwilliger & Carson,5816,S,OP,1,3,4,0,Spring2018
3711,NW Thurman & Gordon,5824,W,NS,10,10,20,1,Spring2018
3712,NW Thurman & 25th,5830,E,NS,4,0,4,1,Spring2018
3713,NW Thurman & 26th,5831,W,NS,1,34,35,7,Spring2018
3714,NW Thurman & 26th,5832,E,FS,41,1,42,6,Spring2018
3715,NW Thurman & 27th,5835,W,FS,1,53,54,2,Spring2018
3716,NW Thurman & 27th,5836,E,FS,56,29,85,8,Spring2018
3717,NW Thurman & 28th,5837,W,FS,15,38,53,4,Spring2018
3718,NW Thurman & 29th,5839,W,OP,1,6,7,0,Spring2018
3719,NW Thurman & 29th,5840,E,NS,12,0,12,0,Spring2018
3720,NW Thurman & 32nd,5841,W,NS,2,10,12,0,Spring2018
3721,NW Thurman & 32nd,5842,E,NS,7,0,7,0,Spring2018
3722,NW Thurman & 34th,5843,W,OP,2,6,8,0,Spring2018
3723,NW Thurman & 34th,5844,E,NS,5,0,5,0,Spring2018
3724,Tigard Transit Center,5846,S,AT,516,452,968,73,Spring2018
3725,SW Towle & 10th Dr,5851,N,FS,0,0,0,0,Spring2018
3726,SW Towle & 10th Ct,5852,S,NS,0,0,0,0,Spring2018
3727,SW Towle & 14th,5853,N,FS,0,0,0,0,Spring2018
3728,SW Towle & 14th,5854,S,OP,0,0,0,0,Spring2018
3729,SW Towle & 19th Dr,5855,S,OP,0,1,1,0,Spring2018
3730,N Trenton & Alaska,5862,W,FS,35,59,94,60,Spring2018
3731,2800 Block S Troutdale,5864,N,OP,0,0,0,0,Spring2018
3732,3000 Block S Troutdale,5865,S,AT,0,0,0,0,Spring2018
3733,S Troutdale & SE Beavercreek,5867,N,FS,0,1,1,0,Spring2018
3734,S Troutdale & SE Beavercreek,5868,S,FS,2,0,2,0,Spring2018
3735,S Troutdale & SE Chapman,5869,N,NS,1,2,3,0,Spring2018
3736,S Troutdale Rd & SW Chapman,5870,S,NS,3,1,4,0,Spring2018
3737,S Troutdale Rd & SE Stark,5871,N,FS,2,4,6,0,Spring2018
3738,S Troutdale & SE Stark,5872,S,NS,7,1,8,0,Spring2018
3739,S Troutdale & SE 19th,5874,N,FS,1,1,2,0,Spring2018
3740,S Troutdale & SE 19th,5875,S,OP,2,0,2,0,Spring2018
3741,S Troutdale & SE 21st,5876,N,FS,0,2,2,0,Spring2018
3742,S Troutdale & SW 21st,5877,S,FS,3,0,3,0,Spring2018
3743,SW Troy & 35th,5878,W,FS,36,106,142,14,Spring2018
3744,SE Umatilla & 16th,5884,E,NS,1,7,8,1,Spring2018
3745,NE M L King & Ainsworth,5886,N,NS,56,101,157,52,Spring2018
3746,NE M L King & Ainsworth,5887,S,NS,81,36,117,34,Spring2018
3747,NE M L King & Alberta,5889,S,FS,185,33,218,23,Spring2018
3748,NE M L King & Alberta,5890,N,FS,136,388,524,87,Spring2018
3749,SE M L King & Ash,5892,S,NS,10,28,38,4,Spring2018
3750,NE M L King & Beech,5893,S,NS,70,30,100,13,Spring2018
3751,NE M L King & Beech,5894,N,NS,33,57,90,19,Spring2018
3752,NE M L King & Brazee,5896,N,NS,26,75,101,12,Spring2018
3753,NE M L King & Broadway,5897,S,NS,26,70,96,27,Spring2018
3754,NE M L King & Bryant,5899,N,NS,71,73,144,39,Spring2018
3755,NE M L King & Bryant,5900,S,NS,28,16,44,9,Spring2018
3756,NE M L King & E Burnside,5901,S,NS,64,227,291,64,Spring2018
3763,NE M L King & Dekum,5903,N,NS,12,73,85,24,Spring2018
3764,NE M L King & Dekum,5904,S,NS,81,18,99,13,Spring2018
3765,NE M L King & Failing,5906,N,FS,26,66,92,21,Spring2018
3766,NE M L King & Failing,5907,S,NS,81,31,112,16,Spring2018
3767,NE M L King & Fargo,5908,S,FS,57,20,77,14,Spring2018
3768,NE M L King & Fargo,5909,N,NS,23,60,83,25,Spring2018
3769,NE M L King & Fremont,5910,N,NS,31,94,125,30,Spring2018
3770,NE M L King & Fremont,5911,S,NS,75,39,114,26,Spring2018
3771,NE M L King & Hoyt,5912,S,NS,31,16,47,6,Spring2018
3772,NE M L King & Hancock,5914,S,NS,13,10,23,7,Spring2018
3773,NE M L King & Holladay,5917,S,NS,195,576,771,134,Spring2018
3774,NE M L King & Holland,5918,N,NS,16,36,52,2,Spring2018
3775,NE M L King & Holland,5919,S,NS,142,87,229,73,Spring2018
3776,M L King & Holman,5920,N,FS,3,11,14,1,Spring2018
3777,NE M L King & Jarrett,5923,S,NS,66,23,89,20,Spring2018
3778,NE M L King & Jarrett,5924,N,NS,17,47,64,18,Spring2018
3779,NE M L King & Killingsworth,5927,S,FS,375,311,686,172,Spring2018
3780,NE M L King & Killingsworth,5929,N,NS,77,163,240,58,Spring2018
3781,NE M L King & Knott,5930,N,NS,39,91,130,25,Spring2018
3782,NE M L King & Knott,5931,S,NS,95,41,136,32,Spring2018
3783,NE M L King & Lombard St,5932,N,NS,67,66,133,20,Spring2018
3784,SE M L King & Mill,5933,S,FS,1,0,1,0,Spring2018
3785,NE M L King & Mason,5934,S,FS,84,37,121,95,Spring2018
3786,NE M L King & Mason,5935,N,NS,37,73,110,85,Spring2018
3787,NE M L King & Morgan,5937,N,NS,9,18,27,1,Spring2018
3788,NE M L King & Morris,5938,S,FS,45,19,64,4,Spring2018
3789,NE M L King & Rosa Parks Way,5943,S,NS,39,7,46,8,Spring2018
3790,NE M L King & Rosa Parks Way,5944,N,NS,5,28,33,12,Spring2018
3791,NE M L King & Prescott,5946,N,NS,20,51,71,5,Spring2018
3792,NE M L King & Prescott,5947,S,OP,72,20,92,8,Spring2018
3793,NE M L King & Russet,5950,S,FS,35,56,91,17,Spring2018
3794,NE M L King & Sacramento,5951,S,OP,72,25,97,11,Spring2018
3795,NE M L King & Tillamook,5955,S,NS,18,9,27,5,Spring2018
3796,NE M L King & Tillamook,5956,N,NS,19,33,52,7,Spring2018
3797,NE M L King & Wasco,5958,S,NS,17,63,80,12,Spring2018
3798,NE M L King & Weidler,5960,S,FS,41,62,103,36,Spring2018
3799,NE M L King & Wygant,5961,S,FS,27,12,39,0,Spring2018
3800,NE M L King & Wygant,5962,N,NS,12,43,55,1,Spring2018
3801,15800 Block SW 72nd,5973,S,AT,1,3,4,0,Spring2018
3802,US Veterans Hospital,5975,S,AT,479,683,1162,371,Spring2018
3803,N Vancouver & Ainsworth,5976,N,NS,4,12,16,0,Spring2018
3804,N Vancouver & Ainsworth,5977,S,NS,11,2,13,0,Spring2018
3805,N Vancouver & Alberta,5978,S,NS,75,18,93,39,Spring2018
3806,N Vancouver & Beech,5979,S,NS,20,10,30,4,Spring2018
3807,N Vancouver & Fargo,5984,S,OP,64,22,86,34,Spring2018
3808,N Vancouver & Holman,5991,N,NS,1,12,13,0,Spring2018
3809,N Vancouver & Holman,5992,S,NS,8,1,9,0,Spring2018
3816,N Vancouver & Jessup,5995,S,NS,12,5,17,1,Spring2018
3817,N Vancouver & Killingsworth,5996,S,FS,58,41,99,24,Spring2018
3818,N Vancouver & Knott,5997,S,NS,57,30,87,32,Spring2018
3819,N Vancouver & Ivy,6000,S,NS,193,93,286,28,Spring2018
3820,N Vancouver & Page,6001,S,NS,43,13,56,6,Spring2018
3821,N Vancouver & Russell,6003,S,FS,61,35,96,69,Spring2018
3822,N Vancouver & Shaver,6004,S,NS,26,8,34,1,Spring2018
3823,N Vancouver & Skidmore,6005,S,NS,65,4,69,5,Spring2018
3824,N Vancouver & Stanton,6006,S,NS,184,100,284,139,Spring2018
3825,N Vancouver & Tillamook,6008,S,NS,31,11,42,6,Spring2018
3826,N Vancouver & Weidler,6009,S,NS,55,77,132,32,Spring2018
3827,N Vancouver & Wygant,6010,S,NS,28,2,30,0,Spring2018
3828,NW Vaughn & 24th,6013,E,NS,40,2,42,3,Spring2018
3829,NW Vaughn & 24th,6014,W,NS,3,47,50,3,Spring2018
3830,1900 Block SW Vermont,6017,E,AT,5,0,5,0,Spring2018
3831,2200 Block SW Vermont,6018,W,AT,0,3,3,0,Spring2018
3832,5700 Block SW Vermont,6019,W,OP,0,1,1,0,Spring2018
3833,SW Vermont & Bertha,6022,E,NS,9,0,9,0,Spring2018
3834,SW Capitol & Vermont,6023,E,FS,24,7,31,4,Spring2018
3835,SW Vermont & Bertha,6024,W,FS,1,5,6,0,Spring2018
3836,SW Vermont & Chestnut,6025,E,NS,4,49,53,0,Spring2018
3837,SW Vermont & Chestnut,6026,W,OP,26,8,34,0,Spring2018
3838,SW Vermont & Idaho,6027,E,OP,0,0,0,0,Spring2018
3839,SW Vermont & Idaho,6028,W,NS,0,4,4,0,Spring2018
3840,SW Vermont & Idaho Dr,6029,W,FS,8,27,35,3,Spring2018
3841,SW Vermont & Shattuck,6030,W,NS,3,3,6,0,Spring2018
3842,SW Vermont & Capitol Hwy,6031,E,FS,1,0,1,0,Spring2018
3843,SW Vermont & 13th,6032,W,OP,1,1,2,0,Spring2018
3844,SW Vermont & 13th,6033,E,FS,2,3,5,0,Spring2018
3845,SW Vermont & 24th,6034,W,FS,0,1,1,0,Spring2018
3846,SW Vermont & 30th,6035,W,NS,2,7,9,0,Spring2018
3847,SW Vermont & 30th,6036,E,NS,8,2,10,0,Spring2018
3848,SW Vermont & 32nd,6037,W,FS,0,4,4,0,Spring2018
3849,SW Vermont & 37th,6041,W,NS,1,5,6,0,Spring2018
3850,SW Vermont & 37th,6042,E,NS,4,1,5,0,Spring2018
3851,SW Vermont & 42nd,6043,W,OP,0,1,1,0,Spring2018
3852,SW Vermont & 45th,6045,E,FS,29,3,32,1,Spring2018
3853,SW Vermont & 50th,6046,E,OP,0,0,0,0,Spring2018
3854,SW Vermont & 50th,6047,W,NS,0,7,7,0,Spring2018
3855,SW Vermont & 52nd,6048,E,NS,0,0,0,0,Spring2018
3856,SW Vermont & 52nd,6049,W,OP,0,4,4,0,Spring2018
3857,SW Vermont & 55th,6050,W,OP,0,4,4,0,Spring2018
3858,SW Vermont & 60th,6051,W,OP,12,12,24,2,Spring2018
3859,SW Vermont & 63rd,6052,W,OP,1,1,2,0,Spring2018
3860,SW Virginia & California,6053,S,NS,1,2,3,0,Spring2018
3861,SW Virginia & Nebraska,6057,N,NS,4,3,7,0,Spring2018
3862,SW Virginia & Nevada,6059,N,NS,1,2,3,0,Spring2018
3869,SW Virginia & Taylors Ferry,6060,S,NS,2,1,3,0,Spring2018
3870,SW Virginia & Taylors Ferry,6061,N,FS,1,1,2,0,Spring2018
3871,SW Virginia & Vermont,6062,S,NS,1,3,4,0,Spring2018
3872,SW Virginia & Vermont,6063,N,NS,2,1,3,0,Spring2018
3873,SW Vista & Broadway,6068,S,NS,0,21,21,0,Spring2018
3874,SW Vista & Elm St,6074,S,NS,1,17,18,0,Spring2018
3875,SW Vista & Elm St,6075,N,NS,3,0,3,0,Spring2018
3876,SW Vista & Isabella,6077,S,NS,0,2,2,0,Spring2018
3877,SW Vista & Jackson,6078,S,FS,0,6,6,0,Spring2018
3878,SW Vista & Jackson,6079,N,FS,4,0,4,0,Spring2018
3879,SW Vista & Madison,6082,S,NS,0,2,2,0,Spring2018
3880,SW Vista & Main,6083,N,NS,12,2,14,0,Spring2018
3881,SW Vista & Market Street,6084,N,FS,0,0,0,0,Spring2018
3882,SW Vista & Market Street,6085,S,NS,1,2,3,0,Spring2018
3883,SW Vista & Montgomery,6086,S,FS,0,2,2,0,Spring2018
3884,SW Vista & Montgomery,6087,N,NS,1,0,1,0,Spring2018
3885,SW Vista & Myrtle,6088,S,NS,0,6,6,0,Spring2018
3886,SW Vista & Myrtle,6089,N,NS,4,0,4,0,Spring2018
3887,SW Vista & Park Pl,6090,S,FS,3,17,20,1,Spring2018
3888,SW Walnut & Brookside,6103,W,NS,1,0,1,0,Spring2018
3889,SW Walnut & Grant,6104,E,FS,2,9,11,0,Spring2018
3890,SW Walnut & Tiedeman,6105,W,FS,1,0,1,0,Spring2018
3891,SW Walnut & Watkins,6107,E,NS,0,2,2,0,Spring2018
3892,SW Walnut & 112th,6108,W,NS,0,0,0,0,Spring2018
3893,SW Walnut & 112th,6109,E,NS,0,0,0,0,Spring2018
3894,SW Walnut & 116th,6111,E,FS,2,2,4,0,Spring2018
3895,SW Walnut & 121st,6112,W,NS,8,4,12,0,Spring2018
3896,100 Block Warner - Milne,6113,E,AT,2,9,11,1,Spring2018
3897,200 Block Warner - Milne,6114,W,OP,6,2,8,1,Spring2018
3898,300 Block Beavercreek Rd,6115,W,AT,18,3,21,2,Spring2018
3899,Beavercreek & Library Ct,6117,S,FS,8,41,49,7,Spring2018
3900,Warner - Milne & Beavercreek,6118,E,NS,1,16,17,1,Spring2018
3901,Warner - Milne & Linn,6120,E,FS,8,13,21,1,Spring2018
3902,Warner - Milne & Linn,6121,W,NS,11,10,21,4,Spring2018
3903,Beavercreek & Red Soils Ct,6122,E,NS,2,16,18,2,Spring2018
3904,SW Eliander & One Embassy Centre,6125,S,AT,19,89,108,8,Spring2018
3905,9000 Block SW Washington Square Rd,6126,N,AT,13,4,17,1,Spring2018
3906,9000 Block SW Washington Square Rd,6133,S,OP,3,20,23,1,Spring2018
3907,SE Washington & Oak,6140,E,NS,1,1,2,0,Spring2018
3908,SE Washington & Oak,6141,N,FS,0,2,2,0,Spring2018
3909,SE Washington & 105th,6143,E,OP,174,68,242,55,Spring2018
3910,SE Washington & 108th,6144,E,NS,33,24,57,8,Spring2018
3911,SE Washington & 23rd,6151,W,FS,1,17,18,3,Spring2018
3912,SE Washington & 25th,6152,E,OP,1,0,1,1,Spring2018
3913,SE Washington & 25th,6153,W,NS,1,1,2,1,Spring2018
3914,SE Washington & 29th,6156,E,OP,1,0,1,0,Spring2018
3915,SE Washington & 29th,6157,W,NS,0,1,1,0,Spring2018
3922,SW Washington & 3rd,6158,W,NS,63,371,434,25,Spring2018
3923,SE Washington & 34th,6159,E,NS,0,0,0,0,Spring2018
3924,SW Washington & 5th,6160,W,NS,369,630,999,171,Spring2018
3925,SE Washington & 80th,6165,E,FS,7,39,46,2,Spring2018
3926,SE Washington & 82nd,6166,E,FS,82,85,167,28,Spring2018
3927,SE Washington & 86th,6167,E,NS,4,12,16,2,Spring2018
3928,SE Washington & 88th,6168,E,NS,3,15,18,1,Spring2018
3929,SW Washington & 9th,6169,W,FS,42,166,208,12,Spring2018
3930,SE Washington & 90th,6170,E,NS,5,13,18,0,Spring2018
3931,SE Washington & 92nd,6171,E,FS,13,29,42,4,Spring2018
3932,SE Washington & 94th,6173,E,NS,6,6,12,0,Spring2018
3933,SW Eliander & One Embassy Centre,6175,N,OP,59,28,87,6,Spring2018
3934,SW Watson & 1st,6178,S,FS,69,14,83,9,Spring2018
3935,SW Watson & 10th,6179,S,FS,15,17,32,12,Spring2018
3936,SW Watson & 9th,6182,S,NS,7,7,14,2,Spring2018
3937,SE Webster & Bixel,6187,N,OP,1,1,2,0,Spring2018
3938,SE Webster & Cavalier Way,6189,S,NS,0,0,0,0,Spring2018
3939,Webster & Charolais,6190,N,NS,13,4,17,1,Spring2018
3940,SE Webster & Clackamas,6191,N,FS,1,1,2,0,Spring2018
3941,SE Webster & Clackamas,6192,S,FS,2,2,4,0,Spring2018
3942,SE Webster & Lake,6193,S,FS,2,2,4,1,Spring2018
3943,Webster & Clayton,6194,S,NS,3,3,6,0,Spring2018
3944,SE Webster & Cypress,6195,N,NS,2,1,3,0,Spring2018
3945,18000 Block Webster,6196,N,AT,1,0,1,0,Spring2018
3946,17700 Block Webster,6197,N,AT,1,3,4,0,Spring2018
3947,Webster & Kraxberger Middle School,6198,S,AT,1,1,2,0,Spring2018
3948,SE Webster & Lake,6199,N,NS,2,1,3,0,Spring2018
3949,Webster & Los Verdes,6201,S,FS,8,12,20,0,Spring2018
3950,SE Webster & Mabel,6203,S,NS,2,1,3,5,Spring2018
3951,SE Webster & Molt St,6205,S,FS,1,2,3,0,Spring2018
3952,Webster & Oatfield,6206,S,NS,1,9,10,1,Spring2018
3953,SE Webster & Pine Creek,6207,N,OP,1,1,2,0,Spring2018
3954,Webster & Kirkwood,6208,N,NS,3,4,7,0,Spring2018
3955,SE Webster & Savanna,6209,N,FS,0,0,0,0,Spring2018
3956,SE Webster & Strawberry,6210,N,NS,5,4,9,6,Spring2018
3957,SE Webster & Thiessen,6211,N,NS,8,7,15,1,Spring2018
3958,SE Webster & Thiessen,6212,S,FS,6,5,11,1,Spring2018
3959,SE Webster & Tuscany Ct,6213,S,NS,1,2,3,0,Spring2018
3960,SE Webster & Wilshire,6215,S,OP,0,1,1,0,Spring2018
3961,NE Weidler & Lloyd Center,6216,E,AT,187,175,362,264,Spring2018
3962,NE Weidler & M L King,6218,E,FS,25,27,52,34,Spring2018
3963,N Weidler & Williams,6220,E,NS,29,19,48,26,Spring2018
3964,NE Weidler & 106th,6223,W,NS,33,18,51,22,Spring2018
3965,NE Weidler & 111th,6225,W,NS,50,21,71,25,Spring2018
3966,NE Weidler & 17th,6227,E,NS,35,46,81,30,Spring2018
3967,NE Weidler & 2nd,6232,E,NS,6,17,23,3,Spring2018
3968,NE Weidler & 21st,6235,E,NS,32,96,128,61,Spring2018
3975,NE Weidler & 22nd,6237,E,NS,18,38,56,7,Spring2018
3976,NE Weidler & 24th,6239,E,NS,8,24,32,8,Spring2018
3977,NE Weidler & 7th,6240,E,NS,16,22,38,16,Spring2018
3978,NE Weidler & 9th,6242,E,NS,10,28,38,27,Spring2018
3979,N Whitaker & Hayden Meadows,6256,N,FS,7,14,21,4,Spring2018
3980,N Willamette & Alma,6258,W,NS,3,28,31,1,Spring2018
3981,N Willamette & Ida,6259,E,NS,20,3,23,1,Spring2018
3982,N Willamette & Bryant,6260,N,NS,1,9,10,0,Spring2018
3983,N Willamette & Edgewater,6262,E,FS,9,1,10,0,Spring2018
3984,N Willamette & Burr,6263,W,FS,2,10,12,0,Spring2018
3985,N Willamette & Carey,6264,N,NS,0,4,4,0,Spring2018
3986,N Willamette & Carey,6265,E,FS,3,0,3,0,Spring2018
3987,N Willamette & Chautauqua,6266,E,OP,6,0,6,0,Spring2018
3988,N Willamette & Harvard,6269,W,NS,3,12,15,0,Spring2018
3989,N Willamette & Harvard,6270,E,OP,9,4,13,0,Spring2018
3990,N Willamette & Haven,6271,W,NS,8,38,46,1,Spring2018
3991,N Willamette & Hurst,6273,W,NS,0,8,8,0,Spring2018
3992,N Willamette & Macrum,6274,E,OP,8,1,9,1,Spring2018
3993,N Willamette & Macrum,6275,W,NS,1,7,8,4,Spring2018
3994,N Willamette & Menlo,6277,W,NS,0,10,10,0,Spring2018
3995,N Willamette & Menlo,6278,E,OP,6,0,6,0,Spring2018
3996,N Willamette & Mohawk,6279,E,OP,8,0,8,5,Spring2018
3997,N Willamette & Monteith,6280,W,FS,3,9,12,0,Spring2018
3998,N Willamette & Oswego,6282,W,NS,0,12,12,6,Spring2018
3999,N Willamette & Edgewater,6283,W,OP,1,12,13,0,Spring2018
4000,N Willamette & Portsmouth,6284,W,NS,7,21,28,0,Spring2018
4001,N Willamette & Portsmouth,6285,E,FS,14,5,19,0,Spring2018
4002,N Willamette & Saratoga,6286,S,OP,4,1,5,0,Spring2018
4003,N Willamette & Tyler,6288,W,FS,0,13,13,0,Spring2018
4004,N Willamette & Tyler,6289,E,FS,11,1,12,1,Spring2018
4005,N Willamette & University of Portland,6290,E,AT,42,11,53,1,Spring2018
4006,N Willamette & Van Houten,6291,E,NS,11,4,15,0,Spring2018
4007,N Willamette & Wall,6292,W,NS,1,10,11,1,Spring2018
4008,N Willamette & Wall,6293,E,NS,11,1,12,1,Spring2018
4009,N Willamette & Washburne,6294,W,NS,0,5,5,0,Spring2018
4010,N Willamette & Washburne,6295,E,OP,4,0,4,0,Spring2018
4011,N Willamette & Woolsey,6298,W,NS,1,11,12,0,Spring2018
4012,N Willamette & Woolsey,6299,E,OP,6,0,6,0,Spring2018
4013,Willamette Dr & Mapleton Dr,6300,S,FS,3,4,7,0,Spring2018
4014,Willamette Dr & Arbor,6301,N,NS,4,2,6,0,Spring2018
4015,Willamette Dr & Arbor,6302,S,NS,1,5,6,0,Spring2018
4016,Willamette Dr & Barlow,6303,W,OP,2,2,4,0,Spring2018
4017,Willamette Dr & Barlow,6304,E,NS,2,4,6,3,Spring2018
4018,Willamette Dr & Burns,6306,W,NS,28,5,33,1,Spring2018
4019,Willamette Dr & Cedar Oak,6309,N,FS,68,10,78,2,Spring2018
4020,Pacific Hwy & Cherry,6310,N,OP,1,0,1,0,Spring2018
4021,Pacific Hwy (Hwy 43) & Cherry,6311,S,FS,0,1,1,0,Spring2018
4028,Willamette Dr & Elliott,6312,W,FS,15,1,16,0,Spring2018
4029,Willamette Dr & West A,6314,E,NS,2,14,16,0,Spring2018
4030,Pacific Hwy & Glenmorrie,6317,N,FS,1,0,1,0,Spring2018
4031,Pacific Hwy & Glenmorrie,6318,S,FS,0,1,1,0,Spring2018
4032,Willamette Dr & Hidden Springs,6319,S,NS,12,72,84,2,Spring2018
4033,Willamette Dr & Holly,6320,N,NS,12,3,15,1,Spring2018
4034,Willamette Dr & Holmes,6321,N,NS,7,1,8,0,Spring2018
4035,Willamette Dr & Holmes,6322,S,OP,0,6,6,0,Spring2018
4036,Willamette Dr & Hughes,6323,N,NS,5,0,5,0,Spring2018
4037,Willamette Dr & Hughes,6324,S,OP,0,4,4,0,Spring2018
4038,Willamette Dr & Jolie Pointe,6325,N,NS,4,1,5,0,Spring2018
4039,Willamette Dr & Jolie Pointe,6326,S,OP,1,4,5,0,Spring2018
4040,Pacific Hwy & Laurel,6327,N,OP,7,0,7,0,Spring2018
4041,Pacific Hwy & Burnham,6328,S,OP,0,8,8,0,Spring2018
4042,Willamette Dr & Mapleton,6331,N,NS,6,5,11,0,Spring2018
4043,Willamette Dr & Mark Ln,6332,N,NS,5,2,7,0,Spring2018
4044,Willamette Dr & Linnwood,6333,S,NS,2,6,8,0,Spring2018
4045,Pacific Hwy & Furman,6334,N,FS,11,19,30,0,Spring2018
4046,Pacific Hwy & Holy Names Drive,6335,N,FS,8,3,11,2,Spring2018
4047,Pacific Hwy & Brookhurst Dr,6336,S,FS,2,11,13,4,Spring2018
4048,Willamette Dr & Marylhurst Dr,6337,S,FS,3,17,20,0,Spring2018
4049,Pacific Hwy & Marylbrook Dr,6338,S,FS,13,8,21,0,Spring2018
4050,Willamette Dr & McKillican,6339,S,NS,5,30,35,2,Spring2018
4051,Willamette Dr & Pimlico,6344,N,OP,13,2,15,0,Spring2018
4052,Willamette Dr & Pimlico,6345,S,NS,1,10,11,0,Spring2018
4053,Willamette Dr & Shady Hollow,6346,N,NS,2,2,4,0,Spring2018
4054,Willamette Dr & Shady Hollow,6347,S,OP,2,2,4,0,Spring2018
4055,Willamette Dr & Holly (near gas stn),6348,S,FS,2,4,6,0,Spring2018
4056,Willamette Dr & Walling Way,6349,N,FS,7,3,10,0,Spring2018
4057,Willamette Dr & Walling Circle,6350,S,NS,2,5,7,1,Spring2018
4058,Willamette Dr & Webb,6352,S,NS,0,2,2,0,Spring2018
4059,N Williams & NE Russell,6354,N,FS,63,143,206,105,Spring2018
4060,N Williams & NE Alberta,6355,N,NS,10,54,64,32,Spring2018
4061,N Williams & NE Broadway,6357,N,FS,42,34,76,16,Spring2018
4062,N Williams & NE Cook,6359,N,FS,33,192,225,33,Spring2018
4063,N Williams & NE Fremont,6360,N,FS,24,51,75,9,Spring2018
4064,N Williams & NE Graham,6362,N,NS,38,135,173,76,Spring2018
4065,N Williams & NE Morris,6364,N,NS,70,112,182,77,Spring2018
4066,N Williams & NE Shaver,6366,N,NS,12,49,61,5,Spring2018
4067,N Williams & NE Skidmore,6367,N,NS,6,52,58,1,Spring2018
4068,N Williams & NE Tillamook,6370,N,FS,20,64,84,9,Spring2018
4069,N Williams & NE Wygant,6371,N,NS,5,36,41,2,Spring2018
4070,N Willis & Bayard,6373,W,NS,17,41,58,1,Spring2018
4071,N Willis & Chautauqua,6374,E,NS,19,2,21,1,Spring2018
4072,N Willis & Druid,6375,W,FS,0,23,23,1,Spring2018
4073,N Willis & Druid,6376,E,NS,26,1,27,1,Spring2018
4074,N Willis & Emerald,6377,E,NS,49,15,64,1,Spring2018
4081,N Willis & Wabash,6378,W,OP,7,35,42,15,Spring2018
4082,N Willis & Hereford,6379,W,NS,1,15,16,6,Spring2018
4083,N Willis & Hodge,6380,E,FS,19,1,20,1,Spring2018
4084,N Willis & Newman,6381,E,NS,33,1,34,1,Spring2018
4085,N Willis & Newman,6382,W,FS,1,29,30,1,Spring2018
4086,N Willis & Peninsular,6383,E,NS,58,21,79,5,Spring2018
4087,N Willis & Peninsular,6384,W,FS,22,52,74,2,Spring2018
4088,N Willis & Portsmouth,6385,W,NS,0,33,33,1,Spring2018
4089,N Willis & Wabash,6386,E,NS,48,9,57,6,Spring2018
4090,N Willis & Washburne,6387,W,FS,3,18,21,0,Spring2018
4091,N Willis & Washburne,6388,E,NS,33,15,48,0,Spring2018
4092,N Willis & Wayland,6389,W,NS,2,21,23,1,Spring2018
4093,N Willis & Wayland,6390,E,NS,25,1,26,1,Spring2018
4094,N Willis & Woolsey,6391,W,NS,0,21,21,1,Spring2018
4095,N Willis & Woolsey,6392,E,NS,21,0,21,1,Spring2018
4096,SE Woodstock & 94th (I-205 West End),6398,E,FS,26,22,48,5,Spring2018
4097,SE Woodstock & Moreland Ln,6399,E,NS,4,9,13,0,Spring2018
4098,3000 Block SE Woodstock,6400,W,OP,5,3,8,1,Spring2018
4099,SE Woodstock & 32nd,6402,E,NS,4,8,12,0,Spring2018
4100,SE Woodstock & 32nd,6403,W,OP,23,10,33,8,Spring2018
4101,SE Woodstock & 34th,6405,E,NS,7,12,19,0,Spring2018
4102,SE Woodstock & 34th,6406,W,OP,8,7,15,1,Spring2018
4103,SE Woodstock & 36th,6407,E,NS,5,7,12,4,Spring2018
4104,3600 Block SE Woodstock,6408,W,OP,10,5,15,0,Spring2018
4105,SE Woodstock & Cesar Chavez Blvd,6409,W,NS,14,2,16,1,Spring2018
4106,SE Woodstock & 41st,6411,E,NS,10,73,83,26,Spring2018
4107,SE Woodstock & 41st,6412,W,NS,67,13,80,24,Spring2018
4108,SE Woodstock & 43rd,6413,E,NS,21,77,98,50,Spring2018
4109,SE Woodstock & 43rd,6414,W,NS,103,37,140,104,Spring2018
4110,SE Woodstock & 46th,6415,E,NS,157,210,367,170,Spring2018
4111,SE Woodstock & 46th,6416,W,NS,53,58,111,47,Spring2018
4112,SE Woodstock & 49th,6419,E,FS,17,28,45,28,Spring2018
4113,SE Woodstock & 49th,6420,W,NS,22,15,37,19,Spring2018
4114,SE Woodstock & 51st,6421,W,NS,58,8,66,7,Spring2018
4115,SE Woodstock & 92nd,6427,E,NS,33,75,108,28,Spring2018
4116,SE Yamhill & 69th,6442,W,NS,8,7,15,5,Spring2018
4117,SE Yamhill & 71st,6443,E,NS,2,17,19,0,Spring2018
4118,SE Yamhill & 71st,6444,W,NS,15,2,17,0,Spring2018
4119,SE Yamhill & 73rd,6445,E,NS,3,11,14,0,Spring2018
4120,SE Yamhill & 73rd,6446,W,FS,10,4,14,0,Spring2018
4121,SE Yamhill & 76th,6447,E,NS,6,44,50,0,Spring2018
4122,4200 Block NW Yeon,6458,W,AT,0,4,4,0,Spring2018
4123,4000 Block NW Yeon Frontage Rd,6460,E,AT,7,0,7,0,Spring2018
4124,3900 Block NW Yeon Frontage Rd,6463,E,AT,6,0,6,0,Spring2018
4125,3900 Block NW Yeon,6467,W,AT,0,9,9,0,Spring2018
4126,NW Yeon & 44th,6470,E,FS,77,49,126,11,Spring2018
4127,2200 Block SW 1st,6472,N,AT,2,13,15,11,Spring2018
4134,SW 1st & Madison Tower,6473,S,AT,0,0,0,3,Spring2018
4135,SW 1st & Arthur,6474,S,NS,5,1,6,0,Spring2018
4136,SW 1st & Arthur,6475,N,NS,0,7,7,0,Spring2018
4137,SW Washington & Adams,6477,E,NS,22,203,225,38,Spring2018
4138,SW 1st & Hooker,6480,S,NS,2,0,2,0,Spring2018
4139,SW 1st & Hooker,6481,N,NS,0,1,1,0,Spring2018
4140,SW 1st & Woods,6488,S,NS,1,0,1,0,Spring2018
4141,SW 1st & Woods,6489,N,FS,0,1,1,0,Spring2018
4142,SE 10th & Maple,6495,N,NS,74,72,146,26,Spring2018
4143,SE 10th & Maple,6496,S,FS,85,68,153,32,Spring2018
4144,SE Tualatin Valley Hwy & 11th,6498,S,FS,35,24,59,7,Spring2018
4145,SE 10th & Walnut,6499,N,NS,81,103,184,17,Spring2018
4146,SE 10th & Walnut,6500,S,NS,141,76,217,16,Spring2018
4147,SE 10th & Baseline,6502,N,NS,54,4,58,5,Spring2018
4148,100 Block NE 102nd,6503,S,AT,9,6,15,8,Spring2018
4149,NE 102nd & Davis,6504,N,NS,5,7,12,2,Spring2018
4150,NE 102nd & Alton,6505,S,NS,7,1,8,8,Spring2018
4151,NE 102nd & Beech,6506,N,FS,0,5,5,0,Spring2018
4152,NE 102nd & Bell,6507,S,FS,9,5,14,2,Spring2018
4153,NE 102nd & Brazee,6508,N,NS,3,8,11,0,Spring2018
4154,NE 102nd & Brazee,6509,S,FS,7,2,9,5,Spring2018
4155,SE 102nd & E Burnside,6510,N,NS,23,71,94,24,Spring2018
4156,SE 102nd & Burnside,6511,S,FS,249,135,384,120,Spring2018
4157,NE 102nd & Clackamas,6513,S,OP,5,22,27,5,Spring2018
4158,NE 102nd & Fremont,6514,N,NS,3,15,18,9,Spring2018
4159,NE 102nd & Fremont,6515,S,NS,15,3,18,1,Spring2018
4160,NE 102nd & Glisan,6516,N,NS,9,29,38,15,Spring2018
4161,NE 102nd & Glisan,6517,S,FS,30,15,45,8,Spring2018
4162,NE 102nd & Hancock,6518,N,NS,8,6,14,2,Spring2018
4163,NE 102nd & Knott,6519,S,OP,3,1,4,0,Spring2018
4164,102nd & Morris St,6520,S,FS,16,4,20,1,Spring2018
4165,NE 102nd & Morris Ct,6521,N,FS,3,15,18,0,Spring2018
4166,1200 Block NE 102nd,6522,N,OP,54,8,62,15,Spring2018
4167,1200 Block NE 102nd,6523,S,AT,8,31,39,17,Spring2018
4168,NE 102nd & Pacific,6525,S,NS,1,11,12,3,Spring2018
4169,SE 102nd & Pine,6526,S,FS,26,49,75,8,Spring2018
4170,NE 102nd & Shaver,6528,N,NS,2,8,10,2,Spring2018
4171,SE 102nd & Washington,6529,S,NS,31,37,68,27,Spring2018
4172,NE 102nd & Tillamook,6530,N,NS,3,5,8,5,Spring2018
4173,NE 102nd & Weidler,6531,N,NS,40,12,52,10,Spring2018
4174,NE 102nd & Weidler,6532,S,NS,5,15,20,9,Spring2018
4175,NW 107th & Copeland,6535,S,NS,0,0,0,0,Spring2018
4176,NW Cornell & 107th,6536,E,NS,1,0,1,0,Spring2018
4177,NW 107th & Cornell,6537,N,NS,0,1,1,0,Spring2018
4178,NW 107th & Walters,6539,N,NS,0,0,0,0,Spring2018
4179,SE 11th & Ash,6541,S,NS,18,23,41,12,Spring2018
4180,SE 11th & Belmont,6542,S,FS,61,71,132,18,Spring2018
4187,SE 11th & Clay,6543,S,NS,14,16,30,6,Spring2018
4188,SE 11th & Division,6545,S,NS,49,64,113,7,Spring2018
4189,SW 11th & Gibbs,6548,N,NS,65,144,209,7,Spring2018
4190,SE 11th & Madison,6551,S,FS,35,74,109,7,Spring2018
4191,SE 11th & Sherman,6553,S,NS,5,14,19,1,Spring2018
4192,SE 11th & Stark,6554,S,NS,34,44,78,31,Spring2018
4193,SE 11th & Stephens,6555,S,NS,6,15,21,3,Spring2018
4194,NE 111th & Knott,6557,N,NS,0,1,1,0,Spring2018
4195,NE 111th & Knott,6558,S,NS,1,0,1,0,Spring2018
4196,NE 111th & Morris,6559,N,NS,0,3,3,1,Spring2018
4197,NE 111th & Sacramento,6561,N,NS,0,3,3,0,Spring2018
4198,NE 111th & Sacramento,6562,S,NS,2,0,2,0,Spring2018
4199,NE 111th & San Rafael,6563,N,NS,0,3,3,0,Spring2018
4200,NE 111th & San Rafael,6564,S,OP,3,0,3,0,Spring2018
4201,NE 111th & Weidler,6565,N,NS,2,3,5,4,Spring2018
4202,NE 111th & Weidler,6566,S,NS,6,2,8,2,Spring2018
4203,SE 112th & Mt Scott Blvd,6567,N,FS,5,14,19,3,Spring2018
4204,SE 12th & Clay,6576,N,NS,20,39,59,5,Spring2018
4205,NE 12th & Couch,6577,S,FS,114,75,189,32,Spring2018
4206,SE 12th & Division,6578,N,NS,77,50,127,6,Spring2018
4207,NE 12th & Glisan,6580,S,NS,56,51,107,0,Spring2018
4208,SE 12th & Harrison,6581,N,NS,20,7,27,0,Spring2018
4209,NE 12th & Irving,6582,N,NS,71,66,137,0,Spring2018
4210,NE 12th & Irving,6583,S,NS,7,3,10,0,Spring2018
4211,SE 12th & Madison,6585,N,FS,79,24,103,13,Spring2018
4212,SE 12th & Morrison,6588,N,NS,70,71,141,38,Spring2018
4213,NE 12th & E Burnside,6592,N,FS,90,141,231,36,Spring2018
4214,SE 12th & Stark,6594,N,NS,59,41,100,24,Spring2018
4215,SW 121st & North Dakota,6597,N,NS,8,1,9,1,Spring2018
4216,SW 121st & Katherine,6598,S,FS,3,4,7,0,Spring2018
4217,SW 121st & Lynn,6599,N,NS,5,3,8,0,Spring2018
4218,SW 121st & Merestone,6601,N,NS,3,1,4,0,Spring2018
4219,SW 121st & Merestone,6602,S,NS,2,1,3,0,Spring2018
4220,SW 121st & North Dakota,6603,S,NS,1,7,8,0,Spring2018
4221,NE 121st Pl & Prescott,6604,N,NS,50,49,99,7,Spring2018
4222,SW 121st & Scholls Ferry,6606,S,FS,12,20,32,3,Spring2018
4223,SW 121st & Springwood,6607,N,NS,8,6,14,0,Spring2018
4224,SW 121st & Summer,6608,S,FS,0,1,1,0,Spring2018
4225,NE 122nd & Davis,6610,S,NS,118,39,157,78,Spring2018
4226,300 Block NE 122nd,6611,N,AT,31,82,113,44,Spring2018
4227,3600 Block NE 122nd,6613,S,OP,28,14,42,1,Spring2018
4228,NE 122nd & Halsey,6617,S,NS,126,55,181,49,Spring2018
4229,SE 122nd & Boise,6618,N,NS,46,7,53,2,Spring2018
4230,SE 122nd & Boise,6619,S,NS,48,56,104,8,Spring2018
4231,NE 122nd & Brazee,6620,N,NS,17,14,31,1,Spring2018
4232,SE 122nd & E Burnside,6621,N,NS,133,341,474,114,Spring2018
4233,SE 122nd & Burnside,6623,S,FS,323,177,500,129,Spring2018
4240,SE 122nd & Bush,6624,N,FS,40,21,61,5,Spring2018
4241,SE 122nd & Bush,6625,S,FS,22,36,58,4,Spring2018
4242,SE 122nd & Foster,6626,N,FS,73,20,93,10,Spring2018
4243,NE 122nd & Halsey,6628,N,FS,49,70,119,36,Spring2018
4244,SE 122nd & Division,6630,N,FS,297,140,437,88,Spring2018
4245,SE 122nd & Division,6631,S,FS,147,290,437,90,Spring2018
4246,SE 122nd & Harold,6633,N,NS,62,9,71,16,Spring2018
4247,SE 122nd & Harold,6634,S,NS,4,49,53,6,Spring2018
4248,SE 122nd & Holgate,6635,N,NS,126,16,142,37,Spring2018
4249,SE 122nd & Holgate,6636,S,FS,20,87,107,35,Spring2018
4250,SE 122nd & Lincoln,6640,N,FS,61,24,85,3,Spring2018
4251,SE 122nd & Lincoln,6641,S,NS,26,66,92,6,Spring2018
4252,SE 122nd & Madison,6642,N,NS,28,11,39,4,Spring2018
4253,1300 Block SE 122nd,6643,S,OP,12,20,32,5,Spring2018
4254,SE 122nd & Market,6645,N,NS,62,58,120,14,Spring2018
4255,SE 122nd & Market,6646,S,NS,78,67,145,19,Spring2018
4256,500 Block NE 122nd Ave,6648,N,OP,48,62,110,66,Spring2018
4257,700 Block NE 122nd,6649,S,AT,57,39,96,68,Spring2018
4258,SE 122nd & Midland Library (Morrison),6650,S,AT,67,45,112,21,Spring2018
4259,NE 122nd & Multnomah,6651,N,NS,8,20,28,3,Spring2018
4260,SE 122nd & Oak,6652,N,OP,96,142,238,51,Spring2018
4261,SE 122nd & Oak,6653,S,NS,40,33,73,17,Spring2018
4262,NE 122nd & Shaver,6654,N,NS,16,109,125,17,Spring2018
4263,SE 122nd & Powell,6655,N,FS,263,71,334,76,Spring2018
4264,SE 122nd & Ramona,6657,N,NS,54,6,60,2,Spring2018
4265,SE 122nd & Ramona,6658,S,OP,8,46,54,7,Spring2018
4266,SE 122nd & Raymond,6660,N,FS,26,3,29,1,Spring2018
4267,SE 122nd & Reedway,6662,S,NS,2,11,13,12,Spring2018
4268,NE 122nd & Sacramento,6667,S,NS,15,17,32,1,Spring2018
4269,SE 122nd & Rhone,6668,S,NS,146,101,247,68,Spring2018
4270,SE 122nd & Salmon,6669,N,FS,10,16,26,0,Spring2018
4271,NE 122nd & San Rafael,6670,N,NS,50,66,116,39,Spring2018
4272,NE 122nd & San Rafael,6671,S,FS,60,51,111,37,Spring2018
4273,NE 122nd & Shaver,6672,S,NS,90,35,125,10,Spring2018
4274,NE 122nd & Stanton,6673,N,NS,14,24,38,13,Spring2018
4275,NE 122nd & Stanton,6674,S,NS,29,22,51,5,Spring2018
4276,SE 122nd & Woodward Pl,6675,N,OP,23,9,32,5,Spring2018
4277,SE 122nd & Woodward Pl,6676,S,FS,5,17,22,5,Spring2018
4278,NE 125th Pl & Riverwood 40,6682,E,NS,1,9,10,0,Spring2018
4279,NE 125th Pl & Shaver,6683,N,FS,1,3,4,0,Spring2018
4280,SE 13th & Clatsop,6688,N,NS,11,1,12,2,Spring2018
4281,SW 13th & Custer,6689,N,NS,3,8,11,0,Spring2018
4282,SE 13th & Knapp,6691,N,NS,12,1,13,0,Spring2018
4283,SE 13th & Lambert,6693,N,NS,28,3,31,0,Spring2018
4284,SE 13th & Lambert,6694,S,NS,1,19,20,0,Spring2018
4285,SE 13th & Nehalem,6699,N,NS,29,3,32,1,Spring2018
4286,SE 13th & Nehalem,6700,S,NS,3,32,35,1,Spring2018
4293,SE 13th & Sellwood,6707,S,NS,1,7,8,0,Spring2018
4294,SE 13th & Tacoma,6708,N,NS,40,7,47,8,Spring2018
4295,SE 13th & Tacoma,6709,S,FS,8,47,55,11,Spring2018
4296,SE 13th & Umatilla,6711,N,NS,11,2,13,0,Spring2018
4297,NE 132nd & Brazee,6713,S,NS,1,0,1,0,Spring2018
4298,NE 132nd & Eugene,6714,N,FS,0,1,1,0,Spring2018
4299,NE 132nd & Eugene,6715,S,NS,2,0,2,0,Spring2018
4300,NE 132nd & Knott,6716,N,OP,0,4,4,0,Spring2018
4301,NE 132nd & San Rafael,6718,S,NS,1,0,1,0,Spring2018
4302,NE 133rd & Shaver,6719,S,NS,1,1,2,0,Spring2018
4303,NE 135th & Fremont,6720,S,FS,2,4,6,0,Spring2018
4304,NE 135th & Rose Parkway,6722,S,NS,3,4,7,0,Spring2018
4305,6000 Block SE 136th,6723,N,AT,12,5,17,0,Spring2018
4306,SE 136th & Center,6725,N,FS,15,2,17,0,Spring2018
4307,SE 136th & Mall,6728,N,NS,13,2,15,6,Spring2018
4308,SE 136th & Ramona,6729,N,OP,18,4,22,1,Spring2018
4309,SE 136th & Ramona,6730,S,NS,6,17,23,3,Spring2018
4310,SE 136th & Rhone,6731,N,FS,22,5,27,2,Spring2018
4311,SW 14th Dr & Battaglia,6735,E,NS,0,0,0,7,Spring2018
4312,SW 14th Dr & Battaglia,6736,W,OP,0,0,0,5,Spring2018
4313,SW 14th Dr & Binford,6737,E,NS,2,0,2,0,Spring2018
4314,SW 14th Dr & Binford,6738,W,OP,0,1,1,0,Spring2018
4315,SW 14th Dr & Birdsdale,6739,E,NS,1,0,1,0,Spring2018
4316,SW 14th Dr & Birdsdale,6740,W,OP,0,1,1,0,Spring2018
4317,SW 14th Dr & Tegart,6742,E,FS,2,0,2,3,Spring2018
4318,SW 14th Dr & Tegart,6743,W,OP,1,0,1,0,Spring2018
4319,SW 14th Dr & Pleasant View Dr,6744,E,NS,1,0,1,0,Spring2018
4320,SW 14th Dr & Pleasant View,6745,W,NS,0,1,1,1,Spring2018
4321,NE 141st & Failing,6746,N,NS,6,1,7,1,Spring2018
4322,NE 141st & Beech,6747,S,FS,2,7,9,1,Spring2018
4323,NE 141st & Failing,6748,S,FS,5,3,8,2,Spring2018
4324,NE 141st & Fremont,6749,S,NS,3,4,7,0,Spring2018
4325,NE 141st & Milton Ct,6750,N,FS,4,0,4,0,Spring2018
4326,NE 143rd & Fremont Ct,6755,N,NS,1,1,2,0,Spring2018
4327,NE 145th & Fremont,6765,N,NS,3,3,6,3,Spring2018
4328,NE 15th & Ainsworth,6771,N,NS,1,33,34,2,Spring2018
4329,NE 15th & Ainsworth,6772,S,NS,41,2,43,4,Spring2018
4330,NE 15th & Alberta,6773,N,NS,39,273,312,34,Spring2018
4331,NE 15th & Alberta,6774,S,FS,185,47,232,25,Spring2018
4332,NE 15th & Brazee,6777,N,NS,7,35,42,3,Spring2018
4333,NE 15th & Brazee,6778,S,NS,27,6,33,4,Spring2018
4334,NE 15th & Weidler,6779,S,NS,71,78,149,35,Spring2018
4335,NE 15th & Dekum,6780,N,NS,2,79,81,2,Spring2018
4336,NE 15th & Failing,6783,N,NS,10,38,48,1,Spring2018
4337,NE 15th & Failing,6784,S,NS,36,4,40,1,Spring2018
4338,NE 15th & Fremont,6785,N,NS,32,126,158,34,Spring2018
4339,NE 15th & Fremont,6786,S,NS,119,33,152,29,Spring2018
4346,NE 15th & Going,6787,N,NS,2,34,36,0,Spring2018
4347,NE 15th & Going,6788,S,NS,49,5,54,3,Spring2018
4348,NE 15th & Halsey,6789,S,FS,29,23,52,10,Spring2018
4349,NE 15th & Holman,6790,N,NS,1,42,43,8,Spring2018
4350,NE 15th & Jarrett,6792,N,NS,3,28,31,9,Spring2018
4351,NE 15th & Jarrett,6793,S,NS,36,2,38,12,Spring2018
4352,NE 15th & Junior,6794,S,NS,76,3,79,0,Spring2018
4353,NE 15th & Killingsworth,6795,N,NS,12,92,104,9,Spring2018
4354,NE 15th & Killingsworth,6796,S,NS,84,11,95,3,Spring2018
4355,NE 15th & Holman,6797,S,FS,38,1,39,7,Spring2018
4356,NE 15th & Knott,6799,N,NS,5,41,46,1,Spring2018
4357,NE 15th & Knott,6800,S,NS,45,7,52,1,Spring2018
4358,NE 15th & Mason,6801,N,NS,6,35,41,11,Spring2018
4359,NE 15th & Mason,6802,S,NS,40,5,45,6,Spring2018
4360,NE 15th & Rosa Parks Way,6803,N,NS,0,22,22,2,Spring2018
4361,NE 15th & Rosa Parks Way,6804,S,NS,37,1,38,1,Spring2018
4362,NE 15th & Prescott,6805,S,FS,51,3,54,1,Spring2018
4363,NE 15th & Siskiyou,6808,N,NS,4,43,47,1,Spring2018
4364,NE 15th & Siskiyou,6809,S,NS,37,5,42,1,Spring2018
4365,NE 15th & Prescott,6810,N,NS,3,61,64,3,Spring2018
4366,NE 15th & Sumner,6813,S,NS,43,3,46,7,Spring2018
4367,NE 15th & Sumner,6814,N,NS,2,15,17,0,Spring2018
4368,NE 15th & Thompson,6815,N,NS,6,24,30,1,Spring2018
4369,NE 15th & Thompson,6816,S,NS,21,3,24,0,Spring2018
4370,NE 15th & Tillamook,6817,S,FS,49,16,65,35,Spring2018
4371,NE 16th & Multnomah,6818,S,NS,37,18,55,5,Spring2018
4372,NW 158th & Greenbrier Pkwy,6828,N,FS,6,29,35,3,Spring2018
4373,NW 158th & Greenbrier Pkwy,6829,S,OP,29,5,34,4,Spring2018
4374,SW 158th & Jay,6830,N,NS,0,0,0,0,Spring2018
4375,SW 158th & Walker,6832,N,FS,18,31,49,4,Spring2018
4376,SW 158th & Walker,6833,S,FS,8,12,20,2,Spring2018
4377,NE 15th & Hancock,6834,N,NS,22,44,66,41,Spring2018
4378,16th & Harrison,6835,W,NS,1,1,2,0,Spring2018
4379,16th & Harrison,6836,E,NS,2,1,3,0,Spring2018
4380,16th & Jackson,6837,W,NS,1,0,1,1,Spring2018
4381,NE 16th & Sandy,6839,N,NS,78,151,229,31,Spring2018
4382,16th & Taylor,6840,E,NS,0,2,2,0,Spring2018
4383,16th & Taylor,6841,W,NS,1,0,1,0,Spring2018
4384,NE 16th & Multnomah,6842,N,FS,16,51,67,7,Spring2018
4385,NE 15th & Broadway,6843,N,NS,80,79,159,35,Spring2018
4386,SE 17th & Mitchell,6846,S,FS,5,20,25,3,Spring2018
4387,SE 17th & Bybee,6847,S,NS,18,39,57,15,Spring2018
4388,SE 17th & Bybee,6848,N,NS,10,12,22,3,Spring2018
4389,SE 17th & Center,6849,N,NS,143,107,250,42,Spring2018
4390,SE 17th & Center,6850,S,NS,104,123,227,11,Spring2018
4391,SE 17th & Clatsop,6852,S,NS,6,26,32,10,Spring2018
4392,SE 17th & Marion,6853,N,NS,12,2,14,2,Spring2018
4399,SE 17th & Claybourne,6856,N,NS,17,9,26,8,Spring2018
4400,SE 17th & Claybourne,6857,S,NS,7,13,20,7,Spring2018
4401,SE 17th & Harney,6860,N,NS,12,2,14,3,Spring2018
4402,SE 17th & Harold,6861,N,NS,16,3,19,2,Spring2018
4403,SE 17th & Harold,6862,S,NS,4,10,14,1,Spring2018
4404,SE 17th & Knight,6867,N,NS,18,3,21,0,Spring2018
4405,SE 17th & Knight,6868,S,NS,3,19,22,1,Spring2018
4406,SE 17th & Lava,6871,N,OP,10,1,11,0,Spring2018
4407,SE 17th & Lava,6872,S,FS,1,9,10,0,Spring2018
4408,SE 17th & Lexington,6873,N,NS,15,3,18,1,Spring2018
4409,SE 17th & Lexington,6874,S,NS,1,20,21,0,Spring2018
4410,SE 17th & Mall,6876,N,OP,47,125,172,24,Spring2018
4411,SE 17th & Mall,6877,S,NS,103,40,143,35,Spring2018
4412,SE 17th & McLoughlin,6882,N,NS,18,4,22,1,Spring2018
4413,SE 17th & Ochoco St,6885,N,NS,37,19,56,4,Spring2018
4414,SE 17th & Ochoco St,6886,S,NS,10,38,48,4,Spring2018
4415,SE 17th & Rex,6889,N,NS,10,1,11,0,Spring2018
4416,SE 17th & Rex,6890,S,NS,1,17,18,14,Spring2018
4417,SE 17th & Schiller,6893,N,FS,3,2,5,0,Spring2018
4418,SE 17th & Schiller,6894,S,NS,3,3,6,0,Spring2018
4419,SE 17th & Tacoma,6896,S,NS,3,47,50,14,Spring2018
4420,SE 17th & Tenino,6897,N,NS,38,6,44,7,Spring2018
4421,SE 17th & Tolman,6898,N,NS,17,6,23,3,Spring2018
4422,SE 17th & Tolman,6899,S,NS,5,24,29,5,Spring2018
4423,SE 17th & Umatilla,6900,S,FS,5,31,36,9,Spring2018
4424,SE 17th & Waverly,6901,N,NS,4,4,8,0,Spring2018
4425,SE 17th & Waverly,6902,S,NS,2,4,6,0,Spring2018
4426,NW 174th & Santiam,6904,N,OP,1,5,6,0,Spring2018
4427,NW 174th & Santiam,6905,S,FS,6,0,6,0,Spring2018
4428,SW 18th & Elizabeth,6908,N,FS,5,0,5,0,Spring2018
4429,NE 181st & Davis,6912,S,NS,2,9,11,4,Spring2018
4430,SE 181st & Yamhill,6913,N,FS,4,5,9,0,Spring2018
4431,NE 181st & E Burnside,6914,N,FS,57,35,92,16,Spring2018
4432,800 Block NE 181st,6916,N,AT,8,7,15,1,Spring2018
4433,NE 181st & Everett Ct,6918,N,NS,2,2,4,1,Spring2018
4434,NE 181st & Glisan,6919,N,NS,9,7,16,1,Spring2018
4435,NE 181st & Glisan,6920,S,FS,10,18,28,4,Spring2018
4436,SE 181st & Oak,6921,N,NS,32,20,52,3,Spring2018
4437,NE 181st & Wasco,6922,N,OP,2,7,9,1,Spring2018
4438,NE 181st & Wasco,6923,S,NS,13,2,15,0,Spring2018
4439,1900 Block SE 182nd,6924,N,AT,7,1,8,1,Spring2018
4440,SE 182nd & 3rd,6926,N,FS,1,1,2,0,Spring2018
4441,SE 182nd & SW 5th Dr,6928,N,NS,4,0,4,1,Spring2018
4442,SE 181st & Yamhill,6929,S,NS,4,3,7,1,Spring2018
4443,SE 182nd & Brooklyn Ct,6930,N,NS,6,1,7,0,Spring2018
4444,SE 182nd & Haig,6931,N,NS,14,1,15,1,Spring2018
4445,SE 182nd & Clinton,6934,N,NS,2,1,3,1,Spring2018
4452,SE 182nd & Division,6935,S,FS,8,31,39,10,Spring2018
4453,SE 182nd & Division,6936,N,FS,40,10,50,8,Spring2018
4454,SE 182nd & Lincoln,6937,S,FS,1,8,9,1,Spring2018
4455,SE 182nd & Market,6938,S,NS,5,5,10,0,Spring2018
4456,SE 182nd & Market,6939,N,OP,6,3,9,1,Spring2018
4457,SE 182nd & Mill,6940,N,NS,4,1,5,0,Spring2018
4458,SE 182nd & W Powell,6942,N,FS,28,0,28,3,Spring2018
4459,SE 182nd & Stephens,6943,S,NS,3,4,7,0,Spring2018
4460,SE 182nd & Tibbetts,6944,S,NS,2,5,7,1,Spring2018
4461,2800 Block SW 185th,6945,N,AT,17,11,28,0,Spring2018
4462,3000 Block SW 185th,6946,S,AT,11,15,26,0,Spring2018
4463,SW 185th & Aloha High School Drive,6952,S,NS,9,10,19,0,Spring2018
4464,NW 185th & Adrian,6953,N,OP,1,5,6,1,Spring2018
4465,NW 185th & Adrian,6954,S,FS,5,3,8,0,Spring2018
4466,SW 185th & Aloha Park Apts,6955,N,OP,8,17,25,3,Spring2018
4467,SW 185th & Aloha Park Apts,6956,S,AT,13,13,26,10,Spring2018
4468,SW 185th & Alexander,6957,N,FS,53,11,64,6,Spring2018
4469,SW 185th & Blanton,6959,S,FS,13,10,23,1,Spring2018
4470,SW 185th & Blanton,6960,N,OP,16,15,31,1,Spring2018
4471,NW 185th & Cornell,6961,N,FS,34,188,222,27,Spring2018
4472,NW 185th & Cornell,6964,S,FS,165,40,205,23,Spring2018
4473,SW 185th & Ewen,6968,N,FS,6,3,9,0,Spring2018
4474,SW 185th & Ewen,6969,S,OP,3,6,9,0,Spring2018
4475,SW 185th & Farmington,6970,N,FS,104,89,193,15,Spring2018
4476,NW 185th & Heritage Pkwy,6972,N,FS,29,18,47,1,Spring2018
4477,NW 185th & Heritage Pkwy,6975,S,FS,14,39,53,9,Spring2018
4478,SW 185th & Honeywood,6976,S,FS,5,3,8,1,Spring2018
4479,SW 185th & Jay,6977,N,FS,5,6,11,2,Spring2018
4480,SW 185th & Johnson,6978,N,FS,48,23,71,1,Spring2018
4481,SW 185th & Johnson,6979,S,FS,22,39,61,0,Spring2018
4482,SW 185th & Kinnaman,6980,N,NS,74,65,139,9,Spring2018
4483,SW 185th & Kinnaman,6981,S,FS,70,72,142,7,Spring2018
4484,SW 185th & Longacre,6982,N,FS,5,8,13,0,Spring2018
4485,SW 185th & Longacre,6983,S,FS,6,6,12,0,Spring2018
4486,SW 185th & Madeline,6984,N,NS,15,9,24,1,Spring2018
4487,NW 185th & McKinley School,6986,N,NS,14,40,54,11,Spring2018
4488,NW 185th & Sunset Square,6987,S,AT,63,26,89,18,Spring2018
4489,NW 185th & Holly,6990,N,OP,5,7,12,2,Spring2018
4490,NW 185th & Holly,6991,S,FS,6,8,14,3,Spring2018
4491,NW 185th & Parkview,6992,N,FS,8,35,43,2,Spring2018
4492,SW 185th & Pheasant,6993,N,FS,2,1,3,1,Spring2018
4493,SW 185th & Pheasant,6994,S,OP,1,2,3,1,Spring2018
4494,SW 185th & Pike,6995,N,NS,5,6,11,0,Spring2018
4495,SW 185th & Pike,6996,S,FS,4,5,9,1,Spring2018
4496,NW 185th & Bronson,6999,S,OP,20,5,25,1,Spring2018
4497,NW 185th & Westview HS,7000,N,AT,11,51,62,3,Spring2018
4498,NW 185th & Rock Creek School,7001,S,AT,68,10,78,4,Spring2018
4505,SW 185th & Rosa,7002,N,FS,14,14,28,1,Spring2018
4506,SW 185th & Rosa,7003,S,NS,18,24,42,3,Spring2018
4507,SW 185th & Edgeway Dr,7006,S,NS,1,11,12,1,Spring2018
4508,SW 185th & Salix Terrace,7007,N,FS,14,2,16,2,Spring2018
4509,SW 185th & Sandra,7009,S,OP,11,13,24,1,Spring2018
4510,SW 185th & Sandra,7010,N,FS,10,7,17,1,Spring2018
4511,NW 185th & Springville,7011,N,NS,0,2,2,2,Spring2018
4512,SW 185th & Tualatin Valley Hwy,7012,N,NS,99,74,173,24,Spring2018
4513,SW 185th & Tualatin Valley Hwy,7013,S,FS,66,67,133,14,Spring2018
4514,NW 185th & Tamarack,7014,N,FS,0,8,8,1,Spring2018
4515,NW 185th & Tamarack,7015,S,OP,6,0,6,0,Spring2018
4516,700 Block NW 185th,7020,N,AT,14,50,64,11,Spring2018
4517,700 Block NW 185th,7021,S,AT,25,8,33,11,Spring2018
4518,SW 185th & W Baseline,7023,S,FS,23,15,38,12,Spring2018
4519,NW 185th & Walker,7024,N,FS,49,80,129,7,Spring2018
4520,NW 185th & NE Walker,7025,S,FS,95,46,141,9,Spring2018
4521,NW 185th & West Union,7026,N,FS,7,77,84,22,Spring2018
4522,NW 185th & West Union,7027,S,NS,93,7,100,13,Spring2018
4523,SW 19th & Barbur,7036,S,FS,6,5,11,0,Spring2018
4524,19th & Birch,7038,E,NS,36,2,38,6,Spring2018
4525,19th & Cedar,7041,E,NS,56,1,57,3,Spring2018
4526,19th & Elm,7043,E,NS,73,4,77,30,Spring2018
4527,19th & Hawthorne,7044,E,NS,56,5,61,28,Spring2018
4528,19th & Main,7046,E,FS,103,2,105,20,Spring2018
4529,SW 19th & Multnomah,7047,N,FS,4,11,15,1,Spring2018
4530,19th Way & 19th Ave,7048,E,FS,135,33,168,60,Spring2018
4531,SW 19th & Spring Garden,7049,S,NS,0,2,2,0,Spring2018
4532,700 Block SW 197th,7052,S,OP,3,6,9,0,Spring2018
4533,SW 197th & W Baseline,7053,N,NS,8,4,12,0,Spring2018
4534,SW 197th & Frances,7054,S,FS,4,10,14,18,Spring2018
4535,SW 198th & Blanton,7060,N,NS,5,4,9,0,Spring2018
4536,SW 198th & Blanton,7061,S,NS,9,8,17,2,Spring2018
4537,SW 198th & Butternut,7062,N,FS,4,0,4,5,Spring2018
4538,SW 198th & Butternut,7063,S,OP,0,2,2,2,Spring2018
4539,SW 198th & Carlin,7064,S,FS,25,19,44,0,Spring2018
4540,SW 198th & Carlin,7065,N,OP,16,25,41,2,Spring2018
4541,SW 198th & Celebrity,7066,S,NS,3,3,6,1,Spring2018
4542,SW 198th & Celebrity,7067,N,FS,4,3,7,0,Spring2018
4543,SW 198th & Deline,7068,S,FS,3,5,8,3,Spring2018
4544,SW 198th & Deline,7069,N,OP,4,3,7,2,Spring2018
4545,SW 198th & Farmington,7070,S,NS,23,18,41,0,Spring2018
4546,SW 198th & Farmington,7071,N,FS,24,23,47,0,Spring2018
4547,SW 198th & Imperial,7072,S,NS,2,2,4,1,Spring2018
4548,SW 198th & Johnson,7073,S,FS,4,3,7,0,Spring2018
4549,SW 198th & Johnson,7074,N,NS,6,3,9,0,Spring2018
4550,SW 198th & Kinnaman,7075,S,NS,5,7,12,0,Spring2018
4551,SW 198th & Kinnaman,7076,N,NS,7,7,14,0,Spring2018
4558,SW 198th & Prospect,7077,N,FS,4,2,6,1,Spring2018
4559,SW 198th & Prospect,7078,S,OP,2,2,4,7,Spring2018
4560,SW 198th & Rock Dr,7079,S,NS,6,9,15,6,Spring2018
4561,SW 198th & Rosa,7082,N,FS,12,9,21,17,Spring2018
4562,SW 198th & Rosa,7083,S,FS,9,11,20,16,Spring2018
4563,SW 198th & Sandra,7084,N,NS,3,3,6,3,Spring2018
4564,SW 198th & Southview,7086,S,FS,6,12,18,1,Spring2018
4565,SW 198th & Southview,7087,N,NS,10,6,16,0,Spring2018
4566,SW 198th & Trelane,7089,S,OP,4,3,7,0,Spring2018
4567,SW 198th & Trelane,7090,N,FS,3,4,7,0,Spring2018
4568,SW 198th & Oak,7092,N,FS,3,2,5,0,Spring2018
4569,SW 198th & York,7093,S,NS,5,6,11,0,Spring2018
4570,SW 198th & York,7094,N,FS,4,6,10,0,Spring2018
4571,SW 2nd & Alder,7095,N,NS,300,25,325,14,Spring2018
4572,SW 2nd & Taylor,7098,N,NS,143,64,207,5,Spring2018
4573,S 2nd & Tumwater,7101,W,FS,8,4,12,1,Spring2018
4574,NE 21st & Argyle,7105,N,NS,0,20,20,0,Spring2018
4575,NE 21st & Clackamas,7106,S,NS,11,2,13,3,Spring2018
4576,NE 21st & Clackamas,7107,N,NS,3,8,11,2,Spring2018
4577,SE 21st & Clinton,7108,S,NS,11,6,17,0,Spring2018
4578,SE 21st & Division,7110,N,NS,8,18,26,3,Spring2018
4579,SE 21st & Division,7111,S,FS,13,19,32,3,Spring2018
4580,NW 21st & Glisan,7112,S,NS,114,13,127,22,Spring2018
4581,NW 21st & Irving,7113,N,NS,6,63,69,15,Spring2018
4582,NW 21st & Irving,7114,S,NS,84,4,88,11,Spring2018
4583,NW 21st & Lovejoy,7121,S,NS,99,5,104,40,Spring2018
4584,NW 21st & Lovejoy,7122,N,FS,5,102,107,40,Spring2018
4585,NW 21st & Northrup,7127,S,NS,76,3,79,10,Spring2018
4586,NW 21st & Northrup,7128,N,NS,3,43,46,27,Spring2018
4587,NW 21st & Pettygrove,7130,N,FS,2,49,51,1,Spring2018
4588,SE 21st & Washington,7136,S,NS,159,167,326,42,Spring2018
4589,NE 21st & Weidler,7138,N,NS,13,22,35,6,Spring2018
4590,NE 21st & Weidler,7139,S,NS,18,11,29,33,Spring2018
4591,SE 22nd & Bluebird,7141,S,NS,1,1,2,0,Spring2018
4592,SE 22nd & Wren,7144,S,FS,0,0,0,0,Spring2018
4593,SE 223rd & Ankeny,7145,N,OP,1,0,1,0,Spring2018
4594,SE 223rd & Ankeny,7146,S,FS,2,2,4,0,Spring2018
4595,SE 223rd & Oak,7149,S,NS,5,30,35,8,Spring2018
4596,SE 223rd & Salmon,7150,N,NS,3,4,7,0,Spring2018
4597,SE 223rd & Salmon,7151,S,OP,2,2,4,0,Spring2018
4598,SE 223rd & Stark,7152,N,FS,80,8,88,8,Spring2018
4599,SE 223rd & Yamhill,7153,N,OP,2,3,5,0,Spring2018
4600,SE 223rd & Yamhill,7154,S,NS,4,3,7,1,Spring2018
4601,SE 23rd & Bybee,7156,S,NS,0,1,1,0,Spring2018
4602,NW 23rd & Flanders,7157,N,NS,18,56,74,32,Spring2018
4603,NW 23rd & Irving,7161,N,NS,15,81,96,7,Spring2018
4604,NW 23rd & Irving,7162,S,NS,142,14,156,9,Spring2018
4611,NW 23rd & Lovejoy,7163,N,NS,16,173,189,85,Spring2018
4612,NW Thurman & 22nd,7168,E,NS,35,1,36,3,Spring2018
4613,NW 23rd & Thurman,7169,N,FS,5,69,74,8,Spring2018
4614,SE 23rd & Tolman (Union Manor),7172,N,NS,29,18,47,119,Spring2018
4615,NW 23rd & Westover,7174,S,NS,38,23,61,5,Spring2018
4616,NE 24th & Broadway,7188,N,FS,15,50,65,42,Spring2018
4617,NE 24th & Fremont,7190,N,FS,5,26,31,1,Spring2018
4618,NE 24th & Fremont,7191,S,NS,25,5,30,1,Spring2018
4619,NE 24th & Hancock,7193,S,NS,12,2,14,0,Spring2018
4620,NE 24th & Klickitat,7194,N,NS,1,14,15,0,Spring2018
4621,NE 24th & Klickitat,7196,S,NS,15,2,17,0,Spring2018
4622,NE 24th & Knott,7197,N,NS,2,30,32,1,Spring2018
4623,NE 24th & Knott,7198,S,NS,25,2,27,0,Spring2018
4624,NE 24th & Siskiyou,7201,N,NS,2,28,30,1,Spring2018
4625,NE 24th & Siskiyou,7202,S,NS,26,2,28,1,Spring2018
4626,NE 24th & Thompson,7205,S,NS,15,2,17,1,Spring2018
4627,NE 24th & Thompson,7206,N,NS,2,13,15,1,Spring2018
4628,NE 24th & Tillamook,7208,N,NS,2,7,9,1,Spring2018
4629,SE 25th & Morrison,7216,N,NS,37,5,42,1,Spring2018
4630,SE Clinton & 26th,7223,W,FS,18,26,44,2,Spring2018
4631,SE 26th & Gladstone,7224,S,NS,3,12,15,0,Spring2018
4632,SE 26th & Kelly,7226,S,OP,21,10,31,0,Spring2018
4633,SE 26th & Powell,7227,N,FS,66,149,215,1,Spring2018
4634,SE 26th & Powell,7228,S,NS,99,54,153,5,Spring2018
4635,SE 26th & Rhone,7230,S,OP,10,10,20,0,Spring2018
4636,SE 26th & Rhone,7231,N,NS,19,9,28,1,Spring2018
4637,SE 26th & Tibbetts,7232,N,NS,9,3,12,0,Spring2018
4638,SE 26th & Woodward,7233,S,NS,22,5,27,0,Spring2018
4639,SE 26th & Woodward,7234,N,NS,8,1,9,0,Spring2018
4640,NE 27th & Ainsworth,7235,N,NS,0,36,36,18,Spring2018
4641,NE 27th & Ainsworth,7236,S,NS,45,1,46,18,Spring2018
4642,NE 27th & Alberta,7237,S,FS,81,20,101,34,Spring2018
4643,NE 27th & Alberta,7238,N,NS,9,94,103,13,Spring2018
4644,NE 27th & Dekum,7240,N,NS,0,23,23,7,Spring2018
4645,NE 27th & Highland,7245,S,NS,15,1,16,2,Spring2018
4646,NE 27th & Holman,7246,N,NS,0,27,27,1,Spring2018
4647,NE 27th & Holman,7247,S,NS,31,1,32,1,Spring2018
4648,NE 27th & Jarrett,7248,N,NS,1,20,21,14,Spring2018
4649,NE 27th & Jarrett,7249,S,NS,19,0,19,0,Spring2018
4650,NE 27th & Killingsworth,7250,N,NS,1,30,31,2,Spring2018
4651,NE 27th & Killingsworth,7251,S,NS,40,2,42,1,Spring2018
4652,NE 27th & Prescott,7256,N,NS,1,21,22,0,Spring2018
4653,NE 27th & Prescott,7257,S,NS,26,3,29,1,Spring2018
4654,NE 27th & Sumner,7260,N,NS,1,24,25,0,Spring2018
4655,NE 27th & Sumner,7261,S,NS,35,1,36,0,Spring2018
4656,NE 27th & Wygant,7266,S,FS,11,0,11,0,Spring2018
4657,NE 27th & Wygant,7267,N,NS,0,12,12,0,Spring2018
4664,SE 28th & Bybee,7270,N,NS,1,0,1,0,Spring2018
4665,SE 28th & Gladstone,7277,N,NS,25,5,30,0,Spring2018
4666,SE 28th & Holgate,7281,S,FS,10,23,33,4,Spring2018
4667,SE 28th & Holgate,7282,N,NS,28,14,42,2,Spring2018
4668,SE 28th & Martins,7286,N,NS,1,3,4,0,Spring2018
4669,SE 28th & Raymond,7288,S,NS,10,24,34,0,Spring2018
4670,SE 28th & Raymond,7289,N,OP,41,10,51,1,Spring2018
4671,28th & Rex,7290,S,NS,0,5,5,0,Spring2018
4672,SE 28th & Steele,7293,S,NS,9,16,25,0,Spring2018
4673,SE 28th & Tolman,7294,N,NS,0,1,1,0,Spring2018
4674,SE 28th & Tolman,7295,S,NS,1,1,2,0,Spring2018
4675,SE 282nd & Chase,7297,N,NS,0,1,1,0,Spring2018
4676,SE 282nd & Chase,7298,S,NS,3,0,3,0,Spring2018
4677,SE 282nd & Orient,7303,S,NS,1,1,2,0,Spring2018
4678,NE 29th & Alameda,7306,N,NS,1,18,19,0,Spring2018
4679,NE 29th & Alameda,7307,S,NS,14,1,15,0,Spring2018
4680,NE 29th & Bryce,7309,N,NS,1,19,20,0,Spring2018
4681,NE 29th & Bryce,7310,S,NS,18,1,19,0,Spring2018
4682,NW 29th & Industrial,7311,N,NS,1,23,24,1,Spring2018
4683,NW 29th & Industrial,7313,S,NS,37,2,39,2,Spring2018
4684,NW 29th & Nela,7314,N,NS,1,15,16,5,Spring2018
4685,NW 29th & Nela,7315,S,OP,19,1,20,2,Spring2018
4686,NW 29th & Nicolai,7316,S,NS,13,1,14,0,Spring2018
4687,NE 29th & Skidmore,7317,N,NS,1,29,30,10,Spring2018
4688,NW 29th & 31st,7320,N,OP,1,16,17,0,Spring2018
4689,NE 30th & Alberta,7326,S,NS,18,18,36,1,Spring2018
4690,NE 30th & Emerson,7327,N,NS,2,5,7,0,Spring2018
4691,NE 30th & Emerson,7328,S,NS,9,9,18,1,Spring2018
4692,NE 30th & Killingsworth,7329,N,NS,21,14,35,1,Spring2018
4693,NE 30th & Sumner,7330,N,NS,5,8,13,2,Spring2018
4694,NE 30th & Sumner,7331,S,NS,2,5,7,2,Spring2018
4695,SE 32nd & Floss,7334,S,OP,7,6,13,0,Spring2018
4696,SE 32nd & Bybee,7335,N,NS,2,5,7,0,Spring2018
4697,SE 32nd & Bybee,7336,S,NS,5,1,6,0,Spring2018
4698,SE 32nd & Hillside,7339,N,OP,22,9,31,24,Spring2018
4699,SE 32nd & Harvey,7340,S,OP,3,5,8,1,Spring2018
4700,SE 32nd & Harvey,7341,N,NS,6,4,10,1,Spring2018
4701,SE 32nd & Hillside,7342,S,NS,11,21,32,29,Spring2018
4702,SE 32nd & Knapp,7344,N,NS,0,3,3,0,Spring2018
4703,SE 32nd & Knapp,7345,S,NS,5,1,6,0,Spring2018
4704,SE 32nd & Malcolm,7346,N,OP,4,3,7,0,Spring2018
4705,SE 32nd & Malcolm,7347,S,FS,4,3,7,0,Spring2018
4706,SE 32nd & Meek,7349,S,NS,4,9,13,7,Spring2018
4707,SE 32nd & Olsen,7350,N,NS,10,6,16,0,Spring2018
4708,SE 32nd & Olsen,7351,S,FS,5,8,13,0,Spring2018
4709,SE 32nd & Rex,7352,S,NS,18,4,22,1,Spring2018
4710,SE 32nd & Tolman,7357,N,NS,1,3,4,0,Spring2018
4717,SE 32nd & Tolman,7358,S,NS,4,1,5,0,Spring2018
4718,SE 32nd & Van Water,7359,N,OP,4,1,5,0,Spring2018
4719,SE 32nd & Woodstock,7360,N,NS,5,10,15,0,Spring2018
4720,NE 33rd & Ainsworth,7361,S,FS,8,0,8,0,Spring2018
4721,NE 33rd & Ainsworth,7362,N,NS,1,9,10,0,Spring2018
4722,NE 33rd & Alberta,7363,S,NS,34,1,35,2,Spring2018
4723,NE 33rd & Alberta Ct,7364,N,NS,0,14,14,0,Spring2018
4724,NE 33rd & Brazee,7365,N,OP,3,6,9,0,Spring2018
4725,NE 33rd & Brazee,7366,S,NS,11,3,14,0,Spring2018
4726,NE 33rd & Bryce,7368,S,NS,4,1,5,0,Spring2018
4727,NE 33rd & Dekum,7369,N,NS,16,14,30,1,Spring2018
4728,NE 33rd & Dekum,7370,S,NS,19,20,39,2,Spring2018
4729,NE 33rd & Emerson,7371,N,NS,4,34,38,4,Spring2018
4730,NE 33rd & Emerson,7372,S,NS,32,5,37,5,Spring2018
4731,NE 33rd & Alameda,7373,N,NS,3,17,20,0,Spring2018
4732,NE 33rd & Fremont,7374,S,NS,11,3,14,0,Spring2018
4733,NE 33rd & Going,7375,N,NS,0,7,7,2,Spring2018
4734,NE 33rd & Hancock,7377,S,NS,4,7,11,1,Spring2018
4735,NE 33rd & Holman,7378,N,NS,1,12,13,1,Spring2018
4736,NE 33rd & Holman,7379,S,FS,13,2,15,1,Spring2018
4737,NE 33rd & Jarrett,7380,N,OP,2,10,12,4,Spring2018
4738,NE 33rd & Jarrett,7381,S,NS,11,1,12,1,Spring2018
4739,NE 33rd & Killingsworth,7382,S,NS,35,33,68,6,Spring2018
4740,NE 33rd & Killingsworth,7383,N,NS,32,40,72,7,Spring2018
4741,NE 33rd & Knott,7385,N,FS,2,10,12,0,Spring2018
4742,NE 33rd & Knott,7386,S,FS,11,2,13,0,Spring2018
4743,NE 33rd & Rosa Parks Way,7388,S,NS,9,0,9,0,Spring2018
4744,NE 33rd & Rosa Parks Way,7389,N,NS,0,8,8,0,Spring2018
4745,NE 33rd & Prescott,7390,N,NS,0,9,9,0,Spring2018
4746,NE 33rd & Prescott,7391,S,NS,17,1,18,0,Spring2018
4747,NE 33rd & Schuyler,7392,N,NS,20,16,36,7,Spring2018
4748,NE 33rd & Shaver,7393,N,NS,1,9,10,0,Spring2018
4749,NE 33rd & Shaver,7394,S,NS,7,1,8,0,Spring2018
4750,NE 33rd & Siskiyou,7395,N,NS,1,6,7,0,Spring2018
4751,NE 33rd & Siskiyou,7396,S,NS,9,1,10,0,Spring2018
4752,NE 33rd & Skidmore,7397,S,NS,5,0,5,0,Spring2018
4753,NE 33rd & Skidmore,7398,N,NS,0,10,10,1,Spring2018
4754,NE 33rd & Stanton,7399,N,FS,1,8,9,0,Spring2018
4755,NE 33rd & Stanton,7400,S,NS,7,1,8,0,Spring2018
4756,NE 33rd & US Grant Pl,7402,N,FS,6,6,12,0,Spring2018
4757,NE 33rd & US Grant Pl,7403,S,NS,4,2,6,0,Spring2018
4758,NE 33rd & Webster,7404,N,NS,1,12,13,0,Spring2018
4759,SE 34th & Sellwood,7407,N,NS,2,0,2,0,Spring2018
4760,SE 34th & Sellwood,7408,S,NS,1,1,2,0,Spring2018
4761,SE 34th & Washington,7409,N,NS,0,0,0,0,Spring2018
4762,SE 34th & Wister,7410,N,NS,2,0,2,0,Spring2018
4763,SE 34th & Wister,7411,S,NS,0,1,1,0,Spring2018
4770,SW 35th & Caldew,7412,S,NS,0,2,2,0,Spring2018
4771,SW 35th & Caldew,7413,N,OP,2,0,2,0,Spring2018
4772,SW 35th & California,7414,S,NS,0,2,2,0,Spring2018
4773,SW 35th & California,7415,N,OP,1,0,1,0,Spring2018
4774,SW 35th & Canby,7417,N,NS,0,1,1,0,Spring2018
4775,SW 35th & Huber,7419,S,NS,0,3,3,0,Spring2018
4776,SW 35th & Indian Hills Apts,7420,N,AT,7,1,8,0,Spring2018
4777,SW 35th & Indian Hills Apts,7421,S,OP,1,4,5,0,Spring2018
4778,SW 35th & Logan,7422,S,NS,0,2,2,0,Spring2018
4779,SW 35th & Logan,7423,N,OP,3,0,3,0,Spring2018
4780,SW 35th & Nevada,7425,S,NS,0,4,4,0,Spring2018
4781,SW 35th & Nevada,7426,N,NS,4,0,4,0,Spring2018
4782,SW 35th & Ridge Dr,7427,N,NS,5,2,7,0,Spring2018
4783,SW 35th & Ridge Dr,7428,S,OP,3,3,6,0,Spring2018
4784,SW 35th & Texas,7429,S,FS,0,1,1,0,Spring2018
4785,SW 35th & Texas,7430,N,OP,1,0,1,0,Spring2018
4786,SE Cesar Chavez Blvd & Alder,7434,S,NS,6,11,17,4,Spring2018
4787,SE Cesar Chavez Blvd & Ash,7435,N,NS,3,5,8,1,Spring2018
4788,SE Cesar Chavez Blvd & Ash,7436,S,OP,9,8,17,9,Spring2018
4789,SE Cesar Chavez Blvd & Belmont,7437,N,NS,116,148,264,55,Spring2018
4790,SE Cesar Chavez Blvd & Belmont,7438,S,NS,121,106,227,25,Spring2018
4791,SE Cesar Chavez Blvd & Brooklyn,7439,N,NS,11,3,14,1,Spring2018
4792,SE Cesar Chavez Blvd & E Burnside,7440,N,NS,61,126,187,33,Spring2018
4793,NE Cesar Chavez Blvd & E Burnside,7441,S,NS,137,49,186,29,Spring2018
4794,SE Cesar Chavez Blvd & Clinton,7442,N,NS,10,8,18,4,Spring2018
4795,SE Cesar Chavez Blvd & Clinton,7443,S,NS,8,11,19,1,Spring2018
4796,SE Cesar Chavez Blvd & Cora,7444,S,NS,3,10,13,0,Spring2018
4797,SE Cesar Chavez Blvd & Division,7445,N,FS,220,160,380,81,Spring2018
4798,SE Cesar Chavez Blvd & Division,7446,S,NS,176,214,390,98,Spring2018
4799,SE Cesar Chavez Blvd & Francis,7447,S,NS,12,32,44,2,Spring2018
4800,SE Cesar Chavez Blvd & Franklin,7448,S,NS,4,14,18,0,Spring2018
4801,SE Cesar Chavez Blvd & Gladstone,7449,N,FS,102,24,126,4,Spring2018
4802,SE Cesar Chavez Blvd & Gladstone,7450,S,NS,21,73,94,11,Spring2018
4803,NE Cesar Chavez Blvd & Glisan,7451,N,NS,32,71,103,34,Spring2018
4804,NE Cesar Chavez Blvd & Glisan,7452,S,AT,69,25,94,29,Spring2018
4805,SE Cesar Chavez Blvd & Harold,7456,N,NS,6,1,7,0,Spring2018
4806,SE Cesar Chavez Blvd & Harold,7457,S,NS,1,6,7,0,Spring2018
4807,SE Cesar Chavez Blvd & Hawthorne,7459,N,NS,192,222,414,102,Spring2018
4808,SE Cesar Chavez Blvd & Hawthorne,7460,S,NS,241,217,458,138,Spring2018
4809,NE Cesar Chavez Blvd & Hazelfern,7461,N,NS,1,6,7,1,Spring2018
4810,SE Cesar Chavez Blvd & Holgate,7463,S,NS,39,99,138,90,Spring2018
4811,SE Cesar Chavez Blvd & Kelly,7464,N,NS,10,3,13,0,Spring2018
4812,SE Cesar Chavez Blvd & Knight,7465,N,NS,35,5,40,4,Spring2018
4813,SE Cesar Chavez Blvd & Knight,7466,S,NS,4,40,44,2,Spring2018
4814,SE Cesar Chavez Blvd & Lafayette,7467,N,OP,26,38,64,11,Spring2018
4815,SE Cesar Chavez Blvd & Lincoln,7468,N,NS,21,9,30,1,Spring2018
4816,SE Cesar Chavez Blvd  & Lincoln,7469,S,NS,10,15,25,2,Spring2018
4823,SE Cesar Chavez Blvd & Long,7470,S,OP,31,50,81,69,Spring2018
4824,SE Cesar Chavez Blvd & Long,7471,N,OP,20,10,30,11,Spring2018
4825,SE Cesar Chavez Blvd & Main,7472,N,NS,44,19,63,16,Spring2018
4826,SE Cesar Chavez Blvd & Main,7473,S,NS,16,59,75,12,Spring2018
4827,SE Cesar Chavez Blvd & Mall,7474,N,NS,145,45,190,94,Spring2018
4828,NE Cesar Chavez Blvd & Multnomah,7475,N,NS,2,8,10,2,Spring2018
4829,SE Cesar Chavez Blvd & Powell,7476,S,NS,151,214,365,68,Spring2018
4830,SE Cesar Chavez Blvd & Powell,7477,N,FS,194,99,293,47,Spring2018
4831,SE Cesar Chavez Blvd & Raymond,7478,N,FS,10,4,14,1,Spring2018
4832,SE Cesar Chavez Blvd & Raymond,7479,S,FS,4,10,14,1,Spring2018
4833,NE Cesar Chavez Blvd & Royal,7482,N,NS,4,4,8,0,Spring2018
4834,NE Cesar Chavez Blvd & Royal Ct,7483,S,NS,6,6,12,1,Spring2018
4835,NE Cesar Chavez Blvd & Sandy,7484,N,NS,37,13,50,15,Spring2018
4836,SE Cesar Chavez Blvd & Stark,7485,N,NS,34,30,64,13,Spring2018
4837,SE Cesar Chavez Blvd & Stark,7486,S,NS,26,27,53,14,Spring2018
4838,SE Cesar Chavez Blvd & Steele,7487,N,NS,30,23,53,2,Spring2018
4839,SE Cesar Chavez Blvd & Steele,7488,S,NS,29,32,61,3,Spring2018
4840,SE Cesar Chavez Blvd & Stephens,7489,N,OP,7,3,10,2,Spring2018
4841,SE Cesar Chavez Blvd & Stephens,7490,S,NS,8,7,15,2,Spring2018
4842,SE Cesar Chavez Blvd & Taylor,7491,N,FS,19,28,47,4,Spring2018
4843,SE Cesar Chavez Blvd & Taylor,7492,S,NS,26,23,49,4,Spring2018
4844,SE Cesar Chavez Blvd & Tibbetts,7493,S,NS,5,13,18,1,Spring2018
4845,NE Cesar Chavez Blvd & Wasco,7494,S,NS,20,4,24,5,Spring2018
4846,NE 41st & Alameda,7497,N,OP,2,20,22,0,Spring2018
4847,NE 41st & Wistaria,7498,S,NS,11,2,13,0,Spring2018
4848,NE 41st & Klickitat,7499,N,FS,1,31,32,1,Spring2018
4849,NE 41st & Klickitat,7500,S,NS,14,2,16,1,Spring2018
4850,NE 42nd & Fremont,7501,N,FS,32,63,95,3,Spring2018
4851,NE 42nd & Alberta Ct,7504,S,NS,72,30,102,20,Spring2018
4852,NE 42nd & Alberta St,7505,N,NS,26,77,103,10,Spring2018
4853,NE 42nd & Beech,7506,N,NS,10,19,29,0,Spring2018
4854,NE 42nd & Brazee,7507,N,NS,6,8,14,0,Spring2018
4855,NE 42nd & Brazee,7508,S,NS,6,3,9,1,Spring2018
4856,NE 42nd & Broadway,7509,N,NS,111,71,182,73,Spring2018
4857,NE 42nd & Broadway,7510,S,FS,77,83,160,50,Spring2018
4858,NE 42nd & Failing,7511,S,NS,15,5,20,0,Spring2018
4859,NE 42nd & Fremont,7512,S,NS,63,39,102,4,Spring2018
4860,NE 42nd & Holman,7516,N,NS,12,40,52,1,Spring2018
4861,NE 42nd & Holman,7517,S,FS,48,15,63,1,Spring2018
4862,NE 42nd & Killingsworth,7519,S,NS,147,100,247,37,Spring2018
4863,NE 42nd & Killingsworth,7520,N,FS,95,161,256,22,Spring2018
4864,NE 42nd & Knott,7521,N,NS,4,12,16,1,Spring2018
4865,NE 42nd & Knott,7522,S,NS,9,2,11,0,Spring2018
4866,SE 42nd & Llewellyn,7523,N,OP,55,68,123,31,Spring2018
4867,SE 42nd & Llewellyn,7524,S,NS,57,59,116,33,Spring2018
4868,NE 42nd & Prescott,7525,S,FS,61,14,75,1,Spring2018
4869,NE 42nd & Prescott,7526,N,NS,14,61,75,1,Spring2018
4876,NE 42nd & Sandy,7527,S,NS,80,135,215,36,Spring2018
4877,NE 42nd & Sandy,7528,N,FS,135,91,226,34,Spring2018
4878,NE 42nd & Shaver,7529,N,NS,3,19,22,0,Spring2018
4879,NE 42nd & Shaver,7530,S,NS,15,5,20,0,Spring2018
4880,NE 42nd & Simpson St,7531,N,NS,5,10,15,0,Spring2018
4881,NE 42nd & Simpson St,7532,S,OP,15,6,21,0,Spring2018
4882,NE 42nd & Skidmore,7533,N,NS,3,22,25,0,Spring2018
4883,NE 42nd & Skidmore,7534,S,NS,16,3,19,0,Spring2018
4884,NE 42nd & Sumner,7535,N,NS,6,33,39,1,Spring2018
4885,NE 42nd & Sumner,7536,S,NS,39,6,45,0,Spring2018
4886,NE 42nd & Tillamook,7537,N,FS,39,19,58,3,Spring2018
4887,NE 42nd & Tillamook,7538,S,NS,20,36,56,5,Spring2018
4888,SW 45th & Caldew,7540,S,FS,0,0,0,0,Spring2018
4889,SE 45th & Evergreen,7542,N,OP,10,3,13,2,Spring2018
4890,SE 45th & Evergreen,7543,S,NS,5,16,21,8,Spring2018
4891,SW 45th & Flower Pl,7544,S,FS,0,1,1,0,Spring2018
4892,SE 45th & Harney,7546,N,OP,38,7,45,16,Spring2018
4893,SE 45th & Harney St,7548,S,NS,7,30,37,13,Spring2018
4894,SW 45th & Illinois,7549,S,NS,8,1,9,0,Spring2018
4895,SE 45th & Knapp,7551,S,NS,4,29,33,0,Spring2018
4896,SE 45th & Knapp,7552,N,FS,31,7,38,0,Spring2018
4897,SE 45th & Malden Dr,7554,N,NS,33,3,36,5,Spring2018
4898,SW 45th & Pendleton,7555,S,NS,5,2,7,0,Spring2018
4899,SE 45th & Rex,7556,S,NS,1,29,30,8,Spring2018
4900,SE 45th & Rural,7557,N,FS,17,3,20,3,Spring2018
4901,SE 45th & Rural,7558,S,NS,3,25,28,2,Spring2018
4902,SW 45th & Vermont,7559,S,NS,0,0,0,0,Spring2018
4903,SE 45th & 46th/Nehalem,7560,N,FS,14,2,16,3,Spring2018
4904,SE 45th & 46th/Nehalem,7561,S,OP,1,8,9,5,Spring2018
4905,SE 46th & Henry,7563,N,FS,13,2,15,0,Spring2018
4906,SE 46th & Henry,7564,S,NS,4,13,17,0,Spring2018
4907,SE 46th & Woodstock,7565,N,NS,66,63,129,52,Spring2018
4908,NE 47th & Halsey,7571,N,FS,6,13,19,1,Spring2018
4909,SW 49th & Coronado,7577,S,NS,0,16,16,0,Spring2018
4910,SW 49th & Coronado,7578,N,NS,22,0,22,1,Spring2018
4911,SW 49th & Hidalgo,7579,N,FS,25,1,26,0,Spring2018
4912,SW 5th & Alder,7586,S,NS,646,281,927,80,Spring2018
4913,SW 5th & Broadway,7588,S,NS,149,55,204,13,Spring2018
4914,SW 5th & Caruthers,7591,S,FS,39,31,70,6,Spring2018
4915,SW 5th & Columbia,7594,S,NS,402,218,620,92,Spring2018
4916,Union Station/NW 5th & Glisan MAX Stn,7601,S,NS,779,1093,1872,1,Spring2018
4917,SW 5th & Harrison,7602,S,NS,766,394,1160,79,Spring2018
4918,5th & High,7604,W,NS,8,5,13,12,Spring2018
4919,NE 5th & Hood,7605,W,NS,5,1,6,1,Spring2018
4920,PSU South/SW 5th & Jackson MAX Stn,7606,S,NS,432,1413,1845,0,Spring2018
4921,City Hall/SW 5th & Jefferson MAX Station,7608,S,NS,826,1380,2206,1,Spring2018
4922,5th & Jefferson,7609,E,NS,8,10,18,3,Spring2018
4929,5th & Jefferson,7610,W,NS,5,8,13,17,Spring2018
4930,SW 5th & Madison,7612,S,NS,656,339,995,95,Spring2018
4931,SW 5th & Main,7614,S,NS,601,196,797,52,Spring2018
4932,SW 5th & Market,7616,S,NS,358,296,654,40,Spring2018
4933,PSU Urban Center/SW 5th & Mill MAX Station,7618,S,FS,677,2411,3088,0,Spring2018
4934,5th & Monroe,7620,E,NS,12,15,27,1,Spring2018
4935,5th & Monroe,7621,W,NS,11,9,20,15,Spring2018
4936,SW 5th & Morrison,7625,S,NS,1074,473,1547,166,Spring2018
4937,SW 5th & Oak MAX Station,7627,S,NS,1099,1490,2589,1,Spring2018
4938,SW 5th & Pine,7631,S,OP,1287,1225,2512,368,Spring2018
4939,SW 5th & Salmon,7634,S,NS,474,207,681,77,Spring2018
4940,SW 5th & Stark,7636,S,NS,545,188,733,126,Spring2018
4941,SW 5th & Taylor,7640,S,NS,914,341,1255,172,Spring2018
4942,SW 5th & Washington,7642,S,NS,311,176,487,61,Spring2018
4943,5th & Washington (Oregon City),7643,E,NS,9,17,26,23,Spring2018
4944,Washington & 16th,7644,S,NS,0,0,0,0,Spring2018
4945,Pioneer Place/SW 5th Ave MAX Station,7646,S,NS,2792,2360,5152,1,Spring2018
4946,SE 50th & Clay,7651,S,NS,11,29,40,6,Spring2018
4947,SE 50th & Clinton,7653,S,FS,34,34,68,5,Spring2018
4948,SE 50th & Division,7654,N,NS,113,49,162,35,Spring2018
4949,SE 50th & Division,7655,S,NS,69,96,165,38,Spring2018
4950,SE 50th & Haig,7656,N,NS,100,54,154,16,Spring2018
4951,SE 50th & Hawthorne,7658,N,NS,49,25,74,3,Spring2018
4952,SE 50th & Lincoln,7659,N,NS,46,7,53,3,Spring2018
4953,SE 50th & Lincoln,7660,S,NS,11,38,49,3,Spring2018
4954,SE 50th & Mill,7662,S,NS,4,12,16,2,Spring2018
4955,SE 50th & Tibbetts,7665,N,NS,18,8,26,3,Spring2018
4956,SE 50th & Kelly,7666,S,FS,2,19,21,0,Spring2018
4957,SW 51st & Custer,7667,N,NS,2,1,3,1,Spring2018
4958,SW 51st & Moss,7668,N,NS,1,1,2,1,Spring2018
4959,SE 52nd & Boise,7669,N,NS,14,6,20,0,Spring2018
4960,SE 52nd & Clinton,7672,N,FS,12,4,16,0,Spring2018
4961,SE 52nd & Clinton,7673,S,FS,34,10,44,0,Spring2018
4962,SE 52nd & Cooper,7675,N,FS,11,2,13,0,Spring2018
4963,SE 52nd & Cooper,7676,S,NS,4,11,15,0,Spring2018
4964,SE 52nd & Division,7678,N,NS,38,67,105,18,Spring2018
4965,SE 52nd & Division,7679,S,FS,55,42,97,13,Spring2018
4966,SE 52nd & Duke,7680,N,NS,17,3,20,3,Spring2018
4967,SE 52nd & Duke,7682,S,NS,4,13,17,5,Spring2018
4968,SE 52nd & Foster,7683,N,NS,22,51,73,15,Spring2018
4969,SE 52nd & Bush,7684,S,FS,52,34,86,11,Spring2018
4970,SE 52nd & Franklin,7685,N,FS,13,3,16,1,Spring2018
4971,SE 52nd & Franklin,7687,S,FS,10,18,28,4,Spring2018
4972,SE 52nd & Gladstone,7688,S,NS,7,15,22,1,Spring2018
4973,SE 52nd & Harold,7690,N,NS,10,31,41,0,Spring2018
4974,SE 52nd & Harold,7691,S,NS,6,7,13,0,Spring2018
4975,SE 52nd & Holgate,7692,N,NS,38,43,81,6,Spring2018
4982,SE 52nd & Holgate,7693,S,NS,42,48,90,6,Spring2018
4983,SE 52nd & Lincoln,7695,N,NS,18,8,26,1,Spring2018
4984,SE 52nd & Lincoln,7696,S,FS,9,16,25,1,Spring2018
4985,SW 52nd & Maplewood School,7698,N,AT,3,2,5,1,Spring2018
4986,SW 52nd & Nevada Ct,7700,N,NS,4,1,5,1,Spring2018
4987,SE 52nd & Ogden,7702,N,NS,23,8,31,1,Spring2018
4988,SE 52nd & Ogden,7703,S,FS,7,27,34,1,Spring2018
4989,SE 52nd & Powell,7704,N,NS,87,95,182,15,Spring2018
4990,SE 52nd & Powell,7706,S,FS,106,78,184,16,Spring2018
4991,SE 52nd & Reedway,7708,N,NS,7,2,9,0,Spring2018
4992,SE 52nd & Reedway,7709,S,NS,2,6,8,0,Spring2018
4993,SE 52nd & Schiller,7711,S,OP,6,8,14,0,Spring2018
4994,SE 52nd & Schiller,7713,N,NS,10,4,14,0,Spring2018
4995,SE 52nd & Steele,7714,N,NS,23,11,34,1,Spring2018
4996,SE 52nd & Steele,7716,S,FS,28,30,58,2,Spring2018
4997,SE 52nd & Carlton,7718,S,NS,88,96,184,34,Spring2018
4998,SE 52nd & Tolman,7719,N,NS,75,48,123,26,Spring2018
4999,SE 52nd & Woodstock,7721,N,FS,46,35,81,12,Spring2018
5000,SE 52nd & Taggart Ct,7722,N,NS,88,87,175,1,Spring2018
5001,SE 52nd & Woodward,7723,S,FS,90,77,167,1,Spring2018
5002,SW 55th & Texas,7728,N,NS,3,1,4,1,Spring2018
5003,SW 55th & Vermont,7729,N,NS,2,0,2,0,Spring2018
5004,NE 57th & Fremont,7732,N,NS,7,33,40,15,Spring2018
5005,NE 57th & Fremont,7733,S,FS,29,12,41,9,Spring2018
5006,NE 57th & Hancock,7734,N,NS,6,11,17,0,Spring2018
5007,NE 57th & Hancock,7735,S,NS,13,3,16,0,Spring2018
5008,NE 57th & Sandy,7737,N,FS,42,52,94,19,Spring2018
5009,NE 57th & Sandy,7738,S,NS,43,42,85,10,Spring2018
5010,NE 57th & Siskiyou,7740,N,NS,2,7,9,0,Spring2018
5011,NE 57th & Siskiyou,7741,S,NS,7,2,9,0,Spring2018
5012,NE 57th & Thompson,7743,N,FS,3,19,22,1,Spring2018
5013,NE 57th & Thompson,7744,S,NS,23,4,27,1,Spring2018
5014,29900 Block SE Eagle Creek Rd,7745,N,AT,1,0,1,0,Spring2018
5015,SW 6th & Alder,7747,N,NS,501,1041,1542,250,Spring2018
5016,SW 6th & Broadway,7749,N,NS,13,60,73,7,Spring2018
5017,NE 6th & N Broadway,7750,W,NS,19,0,19,0,Spring2018
5018,SW 6th & W Burnside,7751,N,NS,645,765,1410,224,Spring2018
5019,SW 6th & Clay,7756,N,NS,154,287,441,60,Spring2018
5020,NW Broadway & Davis,7759,N,NS,106,98,204,60,Spring2018
5021,Union Station/NW 6th & Hoyt MAX Stn,7763,N,AT,976,898,1874,0,Spring2018
5022,SW 6th & Jefferson,7765,N,NS,255,511,766,63,Spring2018
5023,SW 6th & Main,7767,N,NS,286,507,793,139,Spring2018
5024,NE 6th & Main,7770,E,NS,0,19,19,0,Spring2018
5025,SW 6th & Market,7772,N,NS,371,615,986,47,Spring2018
5026,SW 6th & Mill,7773,N,NS,323,590,913,146,Spring2018
5027,PSU Urban Center/SW 6th & Montgomery MAX Stn,7774,N,OP,2105,586,2691,0,Spring2018
5028,Pioneer Courthouse/SW 6th Ave MAX Stn,7777,N,NS,2269,2492,4761,0,Spring2018
5035,SW 6th & Oak,7782,N,NS,281,424,705,94,Spring2018
5036,SW 6th & Pine MAX Station,7787,N,OP,1444,1047,2491,0,Spring2018
5037,SW 6th & Salmon,7789,N,NS,199,597,796,64,Spring2018
5038,SW 6th & Sheridan,7793,N,FS,43,45,88,12,Spring2018
5039,SW 6th & Sheridan,7794,S,OP,31,56,87,27,Spring2018
5040,SW 6th & Stark,7797,N,NS,183,300,483,57,Spring2018
5041,SW 6th & Taylor,7800,N,NS,254,601,855,87,Spring2018
5042,SW 6th & Washington,7803,N,NS,273,453,726,41,Spring2018
5043,SW 6th & Yamhill,7807,N,NS,487,904,1391,159,Spring2018
5044,SE 60th & Belmont,7812,N,FS,42,76,118,11,Spring2018
5045,SE 60th & Belmont,7813,S,NS,59,48,107,6,Spring2018
5046,SE 60th & E Burnside,7814,S,FS,108,52,160,14,Spring2018
5047,SE 60th & E Burnside,7815,N,NS,43,101,144,15,Spring2018
5048,NE 60th & Everett,7816,N,OP,3,7,10,1,Spring2018
5049,NE 60th & Everett,7817,S,NS,12,2,14,2,Spring2018
5050,NE 60th & Glisan,7818,N,NS,21,53,74,30,Spring2018
5051,NE 60th & Glisan,7819,S,NS,56,23,79,22,Spring2018
5052,NE 60th & Halsey,7820,N,NS,11,35,46,3,Spring2018
5053,NE 60th & Hassalo,7821,N,FS,3,6,9,0,Spring2018
5054,SE 60th & Hawthorne,7823,N,OP,6,9,15,0,Spring2018
5055,SE 60th & Hawthorne,7824,S,NS,6,9,15,0,Spring2018
5056,NE 60th & 60th Ave MAX Stn/I-84,7827,N,AT,145,224,369,27,Spring2018
5057,NE 60th & 60th Ave MAX Stn/I-84,7828,S,AT,218,170,388,30,Spring2018
5058,SE 60th & Salmon,7830,N,NS,3,7,10,0,Spring2018
5059,SE 60th & Salmon,7831,S,OP,4,8,12,0,Spring2018
5060,SE 60th & Stark,7832,N,NS,9,15,24,0,Spring2018
5061,SE 60th & Stark,7833,S,NS,11,10,21,0,Spring2018
5062,SE 60th & Stephens,7835,S,OP,3,17,20,1,Spring2018
5063,NE 60th & Wasco,7837,S,NS,25,3,28,1,Spring2018
5064,SW 65th & Borland,7839,N,NS,1,27,28,3,Spring2018
5065,SW 68th & Baylor,7844,N,NS,0,4,4,0,Spring2018
5066,SW 68th & Clinton,7846,S,FS,3,2,5,0,Spring2018
5067,SW 68th & Franklin,7847,N,NS,4,22,26,0,Spring2018
5068,SW 68th & Franklin,7848,S,NS,6,4,10,0,Spring2018
5069,SW 68th & Freeway Entrance/Dartmouth,7849,N,FS,3,5,8,0,Spring2018
5070,SE 69th & Yamhill,7853,S,NS,5,35,40,1,Spring2018
5071,SE 7th & Clay,7855,S,NS,32,32,64,5,Spring2018
5072,SE 7th & Clay,7856,N,FS,22,43,65,2,Spring2018
5073,SE 7th & Grant,7857,S,NS,4,5,9,0,Spring2018
5074,SE 7th & Grant,7858,N,FS,8,11,19,0,Spring2018
5075,SE 7th & Harrison,7859,S,FS,42,64,106,13,Spring2018
5076,SE 7th & Harrison,7860,N,FS,44,29,73,10,Spring2018
5077,16500 Block SW 72nd,7865,N,OP,1,0,1,0,Spring2018
5078,16500 Block SW 72nd,7866,S,AT,0,3,3,0,Spring2018
5079,SW 72nd & Bonita,7867,N,NS,3,1,4,0,Spring2018
5080,SW 72nd & Bonita,7868,S,NS,2,3,5,0,Spring2018
5081,SE 72nd & Luther,7874,S,OP,11,14,25,10,Spring2018
5088,SE 72nd & Flavel,7875,S,FS,19,66,85,15,Spring2018
5089,SW 72nd & Hunziker,7876,S,FS,7,10,17,10,Spring2018
5090,SW 72nd & Kable,7877,N,OP,1,2,3,0,Spring2018
5091,SW 72nd & Kable,7878,S,FS,0,2,2,0,Spring2018
5092,Tualatin Park & Ride,7879,N,AT,258,91,349,15,Spring2018
5093,Tualatin Park & Ride,7880,S,AT,46,216,262,14,Spring2018
5094,SE 72nd & Lexington,7881,N,OP,50,8,58,19,Spring2018
5095,SE 72nd & Lexington,7882,S,NS,8,37,45,19,Spring2018
5096,SW 72nd & Cardinal,7885,N,NS,5,2,7,0,Spring2018
5097,SW 72nd & Sandburg,7887,N,NS,0,0,0,0,Spring2018
5098,SE 72nd & Tenino,7891,N,NS,27,9,36,3,Spring2018
5099,SE 72nd & Tenino,7892,S,FS,8,24,32,5,Spring2018
5100,SW 72nd & Upper Boones Ferry,7893,N,NS,32,11,43,2,Spring2018
5101,SW 72nd & Varns,7894,N,FS,9,6,15,0,Spring2018
5102,14100 Block SW 72nd,7895,N,AT,1,0,1,0,Spring2018
5103,14100 Block SW 72nd,7896,S,OP,0,0,0,0,Spring2018
5104,SE 76th & Washington,7897,N,NS,6,30,36,2,Spring2018
5105,SE 76th & Washington,7898,S,NS,28,7,35,5,Spring2018
5106,SE 76th & Yamhill,7899,S,NS,51,9,60,1,Spring2018
5107,SW 78th & Beaverton-Hillsdale Hwy,7900,S,NS,0,0,0,0,Spring2018
5108,SW 78th & Westmoor,7901,S,NS,0,0,0,0,Spring2018
5109,SW 80th & Birch,7904,S,OP,0,1,1,0,Spring2018
5110,SW 80th & Birch,7905,N,FS,0,0,0,0,Spring2018
5111,SW 80th & Cedarcrest,7906,S,FS,0,1,1,0,Spring2018
5112,SW 80th & Cedarcrest,7907,N,NS,1,1,2,2,Spring2018
5113,SW 80th & Elmwood,7910,S,NS,0,1,1,0,Spring2018
5114,SW 80th & Elmwood,7911,N,NS,1,0,1,0,Spring2018
5115,SW 80th & Landau,7912,S,OP,0,0,0,2,Spring2018
5116,SW 80th & Landau,7913,N,NS,1,0,1,0,Spring2018
5117,SW 80th & Locust,7914,S,NS,1,0,1,0,Spring2018
5118,SW 80th & Taylors Ferry,7915,N,NS,1,0,1,1,Spring2018
5119,NE 81st & Clackamas,7916,N,OP,16,7,23,3,Spring2018
5120,SE 82nd & King,7918,N,FS,192,35,227,29,Spring2018
5121,SE 82nd & Boyer Drive,7920,N,NS,240,90,330,120,Spring2018
5122,SE 82nd & Boyer Drive,7921,S,OP,46,172,218,63,Spring2018
5123,2200 Block SE 82nd,7923,S,OP,28,117,145,6,Spring2018
5124,NE 82nd & Alberta,7927,N,NS,14,39,53,5,Spring2018
5125,SE 82nd & Washington,7928,N,NS,49,94,143,19,Spring2018
5126,SE 82nd & Alder,7929,S,NS,42,25,67,10,Spring2018
5127,SE 82nd & Ash,7930,N,NS,9,14,23,5,Spring2018
5128,SE 82nd & Ash,7931,S,FS,16,15,31,5,Spring2018
5129,NE 82nd & Pacific,7932,S,FS,31,21,52,1,Spring2018
5130,NE 82nd & Beech,7933,N,NS,10,57,67,29,Spring2018
5131,NE 82nd & Beech,7934,S,NS,37,15,52,16,Spring2018
5132,SE 82nd & Boise,7935,N,FS,175,53,228,56,Spring2018
5133,SE 82nd & E Burnside,7936,N,NS,142,239,381,59,Spring2018
5134,NE 82nd & E Burnside,7937,S,NS,264,146,410,64,Spring2018
5141,SE 82nd & Causey,7941,N,NS,189,42,231,35,Spring2018
5142,SE 82nd & Causey,7942,S,NS,35,161,196,34,Spring2018
5143,SE 82nd & Francis,7943,N,NS,132,41,173,23,Spring2018
5144,SE 82nd & Clatsop,7945,S,OP,9,19,28,1,Spring2018
5145,SE 82nd & Clatsop,7946,N,NS,19,16,35,4,Spring2018
5146,SE 82nd & Clinton,7947,N,NS,27,39,66,4,Spring2018
5147,SE 82nd & Clinton,7948,S,NS,22,20,42,4,Spring2018
5148,SE 82nd & Cooper,7950,S,NS,12,45,57,5,Spring2018
5149,SE 82nd & Cornwell,7951,N,NS,15,8,23,6,Spring2018
5150,SE 82nd & Cornwell,7952,S,FS,14,40,54,14,Spring2018
5151,SE 82nd & Crystal Springs,7953,N,NS,71,33,104,17,Spring2018
5152,SE 82nd & Crystal Springs,7954,S,FS,28,71,99,16,Spring2018
5153,NE 82nd & Davis,7955,N,NS,18,26,44,1,Spring2018
5154,NE 82nd & Davis,7956,S,OP,30,27,57,8,Spring2018
5155,SE 82nd & Division,7957,N,FS,387,407,794,86,Spring2018
5156,SE 82nd & Division,7958,S,NS,410,315,725,92,Spring2018
5157,SE 82nd & Duke,7960,N,NS,150,55,205,45,Spring2018
5158,SE 82nd & Duke,7961,S,FS,66,141,207,42,Spring2018
5159,SE 82nd & Flavel,7962,N,FS,118,71,189,26,Spring2018
5160,SE 82nd & Flavel,7963,S,NS,42,106,148,15,Spring2018
5161,SE 82nd & Foster,7964,N,FS,314,176,490,71,Spring2018
5162,SE 82nd & Insley,7965,S,OP,118,264,382,60,Spring2018
5163,NE 82nd & Fremont,7966,S,NS,130,35,165,56,Spring2018
5164,NE 82nd & Fremont,7967,N,NS,52,113,165,76,Spring2018
5165,SE 82nd & Glencoe,7968,N,OP,36,41,77,18,Spring2018
5166,SE 82nd & Glencoe,7969,S,FS,10,44,54,7,Spring2018
5167,SE 82nd & Glenwood,7970,N,NS,32,12,44,3,Spring2018
5168,NE 82nd & Glisan,7972,N,FS,120,135,255,35,Spring2018
5169,NE 82nd & Glisan,7973,S,NS,138,117,255,50,Spring2018
5170,SE 82nd & Harmony,7975,S,FS,15,7,22,3,Spring2018
5171,NE 82nd & Hassalo,7978,S,OP,41,23,64,3,Spring2018
5172,SE 82nd & Hawthorne,7979,N,NS,32,20,52,3,Spring2018
5173,SE 82nd & Hawthorne,7980,S,NS,19,28,47,0,Spring2018
5174,SE 82nd & Ogden,7982,N,OP,85,28,113,10,Spring2018
5175,SE 82nd & Holgate,7984,N,FS,302,243,545,130,Spring2018
5176,SE 82nd & Holgate,7986,S,NS,246,261,507,111,Spring2018
5177,NE 82nd & Holladay,7987,N,NS,14,20,34,2,Spring2018
5178,SE 82nd & Johnson Creek,7988,S,FS,32,47,79,33,Spring2018
5179,SE 82nd & King,7990,S,FS,40,341,381,75,Spring2018
5180,NE 82nd & Klickitat,7991,N,NS,8,46,54,8,Spring2018
5181,NE 82nd & Klickitat,7992,S,NS,66,15,81,11,Spring2018
5182,SE 82nd & Lambert,7993,N,FS,31,20,51,22,Spring2018
5183,SE 82nd & Lambert,7994,S,NS,35,55,90,25,Spring2018
5184,SE 82nd & Lindy,7995,N,NS,173,87,260,106,Spring2018
5185,SE 82nd & Lindy,7996,S,FS,73,140,213,74,Spring2018
5186,NE 82nd & 82nd Ave MAX Stn/I-84,7999,N,AT,953,845,1798,267,Spring2018
5187,NE 82nd & 82nd Ave MAX Stn/I-84,8000,S,AT,694,666,1360,211,Spring2018
5194,NE 82nd & Madison HS,8001,N,OP,138,236,374,7,Spring2018
5195,NE 82nd & Madison HS,8002,S,AT,229,186,415,5,Spring2018
5196,SE 82nd & Main,8004,S,NS,15,16,31,2,Spring2018
5197,SE 82nd & McBride,8005,N,OP,4,16,20,2,Spring2018
5198,SE 82nd & McBride,8006,S,NS,19,5,24,2,Spring2018
5199,SE 82nd & Mill,8007,N,NS,50,46,96,3,Spring2018
5200,SE 82nd & Mill,8008,S,FS,48,69,117,2,Spring2018
5201,SE 82nd & Mitchell,8009,S,FS,17,31,48,7,Spring2018
5202,NE 82nd & Multnomah,8010,N,NS,23,34,57,5,Spring2018
5203,SE 82nd & Ogden,8013,S,NS,24,70,94,8,Spring2018
5204,NE 82nd & Oregon,8014,N,OP,7,7,14,0,Spring2018
5205,SE 82nd & Otty,8015,N,NS,70,34,104,21,Spring2018
5206,SE 82nd & Otty,8016,S,FS,43,86,129,30,Spring2018
5207,SE 82nd & Overland,8017,N,FS,78,55,133,24,Spring2018
5208,SE 82nd & Overland,8018,S,NS,32,46,78,16,Spring2018
5209,SE 82nd & Powell,8023,N,FS,475,366,841,155,Spring2018
5210,SE 82nd & Powell,8024,S,FS,360,442,802,142,Spring2018
5211,NE 82nd & Prescott,8025,S,FS,67,50,117,14,Spring2018
5212,NE 82nd & Prescott,8026,N,NS,46,64,110,4,Spring2018
5213,SE 82nd & Ramona,8027,N,OP,34,23,57,2,Spring2018
5214,SE 82nd & Ramona,8028,S,NS,67,55,122,17,Spring2018
5215,SE 82nd & Raymond Ct,8029,N,NS,80,32,112,19,Spring2018
5216,SE 82nd & Raymond,8030,S,NS,32,69,101,30,Spring2018
5217,SE 82nd & Rhone,8031,N,NS,18,15,33,1,Spring2018
5218,NE 82nd & Russell,8033,N,NS,37,37,74,10,Spring2018
5219,NE 82nd & Russell,8034,S,OP,47,12,59,12,Spring2018
5220,NE 82nd & Thompson,8035,S,FS,34,21,55,5,Spring2018
5221,NE 82nd & Sacramento,8036,N,NS,23,30,53,3,Spring2018
5222,SE 82nd & Salmon,8037,N,OP,13,18,31,2,Spring2018
5223,NE 82nd & Sandy,8038,S,NS,193,120,313,54,Spring2018
5224,NE 82nd & Sandy,8039,N,FS,119,193,312,44,Spring2018
5225,SE 82nd & Schiller,8040,N,NS,23,10,33,7,Spring2018
5226,SE 82nd & Schiller,8041,S,OP,4,13,17,4,Spring2018
5227,NE 82nd & Schuyler,8042,N,FS,16,13,29,4,Spring2018
5228,NE 82nd & Schuyler,8043,S,NS,20,11,31,4,Spring2018
5229,NE 82nd & Siskiyou,8045,S,NS,76,16,92,6,Spring2018
5230,NE 82nd & Siskiyou,8046,N,FS,20,50,70,8,Spring2018
5231,SE 82nd & Stark,8047,N,FS,72,106,178,26,Spring2018
5232,SE 82nd & Stark,8048,S,NS,150,126,276,34,Spring2018
5233,SE 82nd & Sunnyside,8049,N,FS,9,15,24,4,Spring2018
5234,SE 82nd & Sunnyside Dr,8050,S,NS,10,8,18,1,Spring2018
5235,SE 82nd & Tibbetts,8052,N,OP,56,24,80,10,Spring2018
5236,SE 82nd & Tibbetts,8053,S,NS,18,52,70,8,Spring2018
5237,NE 82nd & Tillamook,8055,N,NS,42,33,75,4,Spring2018
5238,NE 82nd & Tillamook,8056,S,NS,30,20,50,2,Spring2018
5239,SE 82nd & Tolman,8057,N,NS,30,13,43,2,Spring2018
5240,SE 82nd & Tolman,8058,S,NS,15,33,48,5,Spring2018
5247,SE 82nd & Woodstock,8059,N,NS,42,25,67,12,Spring2018
5248,SE 82nd & Woodstock,8060,S,NS,24,57,81,12,Spring2018
5249,SE 82nd & Woodward,8061,N,NS,73,50,123,10,Spring2018
5250,SE 82nd & Woodward,8062,S,FS,50,84,134,8,Spring2018
5251,NE 82nd & Wygant,8063,N,NS,6,24,30,1,Spring2018
5252,NE 82nd & Wygant,8064,S,NS,42,9,51,2,Spring2018
5253,SE 82nd & Yamhill,8065,N,NS,23,18,41,20,Spring2018
5254,SE 82nd & Yamhill,8066,S,FS,18,23,41,24,Spring2018
5255,SE 82nd Dr & Beaverlake Dr,8067,S,FS,9,13,22,9,Spring2018
5256,SE 82nd Dr & Scotts Tree Way,8070,N,OP,15,6,21,13,Spring2018
5257,SE 82nd Dr & Clackamas,8071,N,NS,7,2,9,0,Spring2018
5258,SE 82nd Dr & Greenhouse Square,8072,S,OP,39,48,87,16,Spring2018
5259,SE 82nd Dr & Greenhouse Square,8073,N,AT,41,41,82,18,Spring2018
5260,SE 82nd Dr & Enoch Ct,8074,N,NS,4,4,8,1,Spring2018
5261,SE 82nd Dr & Herbert Ct,8075,S,NS,4,6,10,0,Spring2018
5262,SE 82nd Dr & Jannsen,8076,N,OP,18,6,24,3,Spring2018
5263,SE 82nd Dr & Jannsen,8077,S,NS,6,14,20,1,Spring2018
5264,SE 82nd Dr & Manfield Ct,8078,S,FS,3,6,9,1,Spring2018
5265,15900 Block SE 82nd Dr,8079,N,AT,52,17,69,6,Spring2018
5266,SE 82nd Dr & Scotts Tree Way,8080,S,NS,7,17,24,4,Spring2018
5267,SE 82nd Dr & Tolbert,8082,S,FS,3,12,15,1,Spring2018
5268,SE 82nd Dr & Tolbert,8083,N,FS,12,5,17,1,Spring2018
5269,16700 Block SE 82nd Dr,8084,N,AT,10,9,19,1,Spring2018
5270,16700 Block SE 82nd Dr,8085,S,OP,10,6,16,8,Spring2018
5271,15900 Block SE 82nd Dr,8086,S,OP,22,52,74,5,Spring2018
5272,9th & Jackson,8092,E,NS,1,1,2,1,Spring2018
5273,9th & Jefferson,8093,E,NS,1,1,2,0,Spring2018
5274,9th & Jefferson,8094,W,NS,1,1,2,0,Spring2018
5275,9th & Main,8096,W,NS,3,8,11,3,Spring2018
5276,9th & Monroe,8097,S,NS,2,1,3,1,Spring2018
5277,9th & Monroe,8098,W,NS,1,1,2,1,Spring2018
5278,9th & Washington,8100,W,NS,1,2,3,4,Spring2018
5279,NW 90th & W Stark,8105,N,FS,0,0,0,1,Spring2018
5280,SW 90th & Taylor,8106,S,NS,1,0,1,0,Spring2018
5281,SW 90th & Washington,8108,S,FS,1,0,1,0,Spring2018
5282,NE 92nd & Russell,8114,S,NS,4,2,6,15,Spring2018
5283,NE 92nd & Russell,8115,N,OP,2,3,5,14,Spring2018
5284,NE 92nd & Sacramento,8116,N,NS,2,2,4,0,Spring2018
5285,NE 92nd & Schuyler,8118,S,NS,4,0,4,0,Spring2018
5286,NE 92nd & Schuyler,8119,N,OP,1,2,3,0,Spring2018
5287,NE 92nd & Thompson,8124,S,FS,7,3,10,0,Spring2018
5288,NE 92nd & Tillamook,8125,N,OP,5,5,10,0,Spring2018
5289,NE 92nd & Tillamook,8126,S,NS,1,2,3,0,Spring2018
5290,SE 97th & Foster,8134,N,NS,7,81,88,6,Spring2018
5291,NE 99th & Glisan,8140,N,FS,8,40,48,14,Spring2018
5292,99th & Glisan,8141,S,NS,37,10,47,16,Spring2018
5293,NE 102nd & Knott,8149,N,NS,1,5,6,0,Spring2018
5300,SE International Way & 40th,8152,E,FS,7,9,16,4,Spring2018
5301,4400 Block SE International Way,8153,E,AT,3,4,7,1,Spring2018
5302,4900 Block SE International Way (Blount),8154,E,OP,4,1,5,0,Spring2018
5303,SE International Way & Mallard,8155,E,OP,1,5,6,0,Spring2018
5304,5600 Block SE International Way,8156,S,OP,1,3,4,0,Spring2018
5305,SE International Way & Mallard,8164,W,NS,3,2,5,0,Spring2018
5306,4900 Block SE International Way (Blount),8165,W,AT,2,3,5,0,Spring2018
5307,4500 Block SE International Way,8166,W,OP,3,4,7,1,Spring2018
5308,SE International Way & 40th,8167,W,OP,6,8,14,1,Spring2018
5309,SE 32nd & Johnson Creek,8168,N,NS,11,6,17,2,Spring2018
5310,Hillsboro Transit Center,8181,E,AT,451,182,633,107,Spring2018
5311,Gateway Transit Center,8190,S,AT,82,8,90,27,Spring2018
5312,Gateway TC (Drop off only stop),8194,N,AT,173,689,862,207,Spring2018
5313,Lake Oswego Transit Center,8207,S,AT,146,86,232,32,Spring2018
5314,Lake Oswego Transit Center,8208,S,AT,111,179,290,91,Spring2018
5315,Tigard Transit Center,8209,S,AT,227,356,583,49,Spring2018
5316,Tigard Transit Center,8210,S,AT,71,51,122,7,Spring2018
5317,Tigard Transit Center,8211,S,AT,227,223,450,52,Spring2018
5318,Tigard Transit Center,8212,S,AT,159,88,247,27,Spring2018
5319,Barbur Transit Center,8213,E,AT,77,595,672,13,Spring2018
5320,SE Jackson & Main St,8223,W,NS,412,246,658,144,Spring2018
5321,SE Jackson & 21st,8225,E,NS,362,263,625,166,Spring2018
5322,SW Troy & 37th,8227,W,FS,0,0,0,0,Spring2018
5323,SW Hamilton & 54th Pl,8229,E,FS,0,0,0,0,Spring2018
5324,NW 158th & Schendel,8230,S,NS,36,19,55,5,Spring2018
5325,SW 158th & W Baseline,8232,N,OP,0,0,0,1,Spring2018
5326,NW 158th & Schendel,8233,N,FS,13,20,33,2,Spring2018
5327,SW 158th & Jenkins,8234,N,NS,0,0,0,0,Spring2018
5328,SE 82nd & Boise,8237,S,NS,32,146,178,49,Spring2018
5329,SE 50th & Brooklyn,8241,S,FS,67,64,131,8,Spring2018
5330,SE 50th & Woodward,8242,N,FS,73,137,210,6,Spring2018
5331,SE Woodstock & 38th,8243,E,NS,1,9,10,0,Spring2018
5332,SW Martinazzi & Martinazzi Square,8249,N,OP,9,4,13,1,Spring2018
5333,SW Martinazzi & Tualatin-Sherwood,8250,N,FS,7,7,14,0,Spring2018
5334,SW Martinazzi & Martinazzi Square,8252,S,AT,5,11,16,0,Spring2018
5335,13300 Block SW Pacific Hwy,8260,E,AT,12,5,17,1,Spring2018
5336,SW Watson & Broadway,8262,S,NS,85,6,91,9,Spring2018
5337,SW Canyon & Red Robin,8265,W,AT,0,18,18,1,Spring2018
5338,SW Canyon & Watson,8270,E,NS,3,92,95,9,Spring2018
5339,SW Canyon & Broadway,8271,E,NS,18,2,20,4,Spring2018
5340,SW Canyon & Hall,8272,W,NS,45,3,48,6,Spring2018
5341,12900 Block SW Canyon,8273,W,AT,32,8,40,1,Spring2018
5342,SW Sagert & Tillamook,8276,W,OP,1,2,3,0,Spring2018
5343,SW Sagert & Tillamook,8278,E,FS,1,0,1,0,Spring2018
5344,SW 65th & Borland,8279,S,OP,8,0,8,1,Spring2018
5345,SW Sagert & 68th,8281,W,FS,35,0,35,0,Spring2018
5346,SW Sagert & 72nd,8282,W,NS,6,0,6,0,Spring2018
5353,7800 Block SW Sagert,8283,W,OP,4,1,5,0,Spring2018
5354,SW Sagert & Martinazzi,8284,W,FS,3,52,55,9,Spring2018
5355,SW Martinazzi & Mohawk,8285,N,NS,104,26,130,15,Spring2018
5356,SE 32nd & Van Water,8301,S,FS,1,3,4,0,Spring2018
5357,7500 Block NE 21st,8303,N,OP,0,16,16,0,Spring2018
5358,7500 Block NE 21st,8304,S,AT,15,0,15,1,Spring2018
5359,16400 Block SW Langer,8306,N,OP,11,2,13,1,Spring2018
5360,Washington & 16th,8309,N,OP,1,0,1,0,Spring2018
5361,S Holcomb & Front Ave,8310,E,OP,2,5,7,1,Spring2018
5362,S Holcomb & Hunter Ave,8311,E,NS,0,0,0,0,Spring2018
5363,Longview & Holcomb,8312,N,FS,2,6,8,0,Spring2018
5364,900 Block Abernethy,8313,W,OP,0,0,0,0,Spring2018
5365,SE Main & 3rd,8315,N,NS,7,0,7,1,Spring2018
5366,3900 Block SW Murray,8316,S,OP,3,15,18,1,Spring2018
5367,9800 Block NE Pacific St,8321,W,OP,1,86,87,13,Spring2018
5368,SE 32nd & Floss,8326,N,NS,7,8,15,0,Spring2018
5369,N Rosa Parks Way & Knowles,8329,W,NS,2,5,7,1,Spring2018
5370,Library/SW 9th Ave MAX Station,8333,E,AT,1266,1817,3083,0,Spring2018
5371,Pioneer Square South MAX Station,8334,E,AT,1755,3472,5227,0,Spring2018
5372,Mall/SW 4th Ave MAX Station,8335,E,AT,1169,1427,2596,0,Spring2018
5373,Yamhill District MAX Station,8336,E,AT,1167,938,2105,0,Spring2018
5374,Oak/ SW 1st Ave MAX Station,8337,N,NS,622,488,1110,0,Spring2018
5375,Skidmore Fountain MAX Station,8338,N,AT,561,566,1127,0,Spring2018
5376,Old Town/Chinatown MAX Station,8339,N,AT,1006,626,1632,0,Spring2018
5377,Rose Quarter TC MAX Station,8340,E,AT,2505,1405,3910,0,Spring2018
5378,Convention Center MAX Station,8341,E,AT,1022,875,1897,0,Spring2018
5379,NE 7th Ave MAX Station,8342,E,FS,1005,982,1987,0,Spring2018
5380,Lloyd Center/NE 11th Ave MAX Station,8343,E,AT,2006,2110,4116,0,Spring2018
5381,Hollywood/NE 42nd Ave TC MAX Station,8344,E,AT,1092,1597,2689,0,Spring2018
5382,NE 60th Ave MAX Station,8345,E,AT,460,1098,1558,0,Spring2018
5383,NE 82nd Ave MAX Station,8346,E,AT,972,1423,2395,0,Spring2018
5384,Gateway/NE 99th Ave TC MAX Station,8347,S,AT,3768,3559,7327,0,Spring2018
5385,E 102nd Ave MAX Station,8348,E,FS,513,642,1155,0,Spring2018
5386,E 122nd Ave MAX Station,8349,E,FS,502,1138,1640,0,Spring2018
5387,E 148th Ave MAX Station,8350,E,FS,191,657,848,0,Spring2018
5388,E 162nd Ave MAX Station,8351,E,FS,343,1080,1423,0,Spring2018
5389,E 172nd Ave MAX Station,8352,E,FS,121,383,504,0,Spring2018
5390,E 181st Ave MAX Station,8353,E,FS,218,727,945,0,Spring2018
5391,Rockwood/E 188th Ave MAX Station,8354,E,NS,195,636,831,0,Spring2018
5392,Ruby Junction/E 197th Ave MAX Station,8355,E,FS,232,500,732,0,Spring2018
5393,Gresham City Hall MAX Station,8356,E,OP,75,508,583,0,Spring2018
5394,Gresham Central TC MAX Station,8357,E,AT,70,923,993,0,Spring2018
5395,Cleveland Ave MAX Station,8359,W,NS,1013,1050,2063,0,Spring2018
5396,Gresham Central TC MAX Station,8360,W,AT,897,85,982,0,Spring2018
5397,Gresham City Hall MAX Station,8361,W,AT,574,68,642,0,Spring2018
5398,Ruby Junction/E 197th Ave MAX Station,8362,W,FS,318,148,466,0,Spring2018
5399,Rockwood/E 188th Ave MAX Station,8363,W,FS,695,191,886,0,Spring2018
5406,E 181st Ave MAX Station,8364,W,FS,763,235,998,0,Spring2018
5407,E 172nd Ave MAX Station,8365,W,FS,387,123,510,0,Spring2018
5408,E 162nd Ave MAX Station,8366,W,FS,1097,378,1475,0,Spring2018
5409,E 148th Ave MAX Station,8367,W,FS,630,207,837,0,Spring2018
5410,E 122nd Ave MAX Station,8368,W,FS,1182,512,1694,0,Spring2018
5411,E 102nd Ave MAX Station,8369,W,FS,672,551,1223,0,Spring2018
5412,Gateway/NE 99th Ave TC MAX Station,8370,N,AT,3021,3561,6582,0,Spring2018
5413,NE 82nd Ave MAX Station,8371,W,AT,1440,901,2341,0,Spring2018
5414,NE 60th Ave MAX Station,8372,W,AT,1088,466,1554,0,Spring2018
5415,Hollywood/NE 42nd Ave TC MAX Station,8373,W,AT,1376,1131,2507,0,Spring2018
5416,Lloyd Center/NE 11th Ave MAX Station,8374,W,AT,1801,2265,4066,0,Spring2018
5417,NE 7th Ave MAX Station,8375,W,NS,952,1076,2028,0,Spring2018
5418,Convention Center MAX Station,8376,W,AT,1009,927,1936,0,Spring2018
5419,Rose Quarter TC MAX Station,8377,W,AT,1218,2337,3555,0,Spring2018
5420,Old Town/Chinatown MAX Station,8378,S,AT,612,1218,1830,0,Spring2018
5421,Skidmore Fountain MAX Station,8379,S,AT,537,581,1118,0,Spring2018
5422,Oak/ SW 1st Ave MAX Station,8380,S,FS,554,653,1207,0,Spring2018
5423,Morrison/SW 3rd Ave MAX Station,8381,W,NS,1366,1210,2576,0,Spring2018
5424,Mall/SW 5th Ave MAX Station,8382,W,AT,1855,1674,3529,0,Spring2018
5425,Pioneer Square North MAX Station,8383,W,AT,3038,1124,4162,0,Spring2018
5426,Galleria/SW 10th Ave MAX Station,8384,W,AT,1532,1582,3114,0,Spring2018
5427,NW Vaughn & 26th,8385,E,NS,50,2,52,6,Spring2018
5428,SW Taylors Ferry & 76th Pl,8387,W,NS,0,1,1,0,Spring2018
5429,SW Taylors Ferry & 75th,8388,E,NS,2,0,2,0,Spring2018
5430,SW 95th & Commerce Circle,8389,N,NS,5,0,5,1,Spring2018
5431,9900 Block SW Commerce Circle,8391,S,AT,0,2,2,0,Spring2018
5432,NW Everett & Park,8402,E,NS,18,18,36,4,Spring2018
5433,NW St Helens & Newberry Rd,8403,S,NS,0,0,0,0,Spring2018
5434,SE Harold & 67th,8404,W,NS,28,3,31,0,Spring2018
5435,NW Evergreen Pkwy & Tanasbourne Terr,8406,W,OP,3,1,4,0,Spring2018
5436,NW Evergreen Pkwy & NE Amberglen (NW 194th),8408,E,FS,10,25,35,2,Spring2018
5437,NW Evergreen Pkwy & Tanasbourne Terr,8409,E,AT,6,5,11,9,Spring2018
5438,NW Vaughn & 26th,8414,W,NS,1,49,50,10,Spring2018
5439,3300 Block SW Dosch,8416,N,AT,0,0,0,0,Spring2018
5440,SE Hwy 224 & 232nd Dr,8420,W,NS,1,0,1,0,Spring2018
5441,SE Hwy 224 & 232nd Dr,8421,E,NS,0,1,1,0,Spring2018
5442,SE Harold & 64th,8422,W,NS,20,3,23,2,Spring2018
5443,SE Washington & 78th,8426,E,FS,4,21,25,4,Spring2018
5444,16500 Block SE 82nd Dr,8430,N,OP,12,11,23,8,Spring2018
5445,Gillihan Rd & Sauvie Island,8437,N,AT,48,51,99,2,Spring2018
5446,NW St Helens & Harborton Dr,8438,S,NS,1,0,1,0,Spring2018
5447,NW St Helens & Larson,8439,S,OP,1,0,1,0,Spring2018
5448,S Holcomb & Front Ave,8441,W,NS,8,2,10,1,Spring2018
5449,SE Eagle Creek Rd & River Mill Rd,8442,S,NS,0,1,1,0,Spring2018
5450,SW Jenkins & Meridian,8443,W,FS,2,6,8,32,Spring2018
5451,Abernethy & Redland Rd,8446,W,FS,0,0,0,1,Spring2018
5452,Abernethy & Redland Rd,8447,E,NS,0,0,0,0,Spring2018
5459,8300 Block SE Causey,8448,E,AT,14,23,37,12,Spring2018
5460,SW Terwilliger & Cheltenham,8450,S,NS,0,0,0,0,Spring2018
5461,SW Dennis & Baseline,8452,N,NS,15,26,41,6,Spring2018
5462,SW US Veterans Rd & Bldg 16,8455,N,AT,65,84,149,8,Spring2018
5463,SE Bell & Sandview,8457,S,NS,14,55,69,33,Spring2018
5464,E Powell & NE Liberty,8461,W,NS,3,3,6,1,Spring2018
5465,SE Stark & SW 257th Dr,8464,W,FS,127,60,187,55,Spring2018
5466,NE 102nd & Thompson,8465,S,NS,2,1,3,0,Spring2018
5467,SE 90th & Monterey,8467,S,NS,1,8,9,19,Spring2018
5468,NE Shaver & Parkrose Middle School,8471,E,AT,3,29,32,1,Spring2018
5469,NW 158th & Blueridge,8474,S,FS,17,1,18,0,Spring2018
5470,NW 158th & Blueridge,8475,N,NS,2,20,22,0,Spring2018
5471,N Lombard & Baltimore,8480,N,NS,65,137,202,108,Spring2018
5472,NW Wardway & Montgomery Pk,8481,W,AT,3,40,43,1,Spring2018
5473,NW Nicolai & Wardway,8482,E,FS,5,33,38,1,Spring2018
5474,NW 27th & Vaughn at Montgomery Park,8484,S,NS,274,88,362,28,Spring2018
5475,SW Lombard & 2nd,8491,S,NS,17,10,27,9,Spring2018
5476,SE McLoughlin & Naef,8494,S,NS,14,35,49,7,Spring2018
5477,15700 Block SW 72nd,8495,N,AT,0,0,0,0,Spring2018
5478,5500 Block N Channel Ave (Shipyards),8496,E,AT,5,8,13,0,Spring2018
5479,NE Columbia Blvd & 24th,8498,W,OP,0,1,1,0,Spring2018
5480,NE Columbia Blvd & 29th,8499,E,NS,2,0,2,0,Spring2018
5481,NE Columbia Blvd & 27th,8500,E,NS,2,0,2,0,Spring2018
5482,NE Evergreen Pkwy & Cornelius Pass Rd,8505,E,NS,2,9,11,0,Spring2018
5483,SW Sagert & Martinazzi,8506,E,FS,1,20,21,1,Spring2018
5484,NE Columbia Blvd & 24th,8507,E,FS,1,0,1,0,Spring2018
5485,NE Columbia Blvd & 29th,8508,W,FS,0,7,7,0,Spring2018
5486,Jackson & 9th,8509,S,NS,1,0,1,1,Spring2018
5487,W Burnside & SW 20th,8511,E,NS,352,101,453,158,Spring2018
5488,E Burnside & NE 20th,8512,W,NS,81,39,120,10,Spring2018
5489,NE 11th & Holladay,8513,N,NS,72,244,316,33,Spring2018
5490,E Main & NE 14th,8514,E,OP,1,1,2,1,Spring2018
5491,E Main & NE 14th,8537,W,FS,0,1,1,0,Spring2018
5492,NE Evergreen Pkwy & NW Atkeson Ln,8539,E,NS,1,10,11,0,Spring2018
5493,NW Evergreen Pkwy & NE John Olsen,8540,W,FS,19,12,31,1,Spring2018
5494,NW Evergreen Pkwy & NE Aloclek Ct,8541,W,FS,13,4,17,1,Spring2018
5495,NE Century (NW 229th) & Butler,8542,S,NS,4,3,7,0,Spring2018
5496,NE Cornell & Century (NW 229th),8543,W,FS,2,8,10,2,Spring2018
5497,NE Cornell & Elam Young West,8545,W,OP,5,7,12,0,Spring2018
5498,3300 Block NE Cornell,8546,W,AT,4,10,14,0,Spring2018
5499,NE Cornell & 25th,8547,W,FS,15,19,34,2,Spring2018
5500,NE Cornell & Hillaire Dr,8548,W,NS,14,12,26,1,Spring2018
5501,NE Cornell & Arrington,8549,W,NS,22,13,35,1,Spring2018
5502,NE Cornell & Grant,8550,S,NS,7,5,12,0,Spring2018
5503,NE Cornell & Jackson,8551,S,NS,1,2,3,0,Spring2018
5504,SE 10th & E Main,8552,N,NS,15,2,17,0,Spring2018
5505,NE Cornell & Jackson,8553,N,OP,4,1,5,0,Spring2018
5512,NE Cornell & Grant,8554,N,NS,4,8,12,0,Spring2018
5513,NE Cornell & Arrington,8555,E,OP,11,19,30,1,Spring2018
5514,NE Cornell & Hillaire Dr,8556,E,FS,19,14,33,1,Spring2018
5515,NE 25th & Cornell,8557,N,FS,2,2,4,0,Spring2018
5516,NE Cornell & 34th,8558,E,NS,9,4,13,1,Spring2018
5517,NE Cornell & Elam Young West,8559,E,FS,5,4,9,0,Spring2018
5518,NE Cornell & Century (NW 231st),8561,E,FS,9,3,12,3,Spring2018
5519,NW Evergreen Pkwy & NE Aloclek Dr,8562,E,FS,5,12,17,1,Spring2018
5520,NW Evergreen Pkwy & NE John Olsen,8563,E,NS,10,19,29,1,Spring2018
5521,NE 148th & Sacramento,8564,N,NS,1,1,2,0,Spring2018
5522,NE 148th & Fremont,8567,N,NS,3,2,5,1,Spring2018
5523,NE Sandy & 152nd,8569,E,FS,5,12,17,1,Spring2018
5524,NE Sandy & 158th,8570,E,NS,17,38,55,0,Spring2018
5525,NE Sandy & 162nd,8571,E,NS,38,36,74,41,Spring2018
5526,NE Sandy & 165th,8572,E,FS,5,8,13,0,Spring2018
5527,NE 181st & Halsey,8580,S,NS,21,10,31,8,Spring2018
5528,NE 181st & Halsey,8581,N,NS,13,25,38,5,Spring2018
5529,NE 181st & San Rafael,8582,N,NS,2,9,11,4,Spring2018
5530,NE Sandy & 165th,8584,W,FS,7,4,11,0,Spring2018
5531,NE Sandy & 162nd,8585,W,OP,25,13,38,10,Spring2018
5532,NE Sandy & 152nd,8587,W,OP,12,4,16,0,Spring2018
5533,NE 148th & 147th,8589,S,FS,1,0,1,0,Spring2018
5534,NE 148th & Sacramento,8592,S,OP,0,0,0,1,Spring2018
5535,SW 257th & Hensley Rd,8595,S,FS,3,1,4,0,Spring2018
5536,SW 257th & 28th,8597,S,FS,0,3,3,0,Spring2018
5537,SW 257th & SE Stark,8598,N,FS,11,7,18,1,Spring2018
5538,SW 257th & 28th,8599,N,OP,0,0,0,0,Spring2018
5539,SW 185th & Alexander,8603,S,NS,8,91,99,13,Spring2018
5540,SW Murray & Allen,8604,S,FS,52,87,139,31,Spring2018
5541,SW Murray & Davis,8605,S,NS,3,8,11,4,Spring2018
5542,SW Murray & Kilchis,8606,S,FS,2,2,4,0,Spring2018
5543,SW Murray & Hart,8607,S,FS,14,6,20,3,Spring2018
5544,SW Murray & Sexton Mtn Dr,8608,S,FS,4,10,14,0,Spring2018
5545,SW Murray & Maverick Terr,8609,S,FS,13,24,37,10,Spring2018
5546,SW Murray & Beard,8610,S,FS,17,35,52,11,Spring2018
5547,SW Murray & Weir Rd,8611,S,FS,5,19,24,1,Spring2018
5548,SW Murray & Osprey Dr,8612,S,NS,17,60,77,6,Spring2018
5549,SW Murray & Teal Blvd,8613,S,NS,16,49,65,5,Spring2018
5550,SW Scholls Ferry & 135th,8614,E,NS,25,23,48,1,Spring2018
5551,SW Scholls Ferry & 130th,8615,E,FS,7,9,16,0,Spring2018
5552,SW Scholls Ferry & North Dakota,8616,E,NS,21,41,62,12,Spring2018
5553,SW Scholls Ferry & 121st,8617,E,FS,33,27,60,15,Spring2018
5554,SW Scholls Ferry & Murray,8618,E,FS,49,48,97,7,Spring2018
5555,SW Scholls Ferry & Boones Bend Dr,8619,W,FS,27,21,48,1,Spring2018
5556,SW Scholls Ferry & 125th,8620,W,FS,49,22,71,10,Spring2018
5557,SW Scholls Ferry & 130th,8621,W,FS,8,9,17,0,Spring2018
5558,SW Scholls Ferry & 135th,8622,W,FS,23,19,42,1,Spring2018
5565,SW Murray & Teal Blvd,8625,N,NS,37,19,56,3,Spring2018
5566,SW Murray & Osprey Dr,8626,N,FS,50,15,65,6,Spring2018
5567,SW Murray & Weir Rd,8627,N,OP,20,3,23,1,Spring2018
5568,SW Brockman & Stallion,8628,E,NS,6,0,6,0,Spring2018
5569,SW Murray & Maverick Terr,8629,N,FS,15,13,28,8,Spring2018
5570,SW Murray & Sexton Mtn Dr,8630,N,FS,12,5,17,0,Spring2018
5571,SW Murray & Hargis,8631,N,NS,1,0,1,0,Spring2018
5572,SW Murray & Hart,8632,N,FS,15,16,31,1,Spring2018
5573,SW Murray & Barlow,8633,N,NS,4,3,7,0,Spring2018
5574,SW Murray & 22nd,8634,N,FS,9,6,15,5,Spring2018
5575,SW Murray & Allen,8635,N,NS,52,51,103,12,Spring2018
5576,SW Murray & Hargis,8636,S,FS,1,1,2,0,Spring2018
5577,NE Century (NW 229th) & Cornell,8643,N,FS,7,5,12,1,Spring2018
5578,SW Pacific Hwy & Durham,8644,S,NS,15,73,88,10,Spring2018
5579,20500 Block NW Evergreen Pkwy,8646,W,OP,7,3,10,0,Spring2018
5580,20500 Block NW Evergreen Pkwy,8647,E,AT,4,5,9,0,Spring2018
5581,NE Evergreen Pkwy & NW Atkeson Ln,8648,W,OP,10,1,11,0,Spring2018
5582,NE Cornell & Orenco Station Pkwy,8649,E,NS,19,9,28,3,Spring2018
5583,NE Cornell & Orenco Station Pkwy,8650,W,FS,9,18,27,4,Spring2018
5584,NW St Helens & Riverview Drive,8654,S,NS,2,0,2,0,Spring2018
5585,SE 90th & Monterey,8659,N,FS,7,3,10,15,Spring2018
5586,SW Pacific Hwy & Home Street Bank,8663,N,AT,13,5,18,3,Spring2018
5587,SE Harold & Foster,8664,E,NS,47,43,90,6,Spring2018
5588,SW Scholls Ferry & Davies,8665,E,FS,9,7,16,0,Spring2018
5589,SW Talbot & Talbot Terrace,8672,S,NS,0,1,1,0,Spring2018
5590,SW Scholls Ferry & Davies,8673,W,FS,15,11,26,2,Spring2018
5591,SE 90th & Causey,8677,N,NS,21,13,34,17,Spring2018
5592,SE 45th & Lexington,8678,S,NS,0,8,8,1,Spring2018
5593,29600 Block SE Eagle Creek Rd,8685,S,AT,0,0,0,0,Spring2018
5594,NE 181st & San Rafael,8714,S,NS,4,1,5,1,Spring2018
5595,21700 Block SE Hwy 224,8720,E,AT,0,1,1,0,Spring2018
5596,21700 Block SE Hwy 224,8721,W,OP,1,0,1,0,Spring2018
5597,600 Block NW Wade,8722,N,AT,0,0,0,0,Spring2018
5598,800 Block NW Wade (at Library),8723,S,AT,1,8,9,1,Spring2018
5599,12700 Block SE McLoughlin,8726,N,AT,6,10,16,4,Spring2018
5600,NE 27th & Highland,8727,N,FS,0,13,13,1,Spring2018
5601,SW Pacific Hwy & Royalty Parkway,8728,S,FS,7,57,64,12,Spring2018
5602,5th & Washington (Oregon City),8732,W,NS,11,9,20,9,Spring2018
5603,20000 Block SE Hwy 224,8735,W,AT,0,0,0,0,Spring2018
5604,17300 Block SE Hwy 224,8736,W,OP,0,0,0,0,Spring2018
5605,17400 Block SE Hwy 224,8737,E,AT,0,0,0,0,Spring2018
5606,NE Vancouver Way & 3rd,8740,S,NS,3,1,4,0,Spring2018
5607,2700 Block W Powell,8742,E,AT,53,80,133,78,Spring2018
5608,2700 Block W Powell,8743,W,OP,90,54,144,103,Spring2018
5609,NW St Helens & Harborton Dr,8744,N,NS,0,0,0,0,Spring2018
5610,E Burnside & NE 97th,8745,W,NS,12,14,26,2,Spring2018
5611,W Columbia River Hwy & NW Graham,8746,W,FS,51,2,53,2,Spring2018
5618,W Burnside & NW Uptown Terrace,8749,W,AT,1,5,6,0,Spring2018
5619,W Burnside & NW Uptown Terrace,8750,E,OP,3,1,4,0,Spring2018
5620,20000 Block SE Hwy 224,8755,S,AT,0,0,0,0,Spring2018
5621,Oregon City Transit Center,8758,N,AT,268,167,435,61,Spring2018
5622,Oregon City Transit Center,8759,N,AT,68,105,173,20,Spring2018
5623,Oregon City Transit Center,8760,S,AT,192,171,363,74,Spring2018
5624,Oregon City Transit Center,8761,S,AT,257,265,522,131,Spring2018
5625,Oregon City Transit Center,8762,W,AT,215,193,408,37,Spring2018
5626,Webster & Cason,8763,N,NS,5,2,7,0,Spring2018
5627,17100 Block SE Webster,8764,N,AT,4,1,5,0,Spring2018
5628,SW Naito Parkway & Sheridan,8770,S,NS,42,6,48,0,Spring2018
5629,SE Kane & Powell Valley,8776,S,NS,14,4,18,1,Spring2018
5630,NW Bethany & Bronson,8779,S,NS,20,5,25,0,Spring2018
5631,SW Sagert & 86th,8788,W,OP,0,3,3,0,Spring2018
5632,SW Pacific Hwy & Durham,8792,N,FS,56,8,64,4,Spring2018
5633,SE Hwy 224 & Tong,8794,E,OP,0,0,0,0,Spring2018
5634,17700 Block SE Hwy 224,8795,W,AT,0,0,0,0,Spring2018
5635,SW Barnes & Barnes,8798,W,FS,2,16,18,0,Spring2018
5636,W Burnside & SW Barnes,8799,E,NS,17,2,19,0,Spring2018
5637,4100 Block SE 182nd,8800,S,AT,0,17,17,3,Spring2018
5638,NW Vaughn & 27th,8802,W,NS,4,101,105,8,Spring2018
5639,2400 Block NW 29th,8808,N,AT,1,8,9,0,Spring2018
5640,2500 Block NW 29th,8809,S,OP,1,0,1,0,Spring2018
5641,4700 Block W Powell,8812,E,OP,17,33,50,17,Spring2018
5642,N Rosa Parks Way & Albina,8814,W,NS,12,18,30,8,Spring2018
5643,SE McLoughlin & Meldrum,8819,N,FS,11,4,15,0,Spring2018
5644,SW Council Crest & Tualatin (north leg),8821,N,NS,2,0,2,0,Spring2018
5645,SE Hwy 224 & Glover Rd,8823,S,FS,0,0,0,0,Spring2018
5646,SE Hwy 224 & Hwy 211,8824,N,AT,4,1,5,1,Spring2018
5647,19800 Block NE Halsey,8825,W,OP,5,2,7,1,Spring2018
5648,13000 Block NW Cornell,8828,E,AT,10,7,17,1,Spring2018
5649,SE Hwy 224 & 135th,8830,W,NS,13,2,15,0,Spring2018
5650,SW Greenburg & Lehman,8832,S,OP,4,6,10,0,Spring2018
5651,SW Greenburg & Lehman,8835,N,NS,4,9,13,0,Spring2018
5652,NE Main & 3rd,8837,S,NS,0,3,3,1,Spring2018
5653,NE Main & 3rd,8838,N,OP,2,0,2,0,Spring2018
5654,NW Springville & 178th,8839,E,FS,0,5,5,1,Spring2018
5655,SE 122nd & Powell,8843,S,NS,14,220,234,38,Spring2018
5656,SE Harold & 101st,8844,W,NS,23,1,24,0,Spring2018
5657,SW Park Way & 135th,8845,E,OP,0,1,1,0,Spring2018
5658,NW Springville & 181st,8850,E,FS,1,12,13,1,Spring2018
5659,SE Stark & NE Kelly,8851,W,OP,4,3,7,8,Spring2018
5660,NW Springville & 181st,8852,W,OP,0,0,0,0,Spring2018
5661,2500 Block NE Riverside Way,8854,E,AT,0,9,9,0,Spring2018
5662,800 Block NW Wade,8857,N,AT,6,1,7,0,Spring2018
5663,NE Halsey & 181st,8860,W,FS,81,48,129,25,Spring2018
5664,NW Front & Kittridge,8875,E,FS,5,2,7,0,Spring2018
5671,4500 Block NW Front,8877,E,OP,0,0,0,0,Spring2018
5672,4300 Block NW Front,8878,E,OP,1,0,1,0,Spring2018
5673,3600 Block NW Front,8879,E,OP,12,2,14,0,Spring2018
5674,W Burnside & NW Maywood Dr,8880,W,NS,1,3,4,0,Spring2018
5675,W Burnside & NW Maywood Dr,8881,E,OP,1,1,2,1,Spring2018
5676,NE 21st & Riverside Way,8883,N,NS,0,7,7,0,Spring2018
5677,NW 185th & Tanasbourne Rd,8884,N,FS,28,141,169,20,Spring2018
5678,NW Everett & 5th,8886,E,NS,488,455,943,178,Spring2018
5679,SW Garden Home & Capitol Hwy,8888,E,NS,2,3,5,0,Spring2018
5680,NE 82nd & Webster,8889,S,OP,13,11,24,2,Spring2018
5681,24300 Block SW Boones Ferry Rd,8891,S,AT,0,1,1,0,Spring2018
5682,24300 Block SW Boones Ferry Rd,8892,N,AT,1,0,1,0,Spring2018
5683,SE 32nd & Meek,8894,N,OP,41,13,54,34,Spring2018
5684,Division & Warren St,8899,W,OP,1,1,2,0,Spring2018
5685,7th & Taylor,8900,W,NS,1,1,2,0,Spring2018
5686,4200 Block NW Front,8901,E,OP,1,0,1,0,Spring2018
5687,4200 Block NW Front,8902,W,AT,1,2,3,0,Spring2018
5688,3800 Block NW Front,8903,E,OP,0,0,0,0,Spring2018
5689,3800 Block NW Front,8904,W,AT,0,0,0,0,Spring2018
5690,NE 122nd & Fremont,8907,N,FS,12,29,41,1,Spring2018
5691,SW 40th & Garden Home,8911,S,NS,2,2,4,0,Spring2018
5692,SE 96th & Mall 205,8912,S,OP,11,40,51,9,Spring2018
5693,SE Main & 96th,8913,E,FS,19,14,33,11,Spring2018
5694,10000 Block SE Main,8914,E,AT,22,16,38,19,Spring2018
5695,10500 Block SE Cherry Blossom,8915,W,AT,10,6,16,4,Spring2018
5696,10200 Block SE Main,8917,W,AT,23,22,45,25,Spring2018
5697,SE 96th & Main,8918,N,FS,32,38,70,20,Spring2018
5698,SE 96th & Mall 205 Dr,8919,N,NS,27,14,41,14,Spring2018
5699,SW Walker & Butner,8920,W,NS,2,3,5,0,Spring2018
5700,SW Walker & Meadow Dr,8921,W,NS,1,2,3,0,Spring2018
5701,SW Walker & 150th,8922,W,NS,3,3,6,0,Spring2018
5702,SW Walker & Greystone Ct,8923,W,OP,0,0,0,0,Spring2018
5703,SW Walker & 158th,8924,E,NS,1,1,2,0,Spring2018
5704,SW Walker & Greystone Ct,8925,E,FS,0,0,0,0,Spring2018
5705,SW Walker & Koll Parkway,8926,E,NS,4,2,6,0,Spring2018
5706,SW Walker & Meadow Dr,8927,E,NS,2,0,2,0,Spring2018
5707,SW Walker & Murray,8928,E,NS,3,1,4,1,Spring2018
5708,SE Washington & 99th,8935,E,NS,5,34,39,14,Spring2018
5709,SE 99th & Washington,8936,N,NS,18,6,24,9,Spring2018
5710,NE Holladay & 11th,8937,E,NS,200,37,237,39,Spring2018
5711,NE 11th & Multnomah,8938,N,NS,24,98,122,27,Spring2018
5712,SE 122nd & Midland Library,8940,N,OP,30,56,86,18,Spring2018
5713,19500 Block SW 65th,8944,S,AT,37,1,38,0,Spring2018
5714,SE Powell Valley & Greenway,8945,W,FS,0,0,0,0,Spring2018
5715,SE Powell Valley & Greenway,8946,E,OP,0,0,0,0,Spring2018
5716,28400 Block SE Hwy 224,8947,N,AT,0,0,0,0,Spring2018
5717,28400 Block SE Hwy 224,8948,E,OP,0,0,0,0,Spring2018
5724,SE Division & 96th,8949,E,NS,13,25,38,12,Spring2018
5725,SW Canyon & Watson,8950,W,NS,16,3,19,3,Spring2018
5726,SW 49th & PCC Entrance,8951,S,NS,1,38,39,1,Spring2018
5727,20200 Block SW Pacific Hwy,8954,E,AT,4,1,5,1,Spring2018
5728,I-5 Off Ramp & SW Lower Boones Ferry,8956,S,AT,2,124,126,0,Spring2018
5729,NW Leahy & Leahy Terrace,8961,W,NS,0,0,0,0,Spring2018
5730,NW Leahy & Leahy Terrace,8962,S,OP,1,0,1,0,Spring2018
5731,NW 23rd & Flanders,8963,S,NS,67,19,86,11,Spring2018
5732,NW 23rd & Overton,8981,N,FS,15,75,90,18,Spring2018
5733,NW Thurman & 23rd Pl,8984,W,NS,2,47,49,5,Spring2018
5734,NW Thurman & 25th,8985,W,NS,1,12,13,2,Spring2018
5735,NW 23rd & Thurman,8986,S,FS,118,5,123,7,Spring2018
5736,NW 23rd & Marshall,8989,S,NS,176,28,204,45,Spring2018
5737,SE Sunnyside & 105th,8991,E,NS,2,10,12,0,Spring2018
5738,SE Sunnyside & Valley View Terr,8993,E,NS,3,19,22,1,Spring2018
5739,SE Sunnyside & 119th,8995,E,FS,7,33,40,6,Spring2018
5740,SE Mather & 122nd,8998,W,FS,5,2,7,0,Spring2018
5741,SE Mather & 119th Ct,8999,W,NS,0,0,0,0,Spring2018
5742,SE Mather & Cranberry Loop,9000,S,FS,7,0,7,0,Spring2018
5743,11000 Block SE Mather,9001,W,AT,0,0,0,0,Spring2018
5744,10500 Block SE Mather,9002,W,AT,7,1,8,0,Spring2018
5745,SE 97th & Lawnfield,9004,N,NS,5,1,6,0,Spring2018
5746,SE 97th & Talbert Dr,9005,N,NS,2,0,2,0,Spring2018
5747,14000 Block SE 97th,9007,W,AT,5,1,6,0,Spring2018
5748,SE Hubbard & 128th,9008,W,OP,0,0,0,0,Spring2018
5749,SE Hubbard & 128th,9009,E,NS,0,0,0,0,Spring2018
5750,NW Cornell & 185th,9010,E,FS,73,24,97,13,Spring2018
5751,NE Cornell & NW 185th,9012,W,FS,38,78,116,14,Spring2018
5752,NW Cornell & 188th,9013,W,FS,7,13,20,2,Spring2018
5753,NE Cornell & Stucki,9014,W,FS,21,41,62,7,Spring2018
5754,NW 185th & Evergreen,9022,S,FS,163,60,223,28,Spring2018
5755,SW Martinazzi & Tualatin-Sherwood,9026,S,NS,1,9,10,0,Spring2018
5756,NE 122nd & Wasco,9027,N,FS,5,89,94,26,Spring2018
5757,SW Tualatin Valley Hwy & 153rd,9029,E,NS,2,3,5,0,Spring2018
5758,NW 23rd & Raleigh,9030,S,FS,81,4,85,2,Spring2018
5759,NW 23rd & Raleigh,9031,N,NS,4,89,93,1,Spring2018
5760,SW Bertha & Chestnut,9033,N,NS,11,5,16,0,Spring2018
5761,SW Scholls Ferry & Springwood,9038,W,OP,17,24,41,3,Spring2018
5762,Molalla & Char Diaz Dr,9041,N,OP,2,0,2,0,Spring2018
5763,Molalla & Oregon City Post Office,9042,N,AT,6,2,8,6,Spring2018
5764,SW Columbia & 10th,9044,E,NS,186,72,258,39,Spring2018
5765,SW 257th & Hensley Rd,9046,N,FS,0,2,2,0,Spring2018
5766,SW 72nd & Durham Rd,9047,S,NS,0,0,0,0,Spring2018
5767,SW 72nd & Durham Rd,9048,N,OP,0,0,0,0,Spring2018
5768,NW Cornell & Bethany,9050,W,FS,31,28,59,3,Spring2018
5769,NW Cornell & Evergreen Pkwy,9051,W,FS,12,24,36,1,Spring2018
5770,NW Cornell & 167th Pl,9052,W,FS,5,6,11,7,Spring2018
5777,NW Cornell & 173rd Pl,9053,W,NS,21,33,54,3,Spring2018
5778,NW Cornell & 167th Pl,9054,E,NS,5,4,9,6,Spring2018
5779,NW Cornell & 173rd Ave,9055,E,FS,26,22,48,2,Spring2018
5780,NW Cornell & Bethany Ct,9056,E,NS,39,42,81,5,Spring2018
5781,NW Cornell & 179th,9059,E,NS,19,8,27,0,Spring2018
5782,SE 181st & E Burnside,9061,S,FS,24,46,70,17,Spring2018
5783,SW Hall & Tigard City Hall,9065,S,AT,1,2,3,6,Spring2018
5784,SW Hall & Fanno Creek Ct,9067,S,OP,2,4,6,0,Spring2018
5785,SW Hall & Bonita,9068,S,NS,6,29,35,0,Spring2018
5786,SW Hall & Murdock,9069,S,OP,0,7,7,0,Spring2018
5787,SW Hall & Sattler,9070,S,FS,3,9,12,0,Spring2018
5788,SW Hall & Avon,9071,N,FS,41,4,45,0,Spring2018
5789,8300 Block SW Durham,9072,E,OP,6,8,14,1,Spring2018
5790,SW Durham & 76th,9073,E,OP,0,5,5,0,Spring2018
5791,SW Durham & Upper Boones Ferry,9076,S,FS,4,28,32,0,Spring2018
5792,7200 Block SW Durham,9077,W,OP,8,1,9,0,Spring2018
5793,SW Durham & Upper Boones Ferry,9078,N,FS,23,2,25,0,Spring2018
5794,SW Durham & 76th,9079,W,NS,2,1,3,0,Spring2018
5795,8200 Block SW Durham,9080,W,AT,9,5,14,0,Spring2018
5796,SW Hall & Ashford,9082,N,NS,5,2,7,0,Spring2018
5797,SW Hall & Murdock,9083,N,NS,4,0,4,0,Spring2018
5798,SW Hall & Bonita,9084,N,NS,28,4,32,1,Spring2018
5799,SW Hall & McDonald,9085,N,NS,3,1,4,0,Spring2018
5800,SW Hall & Omara,9086,N,OP,21,6,27,6,Spring2018
5801,SW 257th & 16th Way,9092,N,NS,3,17,20,1,Spring2018
5802,SW 257th & Cherry Park,9094,N,NS,1,4,5,0,Spring2018
5803,17600 Block NE Sandy,9095,E,AT,12,24,36,0,Spring2018
5804,SW 257th & Sturges,9101,S,NS,3,0,3,0,Spring2018
5805,SW 257th & Cherry Park,9103,S,NS,22,5,27,1,Spring2018
5806,NE 105th & Killingsworth,9105,N,FS,3,2,5,1,Spring2018
5807,NE 105th & Simpson,9106,N,FS,2,4,6,0,Spring2018
5808,11000 Block NE Holman,9107,E,AT,4,8,12,3,Spring2018
5809,NE Airport Way & Ainsworth Circle,9108,E,NS,3,10,13,5,Spring2018
5810,NE Airport Way & 122nd,9110,E,NS,8,19,27,1,Spring2018
5811,NE Airport Way & 138th,9112,E,NS,4,15,19,1,Spring2018
5812,SW 18th & Morrison,9122,N,NS,20,15,35,1,Spring2018
5813,NW 25th & Lovejoy,9125,N,NS,0,1,1,0,Spring2018
5814,NW Cornell & Marshall,9126,N,AT,0,0,0,0,Spring2018
5815,NW Cornell & Summit Ct,9127,N,OP,0,1,1,0,Spring2018
5816,NW Cornell & Westover,9129,S,NS,0,3,3,0,Spring2018
5817,NW Cumberland & Fairfax,9130,S,FS,0,1,1,0,Spring2018
5818,NW Cumberland & Shenandoah,9131,W,NS,2,2,4,0,Spring2018
5819,NW Cumberland & Ariel,9132,W,FS,0,0,0,0,Spring2018
5820,NW Powhatan & Greenbrier Terr,9133,S,FS,0,1,1,0,Spring2018
5821,NW Macleay & Hermosa,9135,E,FS,1,2,3,0,Spring2018
5822,NW Macleay & Lomita Terrace,9136,E,NS,1,0,1,0,Spring2018
5823,NW Macleay & Beuhla Vista,9137,S,NS,0,0,0,0,Spring2018
5830,NW Macleay & W Burnside,9139,S,NS,0,0,0,0,Spring2018
5831,SW Walker & 158th,9145,W,FS,1,2,3,0,Spring2018
5832,SW Walker & Schendel,9146,W,NS,4,2,6,0,Spring2018
5833,NW Walker & 167th,9147,W,NS,0,0,0,0,Spring2018
5834,NW Walker & 173rd,9148,W,NS,0,0,0,0,Spring2018
5835,NW Walker & 185th,9150,E,FS,4,1,5,1,Spring2018
5836,NW Walker & 173rd,9151,E,NS,0,0,0,0,Spring2018
5837,SW Walker & Schendel,9152,E,NS,4,4,8,0,Spring2018
5838,NW Walker & SW 167th,9153,E,FS,0,0,0,0,Spring2018
5839,NW Cedar Hills & Leahy,9158,N,FS,2,4,6,0,Spring2018
5840,SW Conestoga & Boones Bend,9159,N,OP,0,14,14,0,Spring2018
5841,SW Conestoga & Welch,9160,W,NS,0,5,5,0,Spring2018
5842,SW Conestoga & Downing,9161,W,NS,0,8,8,0,Spring2018
5843,SW Conestoga & 125th,9162,W,NS,0,15,15,0,Spring2018
5844,SW 125th & Longhorn,9163,N,FS,0,6,6,1,Spring2018
5845,SW 125th & Footpath,9164,N,AT,0,4,4,0,Spring2018
5846,SW Brockman & Sorrento,9165,W,FS,0,1,1,0,Spring2018
5847,SW Brockman & 135th,9166,W,NS,0,11,11,0,Spring2018
5848,SW Brockman & Davies,9167,W,NS,0,5,5,0,Spring2018
5849,SW Brockman & Pony,9168,W,FS,0,3,3,0,Spring2018
5850,SW Scholls Ferry & Progress Park & Ride,9169,S,AT,2,27,29,0,Spring2018
5851,SW Teal & 152nd,9170,W,FS,4,2,6,0,Spring2018
5852,SW Teal & 155th,9171,S,NS,3,3,6,0,Spring2018
5853,SW Teal & Bobwhite Circle,9172,E,NS,3,2,5,0,Spring2018
5854,SW Teal & Pintail,9173,S,NS,4,3,7,0,Spring2018
5855,SW Scholls Ferry & Teal Blvd,9174,E,FS,20,14,34,0,Spring2018
5856,SW Scholls Ferry & 147th,9175,E,FS,4,2,6,0,Spring2018
5857,SW Brockman & Davies,9176,E,FS,5,0,5,0,Spring2018
5858,SW Brockman & 135th,9177,E,FS,13,0,13,0,Spring2018
5859,SW Brockman & Sorrento,9178,E,OP,2,0,2,0,Spring2018
5860,SW 125th & Footpath,9179,S,AT,6,0,6,0,Spring2018
5861,9600 Block SW 125th,9180,S,AT,7,3,10,0,Spring2018
5862,SW Conestoga & 125th,9181,E,FS,18,0,18,0,Spring2018
5863,SW Conestoga & Downing,9182,E,OP,7,0,7,0,Spring2018
5864,SW Conestoga & Trapper Terrace,9183,E,FS,4,0,4,0,Spring2018
5865,SW Conestoga & Boones Bend,9184,S,NS,16,1,17,0,Spring2018
5866,SW Scholls Ferry & Progress Park & Ride,9185,N,OP,27,7,34,1,Spring2018
5867,SW Tualatin-Sherwood Rd & Pacific Hwy,9186,S,FS,2,77,79,3,Spring2018
5868,SW Tualatin-Sherwood Rd & Baler,9187,E,NS,2,26,28,10,Spring2018
5869,SW Langer & Sherwood Plaza,9188,W,OP,2,20,22,4,Spring2018
5870,16400 Block SW Langer,9189,S,AT,2,12,14,3,Spring2018
5871,16100 Block SW Langer,9190,E,AT,12,1,13,1,Spring2018
5872,N Rivergate Blvd & Lombard St,9192,W,FS,17,22,39,1,Spring2018
5873,13300 Block N Rivergate,9193,N,OP,0,0,0,0,Spring2018
5874,N Rivergate Blvd & Ramsey,9194,N,NS,1,2,3,0,Spring2018
5875,13300 Block N Rivergate Blvd,9196,S,AT,0,0,0,0,Spring2018
5876,N Lombard & Simmons,9197,N,OP,3,1,4,0,Spring2018
5883,7100 Block N Marine,9198,E,AT,1,1,2,0,Spring2018
5884,5900 Block N Marine,9199,E,OP,0,0,0,0,Spring2018
5885,5700 Block N Marine,9200,E,OP,1,2,3,0,Spring2018
5886,5300 Block N Marine,9202,W,AT,0,0,0,0,Spring2018
5887,5700 Block N Marine,9203,W,FS,1,1,2,0,Spring2018
5888,5900 Block N Marine,9204,W,AT,0,0,0,0,Spring2018
5889,7100 Block N Marine,9205,W,OP,0,1,1,0,Spring2018
5890,N Lombard & Simmons,9206,S,NS,1,5,6,0,Spring2018
5891,SW Tualatin Valley Hwy & 198th,9207,E,FS,58,68,126,21,Spring2018
5892,14700 Block SW Teal,9208,W,OP,10,4,14,1,Spring2018
5893,NW Walker & 180th,9209,W,FS,0,0,0,1,Spring2018
5894,18000 Block NW Walker,9210,E,OP,1,0,1,1,Spring2018
5895,SE Main & 100th,9211,W,OP,5,2,7,1,Spring2018
5896,NW Cornell & Bronson Creek Pk,9212,W,AT,7,6,13,0,Spring2018
5897,NW Cornell & Birch Pointe Apts,9213,E,AT,16,8,24,0,Spring2018
5898,NW Cumberland & Culpepper,9214,W,OP,3,4,7,0,Spring2018
5899,SW Teal & Nighthawk Dr,9215,S,NS,1,1,2,0,Spring2018
5900,Willamette Dr & Lazy River Dr,9216,N,NS,11,2,13,0,Spring2018
5901,NE Wasco & 82nd,9217,E,NS,5,35,40,7,Spring2018
5902,SE Main & 100th,9218,E,NS,2,5,7,1,Spring2018
5903,SE 122nd & Stark,9219,S,FS,116,63,179,31,Spring2018
5904,Washington Square Transit Center,9220,S,AT,50,47,97,6,Spring2018
5905,SW Palmblad & Hall Blvd,9221,N,NS,5,2,7,0,Spring2018
5906,SW Durham & 79th,9224,E,OP,6,4,10,0,Spring2018
5907,SW Durham & 79th,9225,W,NS,5,7,12,0,Spring2018
5908,SW Hall & Ross,9226,N,FS,9,2,11,0,Spring2018
5909,NW Walker & Cambray,9230,E,FS,1,1,2,0,Spring2018
5910,NW Walker & 178th,9232,W,NS,1,1,2,0,Spring2018
5911,SE Orient Dr & 262nd,9233,E,NS,1,1,2,0,Spring2018
5912,SE Orient Dr & 262nd/Barnes/Salquist,9234,W,NS,2,0,2,0,Spring2018
5913,NW Cornell & 153rd,9245,W,NS,8,13,21,0,Spring2018
5914,SE Division & 61st,9248,W,NS,19,11,30,1,Spring2018
5915,SW 158th & Jenkins,9252,S,NS,0,1,1,0,Spring2018
5916,NE Fremont & 66th,9253,E,NS,1,1,2,0,Spring2018
5917,7200 Block SW Durham,9257,S,AT,2,9,11,0,Spring2018
5918,NW Graham/257th & W Columbia River Hwy,9261,S,NS,8,0,8,0,Spring2018
5919,SE Division & 148th,9263,W,FS,92,78,170,48,Spring2018
5920,SE Division & 42nd,9265,W,NS,50,27,77,17,Spring2018
5921,NE 181st & Wilkes,9266,N,NS,2,4,6,0,Spring2018
5922,Willamette Falls Dr & 12th St,9269,E,NS,3,1,4,3,Spring2018
5923,Blankenship & Virginia Lane,9270,N,OP,3,2,5,1,Spring2018
5924,Blankenship & 19th St,9276,W,NS,1,0,1,0,Spring2018
5925,Blankenship & Ostman,9277,W,NS,1,1,2,0,Spring2018
5926,Ostman & Dollar,9279,S,NS,3,2,5,0,Spring2018
5927,Willamette Falls Dr & 19th St,9284,E,OP,1,1,2,0,Spring2018
5928,Willamette Falls Dr & 16th St,9285,E,FS,0,0,0,0,Spring2018
5929,Willamette Falls Dr & 14th St,9286,E,NS,4,2,6,0,Spring2018
5936,10th St & 8th Court,9296,N,NS,5,11,16,10,Spring2018
5937,Blankenship & Tannler Dr,9297,N,FS,1,1,2,0,Spring2018
5938,NW 6th & Davis MAX Station,9299,N,NS,838,684,1522,0,Spring2018
5939,NW 6th & Flanders,9300,N,NS,2,124,126,29,Spring2018
5940,NW 5th & Davis,9301,S,NS,579,415,994,190,Spring2018
5941,NW 5th & Couch MAX Station,9303,S,NS,788,890,1678,1,Spring2018
5942,NE Multnomah & 11th,9305,E,FS,120,64,184,17,Spring2018
5943,SE Steele & 46th,9307,W,NS,16,3,19,1,Spring2018
5944,N Lombard & Ramsey,9308,N,NS,1,1,2,0,Spring2018
5945,N Lombard & Ramsey,9309,S,FS,2,5,7,0,Spring2018
5946,NW Glisan & 3rd,9311,W,FS,94,280,374,76,Spring2018
5947,SE Hwy 224 & Suttle Rd,9312,W,OP,1,0,1,0,Spring2018
5948,SE Hwy 224 & Suttle Rd,9313,E,FS,0,1,1,0,Spring2018
5949,SW Taylors Ferry & Capitol Hwy,9320,E,FS,2,23,25,0,Spring2018
5950,27500 Block SE Hwy 224,9321,E,AT,0,1,1,0,Spring2018
5951,27600 Block SE Hwy 224,9322,W,AT,0,0,0,0,Spring2018
5952,SW Murray & Barlow,9323,S,OP,2,5,7,0,Spring2018
5953,SW Murray & Brockman,9324,N,FS,26,15,41,8,Spring2018
5954,SW 45th & Nevada,9328,S,NS,0,0,0,0,Spring2018
5955,N Marine & Leadbetter,9334,E,FS,3,1,4,0,Spring2018
5956,N Marine & Leadbetter,9335,W,FS,1,7,8,0,Spring2018
5957,SW Canyon & Camelot Ct,9338,N,NS,49,13,62,19,Spring2018
5958,NE 33rd Dr & Sunderland,9339,N,OP,0,0,0,0,Spring2018
5959,NE 15th & Halsey,9342,N,NS,26,38,64,25,Spring2018
5960,W Powell & NW Miller,9347,W,FS,17,5,22,6,Spring2018
5961,NW 185th & Rock Creek,9351,S,FS,67,9,76,4,Spring2018
5962,SW Boones Ferry Rd & Avery,9352,S,FS,1,3,4,0,Spring2018
5963,SW Boones Ferry Rd & Avery,9353,N,FS,6,0,6,0,Spring2018
5964,W Burnside & SW Osage,9354,E,NS,58,50,108,10,Spring2018
5965,NE Multnomah & 3rd,9362,E,OP,20,45,65,8,Spring2018
5966,NE 33rd Dr & Elrod Dr,9365,N,NS,0,11,11,0,Spring2018
5967,9600 Block NE Sunderland,9367,S,AT,1,1,2,2,Spring2018
5968,NE Sunderland & Columbia River Corr Cntr,9368,S,AT,68,58,126,28,Spring2018
5969,NE 33rd Dr & Elrod Dr,9369,S,NS,19,0,19,0,Spring2018
5970,2400 Block NE Riverside Way,9371,W,AT,9,0,9,0,Spring2018
5971,SE Powell Valley & Barnes Flag Stop,9383,W,AT,0,0,0,0,Spring2018
5972,SW 1st & Arthur,9397,S,NS,8,5,13,1,Spring2018
5973,N Going & Port Center Way,9399,E,NS,37,3,40,2,Spring2018
5974,NE 21st & Riverside Way,9402,S,FS,6,0,6,0,Spring2018
5975,N Killingsworth & Greeley,9403,E,FS,44,4,48,5,Spring2018
5976,NW 23rd Place & Westover,9404,N,NS,0,0,0,0,Spring2018
5977,SW Hamilton & 55th Pl,9405,E,OP,1,0,1,0,Spring2018
5978,SW Boones Ferry Rd & 13th Ct,9406,W,NS,0,1,1,0,Spring2018
5979,SW Boones Ferry Rd & 13th Ct,9407,E,FS,1,0,1,0,Spring2018
5980,Exceed Enterprises,9412,S,AT,6,8,14,41,Spring2018
5981,NE Sunderland & 33rd Dr (In),9414,E,NS,1,0,1,0,Spring2018
5982,NW Division & Angeline,9425,W,OP,10,5,15,3,Spring2018
5989,NW Division & Angeline,9426,E,NS,4,9,13,1,Spring2018
5990,SW 257th & Jennings Way,9427,E,NS,1,2,3,0,Spring2018
5991,SW 257th & Jennings Way,9428,W,OP,9,2,11,0,Spring2018
5992,SE Main & E 1st,9429,N,NS,2,0,2,0,Spring2018
5993,NE Main & E 1st,9430,S,NS,0,3,3,0,Spring2018
5994,N Lombard & Catlin,9431,N,NS,2,46,48,3,Spring2018
5995,N Lombard & Weyerhauser,9432,N,FS,0,24,24,1,Spring2018
5996,14500 Block N Lombard,9434,N,AT,2,2,4,0,Spring2018
5997,N Lombard & Catlin,9435,S,NS,45,1,46,3,Spring2018
5998,10200 Block N Lombard,9436,S,AT,24,0,24,1,Spring2018
5999,NE Vancouver Way & Freightliner,9438,N,FS,1,9,10,0,Spring2018
6000,N Marine & Leadbetter,9439,E,NS,1,2,3,0,Spring2018
6001,N Marine & Bybee Lake Road,9440,E,FS,0,0,0,0,Spring2018
6002,6100 Block N Marine,9441,E,AT,1,0,1,0,Spring2018
6003,5300 Block N Marine,9442,E,OP,0,0,0,0,Spring2018
6004,N Marine & Gantenbein,9444,E,OP,0,0,0,0,Spring2018
6005,NE 6th Drive & South Shore,9447,S,FS,0,0,0,0,Spring2018
6006,9000 Block NE Vancouver Way,9449,W,AT,50,13,63,4,Spring2018
6007,NE Middlefield & 6th Drive,9451,E,NS,0,0,0,0,Spring2018
6008,NE 6th Drive & Faloma,9453,N,NS,1,1,2,0,Spring2018
6009,N Marine & Gantenbein,9454,W,NS,0,0,0,0,Spring2018
6010,N Marine & Anchor,9455,W,NS,1,0,1,0,Spring2018
6011,6100 Block N Marine,9457,W,AT,0,2,2,0,Spring2018
6012,N Marine & Bybee Lake Road,9458,W,NS,0,2,2,0,Spring2018
6013,N Marine & Pacific Gateway Blvd,9459,W,FS,1,3,4,0,Spring2018
6014,14500 Block N Lombard,9460,S,OP,0,3,3,0,Spring2018
6015,SW Hocken & Millikan,9462,S,NS,6,12,18,6,Spring2018
6016,13500 Block SW Millikan,9463,W,AT,3,5,8,1,Spring2018
6017,13900 Block SW Millikan,9464,W,AT,3,2,5,0,Spring2018
6018,14100 Block SW Millikan,9465,E,OP,1,2,3,0,Spring2018
6019,13900 Block SW Millikan,9466,E,OP,3,4,7,0,Spring2018
6020,NW 185th & Bronson,9467,N,FS,11,52,63,2,Spring2018
6021,13900 Block SW 72nd,9469,E,AT,0,1,1,0,Spring2018
6022,NW Graham/257th & 257th Way,9470,N,FS,0,20,20,2,Spring2018
6023,NW Graham/257th & 257th Way,9471,S,OP,26,1,27,1,Spring2018
6024,900 Block NW North Frontage Rd,9472,W,AT,0,4,4,0,Spring2018
6025,NE Middlefield Rd & N Vancouver Way,9477,N,FS,19,6,25,0,Spring2018
6026,1000 Block N Marine,9478,E,AT,0,1,1,0,Spring2018
6027,NE Vancouver Way & Gertz Rd,9480,S,FS,52,8,60,21,Spring2018
6028,1100 Block NW Frontage Rd,9481,E,AT,123,116,239,24,Spring2018
6029,9400 Block SW Commerce Circle,9484,W,AT,0,4,4,0,Spring2018
6030,SE 122nd & Schiller,9487,N,FS,17,2,19,10,Spring2018
6031,3505 SW US Veterans Rd,9488,W,OP,42,30,72,1,Spring2018
6032,5500 Block SE International Way,9503,S,AT,1,1,2,0,Spring2018
6033,N Lombard & New York,9505,S,NS,118,14,132,25,Spring2018
6034,13900 Block SW 72nd,9509,W,OP,2,0,2,0,Spring2018
6035,SW Boones Ferry Rd & Iowa Dr,9511,N,FS,5,0,5,0,Spring2018
6042,SW Boones Ferry Rd & Iowa Dr,9512,S,FS,1,6,7,0,Spring2018
6043,Beavercreek & Molalla,9516,E,NS,5,25,30,7,Spring2018
6044,Beavercreek & Library Ct,9517,N,OP,54,9,63,10,Spring2018
6045,20300 Block SW Pacific Hwy,9519,W,AT,0,3,3,0,Spring2018
6046,SE Eagle Creek Rd & Hinman,9520,N,NS,0,0,0,0,Spring2018
6047,SE Eagle Creek Rd & Strubhar Lane,9521,S,FS,0,0,0,0,Spring2018
6048,SW Garden Home & Orchard Lane,9525,S,NS,1,2,3,0,Spring2018
6049,W Burnside & SW 2nd,9526,E,NS,409,211,620,171,Spring2018
6050,SW Barnes & NW 118th,9531,W,NS,10,31,41,1,Spring2018
6051,SW Barnes & 117th,9532,E,NS,8,7,15,5,Spring2018
6052,5200 Block NE 148th (Relay Resources),9537,S,AT,1,0,1,0,Spring2018
6053,SW Laurelwood & Laurel,9544,S,FS,1,59,60,0,Spring2018
6054,Lake Oswego Transit Center,9545,E,NS,36,131,167,19,Spring2018
6055,NE Fremont & Sandy,9548,E,NS,6,6,12,1,Spring2018
6056,NE Riverside Way & 33rd Dr,9549,W,FS,21,0,21,1,Spring2018
6057,2800 Block NE Riverside Way,9550,E,AT,0,9,9,0,Spring2018
6058,SW Salmon & 18th,9552,W,NS,70,12,82,1,Spring2018
6059,W Burnside & NW 23rd Pl,9555,W,FS,22,43,65,5,Spring2018
6060,Linn & Williams,9559,S,OP,5,34,39,7,Spring2018
6061,29200 Block SE Eagle Creek Rd,9561,S,AT,0,0,0,0,Spring2018
6062,29200 Block SE Eagle Creek Rd,9562,N,OP,0,0,0,0,Spring2018
6063,NE Cornell & 48th,9564,W,FS,11,8,19,1,Spring2018
6064,SW Durham & 72nd,9565,E,NS,1,8,9,0,Spring2018
6065,8800 Block SW Oleson,9570,E,OP,1,0,1,0,Spring2018
6066,N Lombard & Reno,9575,S,NS,82,1,83,3,Spring2018
6067,N Lombard & Reno,9576,N,NS,0,78,78,13,Spring2018
6068,1700 Block Beavercreek Rd,9578,W,AT,8,1,9,3,Spring2018
6069,1600 Block Beavercreek Rd,9579,W,AT,4,0,4,1,Spring2018
6070,Beavercreek & Hwy 213,9580,W,FS,18,2,20,1,Spring2018
6071,1600 Block Beavercreek Rd,9581,E,AT,1,10,11,3,Spring2018
6072,2000 Block Beavercreek Rd,9582,E,AT,0,8,8,1,Spring2018
6073,Beavercreek & Hwy 213,9583,E,NS,0,6,6,1,Spring2018
6074,SW Pacific Hwy & Royalty Parkway,9597,N,FS,57,7,64,10,Spring2018
6075,SW Morrison & 12th,9598,W,NS,52,27,79,17,Spring2018
6076,SW Morrison & 17th,9599,W,FS,185,63,248,18,Spring2018
6077,SW 11th & Alder,9600,S,NS,96,202,298,76,Spring2018
6078,NW Evergreen Pkwy & NE 79th (NW 215th),9601,W,NS,7,3,10,0,Spring2018
6079,NW Evergreen Pkwy & NE 79th (NW 215th),9602,E,NS,2,15,17,0,Spring2018
6080,2500 Block NE Century (NW 229th),9603,N,AT,5,29,34,0,Spring2018
6081,2500 Block NE Century (NW 229th),9604,S,AT,26,7,33,0,Spring2018
6082,NE 25th & Sunrise Lane,9606,N,OP,1,0,1,0,Spring2018
6083,NE 25th & Sunrise Lane,9607,S,NS,1,0,1,0,Spring2018
6084,Willow Creek Transit Center,9610,E,AT,505,193,698,65,Spring2018
6085,NE 57th & Failing,9611,N,NS,1,8,9,0,Spring2018
6086,SW Morrison & 16th,9613,W,NS,79,29,108,5,Spring2018
6087,NE Century (NW 229th) & Butler,9614,N,NS,3,6,9,0,Spring2018
6088,6400 Block SE Lake,9615,N,AT,1,1,2,1,Spring2018
6095,NE 105th & Marx,9619,N,NS,0,2,2,0,Spring2018
6096,Willow Creek Transit Center,9621,E,AT,217,186,403,60,Spring2018
6097,SW Murray & NW Milburn,9623,N,NS,5,8,13,0,Spring2018
6098,Sunset TC MAX Station,9624,W,AT,606,2325,2931,0,Spring2018
6099,Sunset Transit Center,9625,W,AT,251,270,521,90,Spring2018
6100,SW Barnes & Cedar Hills Blvd,9627,E,FS,30,40,70,20,Spring2018
6101,SW Barnes & Cedar Hills Blvd,9628,W,NS,35,34,69,13,Spring2018
6102,SW Hamilton & 58th,9634,W,FS,0,1,1,0,Spring2018
6103,N Portsmouth & Willamette,9635,S,NS,58,68,126,3,Spring2018
6104,NE 223rd & Glisan,9636,S,FS,22,5,27,8,Spring2018
6105,SW Tualatin-Sherwood Rd & Pacific Hwy,9639,N,NS,82,2,84,3,Spring2018
6106,SE Hwy 224 & Sherman Cooper,9640,E,NS,1,1,2,0,Spring2018
6107,SE Hwy 224 & Sherman Cooper,9641,W,OP,0,1,1,0,Spring2018
6108,NE 122nd & Multnomah,9642,S,OP,43,10,53,15,Spring2018
6109,1700 Block SE Orient Dr,9644,N,AT,1,0,1,0,Spring2018
6110,SW Pacific Hwy & 74th (Park & Ride),9648,E,FS,151,41,192,6,Spring2018
6111,Washington Square Transit Center,9649,N,AT,225,224,449,49,Spring2018
6112,Washington Square Transit Center,9650,N,AT,263,261,524,52,Spring2018
6113,Washington Square Transit Center,9651,N,AT,307,278,585,35,Spring2018
6114,Washington Square Transit Center,9652,S,AT,257,301,558,62,Spring2018
6115,SW Hart & Forest Dr,9663,W,NS,5,12,17,1,Spring2018
6116,SW Hart & Dunsmuir,9664,W,OP,1,2,3,0,Spring2018
6117,SW Hart & 155th,9665,W,FS,4,4,8,0,Spring2018
6118,SW Hart & 160th,9667,W,NS,6,11,17,0,Spring2018
6119,SW Hart & 165th,9668,W,OP,4,16,20,0,Spring2018
6120,SW Bany & Tallac Way,9669,W,OP,5,16,21,0,Spring2018
6121,SW 170th & Canby,9670,N,NS,6,2,8,0,Spring2018
6122,SW 170th & Ivy Glenn,9671,N,NS,1,4,5,0,Spring2018
6123,SW 170th & Oak,9672,N,FS,4,6,10,0,Spring2018
6124,SW 170th & Rosa Place,9673,N,FS,1,2,3,0,Spring2018
6125,SW Farmington & 185th,9674,W,NS,19,23,42,5,Spring2018
6126,SW 170th & Ivy Glenn,9675,S,NS,5,1,6,0,Spring2018
6127,SW 170th & Rosa Place,9676,S,OP,1,1,2,0,Spring2018
6128,SW 170th & Oak,9677,S,FS,6,5,11,0,Spring2018
6129,SW 170th & Cynthia,9678,S,NS,4,5,9,0,Spring2018
6130,SW Bany & Tallac Way,9679,E,FS,14,4,18,0,Spring2018
6131,SW Hart & 165th,9680,E,FS,19,5,24,0,Spring2018
6132,SW Hart & 161st,9681,E,FS,5,3,8,0,Spring2018
6133,SW Hart & 157th,9682,E,FS,7,4,11,0,Spring2018
6134,SW Hart & 155th,9683,E,FS,4,3,7,0,Spring2018
6135,SW Hart & Dunsmuir,9684,E,FS,2,1,3,0,Spring2018
6136,SW Arctic Dr & Western Ave,9685,E,FS,0,6,6,0,Spring2018
6137,SW Arctic Drive & Harvest Court,9686,S,OP,0,17,17,0,Spring2018
6138,SW Allen & Lombard,9687,E,FS,1,3,4,2,Spring2018
6139,SW Allen & King,9688,E,NS,2,4,6,0,Spring2018
6140,10400 Block SW Allen,9689,E,AT,39,2,41,0,Spring2018
6141,SW Arctic Drive & Sunshine Court,9694,N,NS,9,2,11,0,Spring2018
6148,SW Arctic Drive & Harvest Court,9695,N,FS,6,1,7,0,Spring2018
6149,SW Arctic Dr & Western Ave,9696,W,NS,3,0,3,0,Spring2018
6150,SW 5th & Western,9697,W,FS,1,1,2,0,Spring2018
6151,10900 Block SW 5th,9698,W,OP,4,1,5,0,Spring2018
6152,10900 Block SW 5th,9699,E,AT,2,4,6,0,Spring2018
6153,SW 5th & Western,9700,E,NS,0,0,0,0,Spring2018
6154,SW Arctic Drive & Allen,9701,S,NS,2,11,13,0,Spring2018
6155,10500 Block SW Allen,9703,W,AT,0,19,19,0,Spring2018
6156,SW Allen & King,9704,W,NS,5,1,6,0,Spring2018
6157,5000 Block SW Griffith Drive,9705,N,AT,3,1,4,0,Spring2018
6158,4800 Block SW Griffith Drive,9706,N,AT,0,0,0,0,Spring2018
6159,4900 Block SW Griffith Drive,9707,E,AT,0,3,3,0,Spring2018
6160,SW Morrison & 14th,9708,W,NS,48,27,75,7,Spring2018
6161,NE Glisan & 28th,9709,W,FS,66,57,123,10,Spring2018
6162,18600 Block NE Sandy,9715,E,FS,2,3,5,0,Spring2018
6163,19000 Block NE Sandy (East Entrance),9716,E,NS,2,2,4,0,Spring2018
6164,21100 Block NE Sandy,9717,E,AT,3,4,7,1,Spring2018
6165,NE Sandy & 201st,9718,E,FS,26,19,45,11,Spring2018
6166,NE Sandy & 205th,9719,E,FS,35,25,60,9,Spring2018
6167,21100 Block NE Sandy,9722,W,OP,5,4,9,1,Spring2018
6168,NE Sandy & 206th Pl,9723,W,FS,27,31,58,8,Spring2018
6169,NE Sandy & 201st,9724,W,NS,16,24,40,23,Spring2018
6170,19000 Block NE Sandy (East Entrance),9725,W,OP,3,1,4,0,Spring2018
6171,18600 Block NE Sandy,9726,W,NS,1,1,2,0,Spring2018
6172,Beavercreek & Fir,9755,W,NS,3,1,4,1,Spring2018
6173,NE Sandy & 42nd,9756,W,FS,157,95,252,72,Spring2018
6174,Providence Park MAX Station,9757,W,AT,1077,1704,2781,0,Spring2018
6175,Providence Park MAX Station,9758,E,AT,1272,1021,2293,0,Spring2018
6176,Kings Hill/SW Salmon St MAX Station,9759,N,AT,313,397,710,0,Spring2018
6177,SW Apple Way & Laurelwood,9760,E,NS,1,0,1,0,Spring2018
6178,SW 78th & Westmoor,9761,N,FS,0,0,0,0,Spring2018
6179,SW 78th & Brentwood,9762,N,NS,0,0,0,0,Spring2018
6180,SW Brentwood & Laurelwood,9763,W,NS,0,0,0,0,Spring2018
6181,SW Laurelwood & Beaverton-Hillsdale Hwy,9764,S,NS,0,0,0,0,Spring2018
6182,8500 Block SW Apple Way,9765,S,FS,0,0,0,0,Spring2018
6183,NE 223rd & Glisan,9766,N,NS,4,25,29,10,Spring2018
6184,NE 223rd & Park Lane,9767,S,FS,34,17,51,14,Spring2018
6185,NE 223rd & Park Lane,9772,N,FS,16,30,46,20,Spring2018
6186,1400 Block NE 223rd,9773,N,AT,3,7,10,0,Spring2018
6187,NE Sandy & 223rd,9775,E,FS,6,12,18,0,Spring2018
6188,NE Sandy & 223rd,9776,W,FS,9,11,20,0,Spring2018
6189,SW Denney & King,9781,W,FS,4,1,5,0,Spring2018
6190,SW Lombard & Camden,9782,N,NS,2,1,3,0,Spring2018
6191,SW Lombard & Camden,9785,S,NS,1,2,3,0,Spring2018
6192,NE Century (NW 229th) & Evergreen Pkwy,9790,S,FS,10,2,12,0,Spring2018
6193,NE Century (NW 229th) & Evergreen Pkwy,9791,N,NS,4,13,17,0,Spring2018
6194,SE Stark & SW Sundial,9792,W,FS,28,29,57,42,Spring2018
6201,NW Cornell & 158th,9793,W,OP,7,28,35,1,Spring2018
6202,NW Eastman & Division,9795,S,FS,3,1,4,1,Spring2018
6203,SW Barnes & Cedar Hills Blvd,9808,W,FS,1,0,1,0,Spring2018
6204,19000 Block NE Sandy,9811,E,AT,2,5,7,0,Spring2018
6205,Beaverton TC MAX Station,9818,S,AT,1610,1720,3330,0,Spring2018
6206,Beaverton Creek MAX Station,9819,N,AT,140,721,861,0,Spring2018
6207,Kings Hill/SW Salmon St MAX Station,9820,S,AT,314,333,647,0,Spring2018
6208,Beaverton TC MAX Station,9821,N,AT,2915,3221,6136,0,Spring2018
6209,Beaverton Creek MAX Station,9822,S,AT,756,122,878,0,Spring2018
6210,Beaverton Central MAX Station,9823,W,AT,392,417,809,0,Spring2018
6211,Beaverton Central MAX Station,9824,E,AT,430,427,857,0,Spring2018
6212,Millikan Way MAX Station,9825,W,AT,421,1024,1445,0,Spring2018
6213,Millikan Way MAX Station,9826,E,AT,1083,390,1473,0,Spring2018
6214,Merlo Rd/SW 158th Ave MAX Station,9827,W,AT,216,610,826,0,Spring2018
6215,Merlo Rd/SW 158th Ave MAX Station,9828,E,AT,585,215,800,0,Spring2018
6216,Elmonica/SW 170th Ave MAX Station,9829,W,AT,310,1119,1429,0,Spring2018
6217,Elmonica/SW 170th Ave MAX Station,9830,E,AT,1110,261,1371,0,Spring2018
6218,Willow Creek/SW 185th Ave TC MAX Station,9831,E,AT,1263,484,1747,0,Spring2018
6219,Willow Creek/SW 185th Ave TC MAX Station,9832,W,AT,539,1284,1823,0,Spring2018
6220,Quatama MAX Station,9833,W,AT,257,1070,1327,0,Spring2018
6221,Quatama MAX Station,9834,E,AT,1147,255,1402,0,Spring2018
6222,Orenco MAX Station,9835,E,AT,918,299,1217,0,Spring2018
6223,Orenco MAX Station,9836,W,AT,305,916,1221,0,Spring2018
6224,Fair Complex/Hillsboro Airport MAX Stn,9837,W,AT,111,740,851,0,Spring2018
6225,Fair Complex/Hillsboro Airport MAX Stn,9838,E,AT,736,106,842,0,Spring2018
6226,Hawthorn Farm MAX Station,9839,E,AT,276,96,372,0,Spring2018
6227,Hawthorn Farm MAX Station,9840,W,AT,91,283,374,0,Spring2018
6228,Washington/SE 12th Ave MAX Station,9841,E,AT,363,114,477,0,Spring2018
6229,Washington/SE 12th Ave MAX Station,9842,W,AT,105,352,457,0,Spring2018
6230,Tuality Hospital/SE 8th Ave MAX Station,9843,E,AT,392,74,466,0,Spring2018
6231,Tuality Hospital/SE 8th Ave MAX Station,9844,W,AT,63,391,454,0,Spring2018
6232,Hillsboro Central/SE 3rd TC MAX Station,9845,W,AT,43,889,932,0,Spring2018
6233,Hillsboro Central/SE 3rd TC MAX Station,9846,E,AT,751,51,802,0,Spring2018
6234,Hatfield Government Center MAX Station,9848,S,AT,1088,948,2036,0,Spring2018
6235,SW Baseline & Dennis,9850,W,NS,18,19,37,8,Spring2018
6236,NE Century (NW 229th) & Rosebay Dr,9851,S,NS,2,2,4,0,Spring2018
6237,19000 Block NE Sandy,9853,W,OP,5,1,6,0,Spring2018
6238,W Burnside & SW 18th,9860,E,NS,164,41,205,69,Spring2018
6239,SW Terwilliger & Sam Jackson,9861,N,NS,5,28,33,1,Spring2018
6240,1100 Block N Hayden Meadows Dr,9862,N,NS,56,23,79,43,Spring2018
6241,Willow Creek Transit Center,9869,E,AT,180,523,703,70,Spring2018
6242,Willow Creek Transit Center,9871,E,AT,10,23,33,2,Spring2018
6243,7600 Block SW Barnes,9872,W,OP,3,8,11,0,Spring2018
6244,600 Block NW Naito Parkway,9873,N,AT,3,2,5,3,Spring2018
6245,900 Block NW Naito Parkway,9874,N,OP,3,4,7,4,Spring2018
6246,NW Naito Parkway & 9th,9875,N,OP,8,5,13,1,Spring2018
6247,NW Front & 15th,9877,N,FS,7,10,17,0,Spring2018
6254,NW Front & 17th,9878,N,FS,8,16,24,0,Spring2018
6255,NW Front & 21st,9879,N,OP,1,5,6,0,Spring2018
6256,NW Front & Nicolai,9880,N,FS,5,17,22,0,Spring2018
6257,3000 Block NW Front,9881,N,OP,0,16,16,0,Spring2018
6258,900 Block NW Naito Parkway,9889,S,AT,6,5,11,8,Spring2018
6259,NW Naito Parkway & 9th,9890,S,FS,6,16,22,1,Spring2018
6260,NW Front & 17th,9893,S,NS,26,15,41,0,Spring2018
6261,NW Front & 21st,9894,S,NS,2,1,3,0,Spring2018
6262,NW Front & Nicolai,9896,S,NS,13,6,19,0,Spring2018
6263,NE Evergreen & 13th,9920,W,OP,0,1,1,0,Spring2018
6264,NE Evergreen & NW Jackson School Rd N,9921,W,FS,0,0,0,0,Spring2018
6265,NE Orenco Station Loop & MAX Station,9923,E,AT,140,51,191,6,Spring2018
6266,300 Block E Main,9931,W,AT,1,0,1,0,Spring2018
6267,E Main & N 1st,9933,W,NS,2,0,2,0,Spring2018
6268,N 1st & NE Edison,9935,N,NS,0,1,1,0,Spring2018
6269,N 1st & NE Grant,9936,N,NS,0,0,0,0,Spring2018
6270,N 1st & NE Tiffany,9937,N,FS,0,0,0,0,Spring2018
6271,2800 Block NW Glencoe,9938,N,OP,2,12,14,0,Spring2018
6272,NW Glencoe & NE Cory,9939,N,FS,2,3,5,0,Spring2018
6273,NW Glencoe & NE Lenox,9940,N,NS,3,5,8,0,Spring2018
6274,NW Glencoe & NE Milne,9941,N,NS,0,1,1,0,Spring2018
6275,NE Evergreen & NW Glencoe,9942,E,FS,0,0,0,0,Spring2018
6276,NE Evergreen & 3rd,9943,E,NS,1,1,2,0,Spring2018
6277,NE Evergreen & Sunburst,9944,E,NS,0,0,0,0,Spring2018
6278,NE Evergreen & Jackson School Rd,9945,E,NS,0,1,1,0,Spring2018
6279,NE Evergreen & Jackson Road Loop,9946,E,NS,0,0,0,0,Spring2018
6280,NE Evergreen & 13th,9947,E,NS,1,1,2,0,Spring2018
6281,NE 15th & Jones Farm Pkwy,9948,S,NS,4,2,6,0,Spring2018
6282,NE Griffin Oaks & 15th,9949,E,FS,4,3,7,0,Spring2018
6283,1800 Block NE Griffin Oaks,9950,E,AT,2,0,2,0,Spring2018
6284,2200 Block NE Griffin Oaks,9951,E,AT,2,1,3,0,Spring2018
6285,NE 25th & Kathryn,9952,S,NS,1,0,1,0,Spring2018
6286,Fair Complex/Airport Park & Ride,9953,E,AT,40,43,83,33,Spring2018
6287,Hillsboro Transit Center,9954,E,AT,59,16,75,3,Spring2018
6288,Hillsboro Transit Center,9955,E,AT,277,405,682,82,Spring2018
6289,Hillsboro Transit Center,9956,E,AT,186,76,262,16,Spring2018
6290,Millikan Way MAX Station/Park and Ride,9957,W,AT,68,239,307,20,Spring2018
6291,Millikan Way MAX Station/Park and Ride,9958,W,AT,195,80,275,31,Spring2018
6292,NE Shaver & Parkrose HS,9959,W,AT,32,7,39,0,Spring2018
6293,NE 34th & Cornell,9962,N,NS,0,1,1,0,Spring2018
6294,NE 25th & Kathryn,9963,N,OP,0,2,2,0,Spring2018
6295,NE Griffin Oaks & 15th,9965,W,NS,3,1,4,0,Spring2018
6296,1800 Block NE Griffin Oaks,9966,W,OP,0,3,3,0,Spring2018
6297,NE 15th & Jones Farm Pkwy,9967,N,OP,3,3,6,0,Spring2018
6298,Sunset TC MAX Station,9969,E,AT,2291,506,2797,0,Spring2018
6299,Sunset Transit Center,9970,W,AT,119,60,179,32,Spring2018
6300,Sunset Transit Center,9971,W,AT,70,100,170,1,Spring2018
6307,Sunset Transit Center,9972,W,AT,18,23,41,0,Spring2018
6308,Sunset Transit Center,9975,W,AT,52,156,208,38,Spring2018
6309,Beaverton Transit Center,9976,S,AT,279,259,538,58,Spring2018
6310,Beaverton Transit Center,9977,E,AT,188,214,402,4,Spring2018
6311,Beaverton Transit Center,9978,S,AT,403,338,741,146,Spring2018
6312,Beaverton Transit Center,9979,N,AT,447,385,832,82,Spring2018
6313,Beaverton Transit Center,9981,S,AT,531,27,558,99,Spring2018
6314,Beaverton Transit Center,9982,S,AT,545,37,582,114,Spring2018
6315,Beaverton Transit Center,9983,S,AT,142,150,292,27,Spring2018
6316,Beaverton Transit Center,9984,N,AT,961,796,1757,171,Spring2018
6317,Beaverton Transit Center,9985,S,AT,392,359,751,63,Spring2018
6318,Beaverton Transit Center,9986,S,AT,562,477,1039,80,Spring2018
6319,NE Evergreen & Jackson School Rd S,9987,W,OP,1,1,2,0,Spring2018
6320,NE Evergreen & Sunburst,9988,W,OP,0,0,0,0,Spring2018
6321,NE Evergreen & 3rd,9989,W,OP,1,0,1,0,Spring2018
6322,30900 Block NE Evergreen,9990,W,OP,0,0,0,0,Spring2018
6323,2800 Block NW Glencoe,9991,S,AT,12,1,13,0,Spring2018
6324,NW Glencoe & Cory,9992,S,FS,5,1,6,0,Spring2018
6325,3100 Block NW Glencoe,9993,S,AT,10,1,11,0,Spring2018
6326,NW Glencoe & Milne,9994,S,NS,2,0,2,0,Spring2018
6327,N 1st & NW Garibaldi,9995,S,NS,0,0,0,0,Spring2018
6328,N 1st & NW Tiffany,9996,S,NS,1,0,1,0,Spring2018
6329,300 Block N 1st,9997,S,AT,0,0,0,1,Spring2018
6330,NE Lincoln & 2nd,9998,E,NS,0,3,3,0,Spring2018
6331,NE 3rd & E Main,10000,S,NS,0,2,2,0,Spring2018
6332,5400 Block NE Dawson Creek,10001,W,AT,1,0,1,0,Spring2018
6333,NE Evergreen & Brookwood,10004,E,NS,1,3,4,0,Spring2018
6334,3100 Block NE Dawson Creek,10005,N,AT,2,4,6,33,Spring2018
6335,SE 223rd & Stark,10006,S,FS,12,59,71,7,Spring2018
6336,600 Block SE 223rd,10007,N,AT,5,7,12,3,Spring2018
6337,NW Cornell & 192nd,10008,W,OP,7,20,27,3,Spring2018
6338,NW Cornell & NE Amberglen (NW 194th),10009,W,FS,14,12,26,2,Spring2018
6339,NW Cornell & NE Overlook (NW Amberbrook),10010,W,NS,5,9,14,2,Spring2018
6340,NW Cornell & NE John Olsen,10011,W,NS,14,14,28,1,Spring2018
6341,NW Cornell & NE Aloclek,10013,W,FS,3,6,9,0,Spring2018
6342,NE Cornell & Cornelius Pass,10014,W,FS,2,7,9,1,Spring2018
6343,NE Cornell & Butler,10015,S,FS,9,11,20,4,Spring2018
6344,NE Cornell & Walbridge,10016,W,FS,7,4,11,1,Spring2018
6345,NW Cornell & NE Amberglen (NW Amberwood),10021,E,NS,18,20,38,2,Spring2018
6346,NW Cornell & NE Overlook (NW Amberbrook),10022,E,NS,6,3,9,2,Spring2018
6347,NW Cornell & NE John Olsen (NW 206th),10023,E,NS,20,11,31,1,Spring2018
6348,NW Cornell & 192nd,10024,E,NS,13,3,16,0,Spring2018
6349,NW Cornell & NE Aloclek,10025,E,FS,3,5,8,0,Spring2018
6350,NE Cornell & 25th,10026,E,FS,18,20,38,5,Spring2018
6351,NE Cornell & 48th,10028,E,NS,7,10,17,2,Spring2018
6352,NW Cornell & NE Cornelius Pass,10029,E,FS,4,3,7,0,Spring2018
6353,NE Cornell & Butler,10030,E,NS,13,18,31,5,Spring2018
6360,NE Cornell & NW Walbridge,10031,E,NS,5,7,12,2,Spring2018
6361,NE Cornell & Stucki (NW Amberglen),10032,E,FS,30,16,46,9,Spring2018
6362,NE Century (NW 231st) & Alder/Orenco Stn,10033,N,FS,6,23,29,1,Spring2018
6363,4100 Block SW 110th,10035,S,OP,55,0,55,0,Spring2018
6364,4200 Block SW 110th,10036,N,AT,1,56,57,0,Spring2018
6365,10200 Block SW Park Way,10037,W,AT,1,0,1,0,Spring2018
6366,NE Century (NW 231st) & Carillion,10041,S,NS,1,4,5,1,Spring2018
6367,NE Century (NW 231st) & Orenco Max Stn,10042,S,NS,27,100,127,5,Spring2018
6368,NE Century (NW 231st) & Dogwood,10043,S,NS,0,2,2,0,Spring2018
6369,NE Century (NW 231st) & Orenco Ridge,10044,S,FS,0,6,6,0,Spring2018
6370,E Main (W Baseline) & SE 58th Ct,10045,W,OP,0,2,2,0,Spring2018
6371,E Main (W Baseline) & NE 53rd,10046,W,NS,9,11,20,1,Spring2018
6372,E Main (W Baseline) & NE 49th,10047,W,NS,2,1,3,0,Spring2018
6373,E Main (W Baseline) & SE 58th Ct,10049,E,NS,2,0,2,0,Spring2018
6374,E Main (W Baseline) & NE 53rd,10050,E,NS,12,12,24,0,Spring2018
6375,E Main (W Baseline) & NE 49th,10051,E,NS,2,1,3,0,Spring2018
6376,NE Century (NW 231st) & Campus Way,10052,N,NS,3,1,4,0,Spring2018
6377,NE Century (NW 231st) & Dogwood,10053,N,NS,1,0,1,0,Spring2018
6378,NE Century (NW 231st) & Deer Run,10054,N,FS,5,1,6,0,Spring2018
6379,NE Evergreen Pkwy & 106th (NW 188th),10056,E,NS,12,33,45,6,Spring2018
6380,Dawson Creek & Brookwood,10061,N,FS,2,3,5,0,Spring2018
6381,Shute Rd & Dawson Creek Dr,10063,S,NS,2,1,3,0,Spring2018
6382,NW 31st & Guam,10071,S,NS,0,20,20,0,Spring2018
6383,3300 Block NW Guam,10072,W,AT,1,5,6,0,Spring2018
6384,NW Guam & 35th,10073,W,NS,0,20,20,1,Spring2018
6385,3300 Block NW 35th,10074,N,AT,1,8,9,0,Spring2018
6386,NW Kaiser & Snowlily Dr,10076,N,NS,0,3,3,0,Spring2018
6387,NW Kaiser & Two Ponds Dr,10077,N,FS,5,9,14,0,Spring2018
6388,15500 Block NW Springville,10078,W,AT,0,1,1,0,Spring2018
6389,NW Springville & 160th,10079,W,FS,2,7,9,0,Spring2018
6390,NW Springville & Sickle Terrace,10080,W,FS,0,7,7,9,Spring2018
6391,NW Springville & Joss,10081,W,NS,0,5,5,0,Spring2018
6392,NW Springville & Samuel Drive,10082,W,OP,0,1,1,0,Spring2018
6393,NW Springville & 173rd,10083,W,OP,0,4,4,0,Spring2018
6394,NW Bethany & Cornell,10084,N,FS,19,21,40,2,Spring2018
6395,NW Bethany & Bronson,10085,N,FS,4,17,21,1,Spring2018
6396,NW Bethany & Oak Hills Dr,10086,N,NS,3,7,10,0,Spring2018
6397,NW Bethany & Telshire Terrace,10087,N,NS,2,1,3,0,Spring2018
6398,NW Bethany & Ridgetop Lane,10088,N,NS,3,2,5,0,Spring2018
6399,NW Bethany & West Union,10089,N,FS,3,9,12,0,Spring2018
6400,NW Bethany & Saint Andrews,10090,N,FS,0,2,2,0,Spring2018
6401,NW Bethany & Mitchell,10091,N,NS,3,4,7,0,Spring2018
6402,4700 Block NW Bethany,10092,N,AT,7,44,51,4,Spring2018
6403,NW Bethany & Laidlaw,10093,N,NS,4,24,28,2,Spring2018
6404,NW Bethany & Kaiser Rd,10094,N,NS,9,7,16,0,Spring2018
6405,Pier Park,10095,E,AT,89,73,162,18,Spring2018
6406,NW Springville & Kaiser Rd,10098,E,NS,6,4,10,0,Spring2018
6413,NW Springville & Oats Terrace,10099,E,NS,8,2,10,0,Spring2018
6414,NW Springville & Sickle Terrace,10100,E,NS,3,0,3,0,Spring2018
6415,NW Springville & 165th Terrace,10101,E,OP,6,0,6,0,Spring2018
6416,NW Springville & Samuel Drive,10102,E,NS,1,0,1,0,Spring2018
6417,NW Springville & 173rd,10103,E,NS,6,1,7,0,Spring2018
6418,NW Kaiser & Westbrook,10104,S,NS,3,2,5,0,Spring2018
6419,NW Kaiser & Graf St,10105,S,NS,9,3,12,0,Spring2018
6420,NW Bethany & Wismer,10106,S,FS,9,7,16,0,Spring2018
6421,NW Bethany & Laidlaw,10107,S,NS,55,20,75,1,Spring2018
6422,4700 Block NW Bethany,10108,S,OP,33,8,41,4,Spring2018
6423,NW Bethany & Claremont Dr,10109,S,NS,4,2,6,0,Spring2018
6424,NW Bethany & Saint Andrews,10110,S,NS,1,0,1,0,Spring2018
6425,NW Bethany & West Union,10111,S,NS,9,2,11,0,Spring2018
6426,NW Bethany & Ridgetop Lane,10112,S,FS,2,2,4,1,Spring2018
6427,NW Bethany & Telshire Terrace,10113,S,FS,1,1,2,0,Spring2018
6428,NW Bethany & Oak Hills Dr,10114,S,FS,9,5,14,0,Spring2018
6429,NW Bethany & Cornell,10115,S,NS,13,16,29,3,Spring2018
6430,Goose Hollow/SW Jefferson St MAX Station,10117,W,AT,899,422,1321,0,Spring2018
6431,Goose Hollow/SW Jefferson St MAX Station,10118,E,AT,406,1379,1785,0,Spring2018
6432,Washington Park MAX Station,10120,E,AT,481,255,736,0,Spring2018
6433,Washington Park MAX Station,10121,W,AT,210,663,873,0,Spring2018
6434,20700 Block NE Halsey,10125,E,OP,6,12,18,0,Spring2018
6435,SW Baseline & Main,10129,W,FS,11,24,35,4,Spring2018
6436,SW Murray & Nike,10132,N,OP,8,8,16,0,Spring2018
6437,SW Murray & Nike,10133,S,NS,7,7,14,0,Spring2018
6438,SE Sunnyside & 122nd,10135,W,NS,21,7,28,1,Spring2018
6439,SE Sunnyside & 128th,10136,E,FS,0,4,4,0,Spring2018
6440,SE Sunnyside & 128th,10137,W,FS,4,1,5,0,Spring2018
6441,SE Sunnyside & 132nd,10138,E,FS,2,12,14,2,Spring2018
6442,SE Sunnyside & 132nd,10139,W,NS,12,2,14,1,Spring2018
6443,SE Sunnyside & 139th,10140,E,FS,1,5,6,0,Spring2018
6444,SE Sunnyside & 140th,10141,W,FS,3,1,4,0,Spring2018
6445,SE Sunnyside & 142nd,10142,E,FS,2,11,13,1,Spring2018
6446,SE Sunnyside & 142nd,10143,W,NS,8,1,9,0,Spring2018
6447,SE Sunnyside & 145th,10144,E,FS,3,14,17,2,Spring2018
6448,SE Sunnyside & 145th,10145,W,NS,9,0,9,0,Spring2018
6449,14600 Block SE 147th,10146,S,AT,2,2,4,0,Spring2018
6450,SE Oregon Trail Dr & Hines,10148,E,NS,5,3,8,4,Spring2018
6451,SE Lake & Freeman Way,10149,W,FS,3,1,4,0,Spring2018
6452,NW Evergreen Pkwy & NE Stucki,10150,N,FS,19,10,29,5,Spring2018
6453,NW Cedar Hills & Leahy,10152,S,FS,3,2,5,0,Spring2018
6454,NE Century (NW 231st) & Oelrich,10153,S,NS,0,2,2,0,Spring2018
6455,NE Century (NW 231st) & Oelrich,10154,N,NS,2,0,2,0,Spring2018
6456,NE Century (NW 229th) & Walbridge,10155,N,NS,1,2,3,0,Spring2018
6457,SE Tualatin Valley Hwy & 44th,10157,E,OP,16,29,45,86,Spring2018
6458,N Lombard & Terminal 5 Access Rd,10162,S,NS,0,0,0,0,Spring2018
6459,N Lombard & Terminal 5 Access Rd,10163,N,OP,0,0,0,0,Spring2018
6466,NW Springville & PCC Drive,10165,W,NS,0,7,7,0,Spring2018
6467,SW Farmington & 185th,10166,E,FS,110,114,224,17,Spring2018
6468,SW Columbia & 18th,10168,E,NS,245,185,430,29,Spring2018
6469,NW Glencoe & Cody Ct,10169,N,FS,1,2,3,0,Spring2018
6470,400 Block SW 257th,10170,N,AT,1,1,2,0,Spring2018
6471,400 Block SW 257th,10171,S,OP,2,0,2,0,Spring2018
6472,South Shore & Cedar Rd,10175,E,FS,2,2,4,22,Spring2018
6473,700 SW Campus Dr at Doernbecher,10176,E,AT,90,10,100,3,Spring2018
6474,N Ivanhoe & Leavitt,10177,W,FS,17,1,18,0,Spring2018
6475,Tigard Transit Center,10180,S,AT,164,88,252,19,Spring2018
6476,800 Block SW 158th,10182,S,AT,0,0,0,0,Spring2018
6477,NE Alberta & 7th,10184,W,NS,12,28,40,3,Spring2018
6478,22600 Block SE Hwy 224,10185,W,OP,0,0,0,0,Spring2018
6479,22600 Block SE Hwy 224,10186,E,AT,0,0,0,0,Spring2018
6480,SE 28th & Carlton,10189,S,OP,1,1,2,0,Spring2018
6481,SE Tualatin Valley Hwy & 30th,10190,W,NS,7,12,19,6,Spring2018
6482,NE Cornell & Elam Young East,10192,W,OP,4,6,10,0,Spring2018
6483,NE Cornell & Brookwood Pkwy,10193,E,NS,1,1,2,0,Spring2018
6484,17600 Block NE Sandy,10194,W,AT,20,7,27,0,Spring2018
6485,SE Foster & 63rd,10196,E,NS,33,76,109,29,Spring2018
6486,NE Cornell & Brookwood Pkwy,10197,W,NS,1,2,3,0,Spring2018
6487,2200 Block NE Griffin Oaks,10198,W,OP,2,4,6,0,Spring2018
6488,SE Sunnyside & 122nd,10203,E,FS,6,23,29,1,Spring2018
6489,SE Mather & Cedar Park Dr,10204,W,NS,2,0,2,0,Spring2018
6490,10500 Block SE Mather,10205,E,OP,1,3,4,0,Spring2018
6491,SE Mather & Bliss,10206,E,FS,0,0,0,0,Spring2018
6492,SE Mather & 116th Ct,10208,E,NS,0,2,2,0,Spring2018
6493,SE Mather & 119th Ct,10209,E,OP,0,0,0,0,Spring2018
6494,SE Mather & 122nd,10210,E,NS,1,3,4,0,Spring2018
6495,SW Hart & Forest Drive,10211,E,OP,2,4,6,0,Spring2018
6496,SE Sunnyside & Valley View Terr,10214,W,FS,19,2,21,1,Spring2018
6497,SE Sunnyside & 119th,10216,W,OP,19,2,21,2,Spring2018
6498,SE Oregon Trail Dr & 152nd,10219,E,NS,1,0,1,0,Spring2018
6499,SE 152nd & Territory Dr,10221,S,FS,1,0,1,0,Spring2018
6500,SE 152nd & Bollam Dr,10222,N,NS,1,2,3,0,Spring2018
6501,SE 152nd & Morning Way,10223,S,NS,0,0,0,0,Spring2018
6502,SE 152nd & Morning Way,10224,N,OP,0,1,1,0,Spring2018
6503,13300 Block SE Hubbard,10225,W,OP,5,0,5,0,Spring2018
6504,13300 Block SE Hubbard,10226,E,AT,0,3,3,0,Spring2018
6505,SE Hubbard & 125th,10227,W,OP,6,1,7,0,Spring2018
6506,SE Hubbard & 125th,10228,E,FS,1,4,5,0,Spring2018
6507,SE 122nd & Mountain Sun Dr,10229,N,NS,3,0,3,0,Spring2018
6508,SE 122nd & Mountain Sun Dr,10230,S,FS,0,2,2,0,Spring2018
6509,SE 122nd & Echo Valley,10231,N,OP,1,0,1,0,Spring2018
6510,SE 122nd & Echo Valley,10232,S,FS,0,1,1,0,Spring2018
6511,SE 97th & Lawnfield,10234,S,NS,1,4,5,1,Spring2018
6512,SE 97th & Talbert Dr,10235,S,OP,0,3,3,0,Spring2018
6519,SW 170th & Timberland Dr,10273,S,OP,1,2,3,0,Spring2018
6520,SW 170th & Timberland Dr,10274,N,NS,1,1,2,0,Spring2018
6521,27500 Block SE Eagle Creek Rd,10275,N,AT,0,0,0,1,Spring2018
6522,NE 15th & Edgefield,10277,S,NS,2,1,3,1,Spring2018
6523,NE 15th & Edgefield,10278,N,OP,2,1,3,1,Spring2018
6524,NE 15th & Prahl Pkwy,10279,S,NS,2,2,4,0,Spring2018
6525,NE 15th & Prahl Pkwy,10280,N,OP,2,1,3,0,Spring2018
6526,NW 23rd & Overton,10287,S,NS,87,9,96,6,Spring2018
6527,1300 Block NE 25th,10288,N,AT,0,0,0,0,Spring2018
6528,1200 Block NE 25th,10289,S,AT,0,0,0,0,Spring2018
6529,SE Washington & 2nd,10290,E,NS,14,31,45,28,Spring2018
6530,NW St Helens & Marina Way,10291,N,FS,0,0,0,0,Spring2018
6531,PSU South/SW 6th & College MAX Stn,10293,N,NS,1005,436,1441,0,Spring2018
6532,SE 152nd & Sedona Drive,10297,S,FS,2,1,3,0,Spring2018
6533,MAX Station/Oregon Zoo,10299,W,AT,46,45,91,2,Spring2018
6534,SE 17th & Spokane,10302,N,NS,30,5,35,8,Spring2018
6535,SE King & Home,10303,W,FS,13,13,26,0,Spring2018
6536,Kerr & Touchstone,10305,W,NS,11,5,16,0,Spring2018
6537,SE Flavel & 92nd (MAX Stn),10307,W,NS,87,67,154,66,Spring2018
6538,SE 152nd & Ranger Drive,10308,N,NS,1,1,2,0,Spring2018
6539,NE Sandy & 154th,10309,E,NS,4,12,16,1,Spring2018
6540,SW Patton & Humphrey,10310,S,NS,1,19,20,0,Spring2018
6541,NW Cornell & 169th Pl,10313,W,OP,2,4,6,0,Spring2018
6542,2400 Block NW Westover,10314,N,OP,0,0,0,0,Spring2018
6543,NE Sandy & 181st/Airport Way,10315,E,FS,24,34,58,2,Spring2018
6544,NE Sandy & Airport Way/181st,10318,W,FS,41,20,61,1,Spring2018
6545,NW Cornell & 169th Pl,10319,E,NS,3,6,9,0,Spring2018
6546,SE McLoughlin & Glen Echo,10323,S,FS,20,47,67,23,Spring2018
6547,McLoughlin & Gloucester,10324,S,FS,14,47,61,21,Spring2018
6548,McLoughlin & River Rd,10325,S,NS,27,61,88,31,Spring2018
6549,SE McLoughlin & Glen Echo,10326,N,FS,44,25,69,10,Spring2018
6550,SE McLoughlin & W Gloucester,10327,N,FS,44,16,60,23,Spring2018
6551,McLoughlin & W Arlington,10328,N,FS,83,29,112,20,Spring2018
6552,19300 Block McLoughlin,10421,N,AT,4,3,7,5,Spring2018
6553,19300 Block McLoughlin,10422,S,AT,4,11,15,20,Spring2018
6554,NE Weidler & 15th,10425,E,NS,33,62,95,22,Spring2018
6555,SW Hart & 149th,10436,W,OP,1,3,4,0,Spring2018
6556,SW Hart & 149th,10437,E,FS,2,1,3,0,Spring2018
6557,NW Leahy & Alpenglow Way,10442,E,NS,0,0,0,0,Spring2018
6558,SW 170th & Division,10443,S,OP,3,2,5,1,Spring2018
6559,SW Dosch & Patton,10445,S,FS,0,0,0,0,Spring2018
6560,SE 82nd & Sunnybrook,10446,S,NS,7,9,16,1,Spring2018
6561,Oregon City Transit Center,10447,S,AT,64,81,145,36,Spring2018
6562,8300 Block SW Apple Way,10448,E,AT,0,0,0,0,Spring2018
6563,SE Belmont & 51st,10449,W,FS,12,6,18,0,Spring2018
6564,8400 Block NE 33rd Dr,10450,S,OP,6,0,6,0,Spring2018
6565,8400 Block NE 33rd Dr,10452,N,AT,0,13,13,0,Spring2018
6572,NE Sandy & 154th,10453,W,FS,13,4,17,1,Spring2018
6573,NE Shaver & 141st,10454,E,NS,5,17,22,1,Spring2018
6574,NW 35th & Yeon,10455,N,NS,1,17,18,0,Spring2018
6575,NW Evergreen Pkwy & NE Venetian (NW 196th),10457,W,NS,10,3,13,0,Spring2018
6576,NW Evergreen Pkwy & NE Venetian (NW 196th),10458,E,NS,4,7,11,0,Spring2018
6577,N Williams & Emerson,10463,N,NS,4,38,42,4,Spring2018
6578,W Baseline & SW 185th,10464,E,NS,0,9,9,1,Spring2018
6579,SW 45th & Vermont,10466,S,FS,2,0,2,0,Spring2018
6580,SW Vermont & 45th,10467,W,NS,0,2,2,0,Spring2018
6581,400 Block Beavercreek Rd,10469,E,AT,6,50,56,11,Spring2018
6582,2600 Block N Marine,10477,E,AT,0,0,0,0,Spring2018
6583,SE 52nd & Woodstock,10481,S,NS,19,70,89,11,Spring2018
6584,NE Evergreen & Evergreen Middle School,10482,E,AT,1,1,2,0,Spring2018
6585,SE Woodstock & 51st,10484,E,FS,12,46,58,8,Spring2018
6586,SE International Way & Criterion Ct,10489,S,OP,3,1,4,2,Spring2018
6587,SE International Way & Criterion Ct,10490,N,NS,3,5,8,42,Spring2018
6588,SW 5th & Hall,10491,S,NS,581,268,849,53,Spring2018
6589,NE M L King & Morgan,10494,S,NS,22,12,34,2,Spring2018
6590,SW Allen & 107th,10499,W,NS,1,5,6,0,Spring2018
6591,26300 Block SE Hwy 224,10500,E,OP,1,1,2,0,Spring2018
6592,26300 Block SE Hwy 224,10501,W,AT,1,1,2,0,Spring2018
6593,NE 92nd & Hill,10505,N,FS,1,1,2,4,Spring2018
6594,Ostman & Willamette Falls,10523,S,NS,1,1,2,0,Spring2018
6595,Blankenship & Debok,10548,W,NS,6,5,11,5,Spring2018
6596,NE Sandy & 185th Dr,10569,E,NS,7,11,18,0,Spring2018
6597,NE Fremont & 51st,10571,E,NS,2,3,5,0,Spring2018
6598,Parkrose/Sumner TC MAX Station,10572,N,AT,165,894,1059,0,Spring2018
6599,Parkrose/Sumner TC MAX Station,10573,S,AT,888,188,1076,0,Spring2018
6600,Cascades MAX Station,10574,W,AT,53,468,521,0,Spring2018
6601,Cascades MAX Station,10575,E,AT,449,55,504,0,Spring2018
6602,Mt Hood Ave MAX Station,10576,N,AT,51,272,323,0,Spring2018
6603,Mt Hood Ave MAX Station,10577,S,AT,262,63,325,0,Spring2018
6605,SE Sunnyside & 117th,10580,E,NS,2,12,14,4,Spring2018
6606,SW Park Pl & Wright,10589,E,NS,3,1,4,0,Spring2018
6607,N Vancouver Way & NE Walker St,10590,S,NS,28,5,33,1,Spring2018
6608,N Vancouver Way & NE Walker St,10591,N,FS,4,15,19,0,Spring2018
6609,SE Sunnyside & 117th,10592,W,NS,9,1,10,1,Spring2018
6610,SE Holgate & 85th,10593,W,NS,81,111,192,119,Spring2018
6611,NE Fremont & 45th,10594,W,FS,10,5,15,1,Spring2018
6612,NE Fremont & 45th,10596,E,OP,5,7,12,2,Spring2018
6613,NE Fremont & 68th,10597,E,FS,7,8,15,17,Spring2018
6614,SW Halsey & Edgefield Meadows,10598,E,NS,1,6,7,0,Spring2018
6615,SW Murray & Millikan Way,10599,N,NS,4,12,16,1,Spring2018
6616,NE Killingsworth & Cully,10600,E,FS,142,84,226,18,Spring2018
6617,NE Killingsworth & Cully,10601,W,NS,163,250,413,24,Spring2018
6618,300 Block NE Division,10602,W,AT,36,2,38,3,Spring2018
6625,N Willis & Chautauqua,10611,W,NS,9,35,44,4,Spring2018
6626,3515 SW US Veterans Rd,10612,W,OP,78,100,178,0,Spring2018
6627,N Fessenden & Tioga,10614,E,NS,23,5,28,3,Spring2018
6628,SW Park Way & 134th,10615,W,OP,1,0,1,0,Spring2018
6629,SW Halsey & Edgefield Meadows,10630,W,OP,7,1,8,0,Spring2018
6630,SW Hall & Avon,10631,S,NS,7,41,48,1,Spring2018
6631,SW Canyon & Camelot Ct,10632,W,FS,11,44,55,11,Spring2018
6632,SW Canyon & Canyon Crest,10633,W,OP,4,10,14,0,Spring2018
6633,SW Canyon & Canyon Crest,10634,E,NS,8,4,12,0,Spring2018
6634,11600 Block SW Pacific Hwy,10639,W,AT,35,156,191,2,Spring2018
6635,SW Tualatin Valley Hwy & Hocken,10641,W,FS,63,33,96,11,Spring2018
6636,SE Lake & Hwy 224,10644,W,FS,1,0,1,0,Spring2018
6637,2300 Block SW 257th,10645,N,AT,1,2,3,0,Spring2018
6638,SW 257th & 24th,10646,S,FS,1,0,1,0,Spring2018
6639,22000 Block SE Hwy 224,10647,W,OP,0,0,0,0,Spring2018
6640,N Fremont & Kerby,10649,E,FS,81,28,109,5,Spring2018
6641,N Fremont & Kerby,10650,W,NS,26,42,68,2,Spring2018
6642,SE Lake & Hwy 224,10653,E,NS,0,1,1,0,Spring2018
6643,NE Hood & 5th,10654,N,NS,0,5,5,0,Spring2018
6644,NE Hood & 2nd,10657,N,NS,0,14,14,1,Spring2018
6645,NW 21st & Savier,10694,N,FS,1,23,24,1,Spring2018
6646,SE Hwy 224 & Eilers Circle,10695,W,OP,0,0,0,0,Spring2018
6647,SE Hwy 224 & Eilers Circle,10696,E,FS,0,0,0,0,Spring2018
6648,Pier Park,10697,E,AT,163,168,331,73,Spring2018
6649,10900 Block SW 121st,10698,S,OP,3,1,4,0,Spring2018
6650,2900 Block NE 181st,10699,S,AT,14,6,20,0,Spring2018
6651,Oatfield & E Exeter,10700,N,OP,13,4,17,1,Spring2018
6652,SW Harbor & Harrison,10712,S,FS,21,1,22,2,Spring2018
6653,SW Harbor & River Pkwy,10713,N,FS,1,32,33,3,Spring2018
6654,NW Division & Norman,10714,W,NS,31,5,36,14,Spring2018
6655,NE Sandy & 102nd,10715,E,NS,24,12,36,5,Spring2018
6656,NE Airport Way & Win Sivers Drive,10716,E,NS,11,25,36,0,Spring2018
6657,13100 Block NE Airport Way,10717,E,AT,4,10,14,1,Spring2018
6658,NE Airport Way & 148th,10718,E,FS,7,10,17,5,Spring2018
6659,NE Airport Way & 152nd Pl,10719,E,OP,3,3,6,0,Spring2018
6660,16400 Block NE Airport Way,10720,E,AT,3,5,8,0,Spring2018
6661,NE Airport Way & Sandy Blvd,10721,S,NS,11,11,22,0,Spring2018
6662,NE 181st & Sandy,10723,N,NS,6,41,47,1,Spring2018
6663,16300 Block NE Airport Way,10724,W,AT,3,4,7,0,Spring2018
6664,15300 Block NE Airport Way,10725,W,AT,1,4,5,0,Spring2018
6665,NE Airport Way & 148th,10726,W,NS,8,11,19,4,Spring2018
6666,NE Airport Way & 138th,10727,W,NS,12,4,16,1,Spring2018
6667,12900 Block NE Airport Way,10728,W,AT,6,6,12,1,Spring2018
6668,NE Airport Way & 122nd,10729,W,NS,14,8,22,1,Spring2018
6669,NE Airport Way & Glenn Widing,10730,W,FS,25,17,42,2,Spring2018
6670,11000 Block NE Holman,10731,W,OP,8,6,14,4,Spring2018
6671,NE 105th & Simpson,10732,S,FS,2,3,5,0,Spring2018
6678,NE 105th & Marx,10733,S,NS,1,1,2,0,Spring2018
6679,NE 105th & Killingsworth,10734,S,FS,1,0,1,0,Spring2018
6680,NE Weidler & 103rd Pl,10746,W,FS,47,55,102,47,Spring2018
6681,NE Halsey & 102nd,10747,E,NS,149,91,240,61,Spring2018
6682,SW Cedar Hills & Celeste,10749,S,NS,8,3,11,0,Spring2018
6683,NW Graham/257th & North Frontage Rd,10758,N,NS,0,12,12,0,Spring2018
6684,SW Cedar Hills & Celeste,10761,N,FS,3,7,10,0,Spring2018
6685,NE Sandy & 105th,10779,E,NS,12,17,29,2,Spring2018
6686,NE Sandy & 107th,10780,E,NS,13,14,27,6,Spring2018
6687,NE Sandy & 109th,10781,E,NS,6,6,12,1,Spring2018
6688,NE Sandy & 112th,10782,E,NS,8,14,22,3,Spring2018
6689,NE Sandy & 115th,10783,E,NS,5,13,18,5,Spring2018
6690,NE Sandy & 118th,10784,E,FS,14,10,24,0,Spring2018
6691,NE Sandy & 125th Pl,10785,E,NS,20,19,39,2,Spring2018
6692,NE Sandy & 131st Pl,10786,E,NS,8,12,20,0,Spring2018
6693,NE Sandy & 133rd,10787,E,FS,8,19,27,11,Spring2018
6694,NE Sandy & 138th,10788,E,FS,21,59,80,7,Spring2018
6695,14300 Block NE Sandy,10789,E,AT,3,2,5,7,Spring2018
6696,NE Sandy & 148th,10790,E,NS,10,21,31,2,Spring2018
6697,W Burnside & NW 10th,10791,W,FS,123,176,299,67,Spring2018
6698,W Burnside & SW 10th,10792,E,NS,237,94,331,45,Spring2018
6699,NE Sandy & 38th,10793,E,OP,14,57,71,19,Spring2018
6700,NE Sandy & 74th,10795,E,FS,9,38,47,5,Spring2018
6701,Parkrose/ Sumner Transit Center,10798,W,AT,209,186,395,72,Spring2018
6702,7500 Block SW 45th,10801,S,AT,0,0,0,0,Spring2018
6703,W Burnside & NW 17th,10809,W,NS,15,54,69,13,Spring2018
6704,NE Prescott & 89th,10820,W,NS,3,2,5,0,Spring2018
6705,NW Eastman & Burnside,10821,N,FS,20,7,27,14,Spring2018
6706,NE Sandy & 148th,10822,W,NS,18,7,25,3,Spring2018
6707,NE Sandy & 138th,10823,W,NS,68,23,91,12,Spring2018
6708,14300 Block NE Sandy,10824,W,OP,2,2,4,7,Spring2018
6709,NE Sandy & 133rd,10825,W,OP,9,4,13,0,Spring2018
6710,NE Sandy & 131st Pl,10826,W,FS,12,5,17,1,Spring2018
6711,NE Sandy & 125th Pl,10827,W,OP,14,16,30,2,Spring2018
6712,NE Sandy & 118th,10828,W,FS,8,12,20,1,Spring2018
6713,NE Sandy & 115th,10829,W,OP,11,3,14,5,Spring2018
6714,NE Sandy & 112th,10830,W,NS,17,6,23,1,Spring2018
6715,NE Sandy & 109th,10831,W,FS,6,7,13,0,Spring2018
6716,NE Sandy & 107th,10832,W,OP,10,13,23,10,Spring2018
6717,NE Sandy & 44th,10834,W,FS,55,50,105,31,Spring2018
6718,SE Eagle Creek Rd & Duus Rd,10835,S,OP,0,0,0,0,Spring2018
6719,SE Eagle Creek Rd & Duus Rd,10836,N,FS,0,1,1,0,Spring2018
6720,NE 102nd & Prescott,10838,S,NS,19,7,26,2,Spring2018
6721,NE 102nd & Shaver,10840,S,NS,1,0,1,0,Spring2018
6722,NE 102nd & Prescott,10842,N,NS,10,18,28,1,Spring2018
6723,SW Barbur & Spring Garden,10844,W,OP,8,32,40,2,Spring2018
6724,SW Barbur & Huber,10845,W,NS,32,45,77,7,Spring2018
6731,NE Jonesmore & 82nd,10846,W,NS,72,360,432,52,Spring2018
6732,SW Barbur & Bertha,10848,E,NS,106,33,139,19,Spring2018
6733,SW Barbur & 26th Way,10849,E,AT,19,3,22,0,Spring2018
6734,Parkrose/ Sumner Transit Center,10851,W,AT,351,319,670,134,Spring2018
6735,Parkrose/ Sumner Transit Center,10853,E,AT,12,267,279,41,Spring2018
6736,Parkrose/ Sumner Transit Center,10854,E,AT,377,45,422,45,Spring2018
6737,Parkrose/ Sumner Transit Center,10855,E,AT,394,10,404,42,Spring2018
6738,Gresham Transit Center,10858,E,AT,463,406,869,88,Spring2018
6739,Gresham Transit Center,10859,W,AT,214,182,396,21,Spring2018
6740,Gateway Transit Center,10860,S,AT,196,18,214,54,Spring2018
6741,Gateway Transit Center,10861,S,AT,208,11,219,89,Spring2018
6742,Gateway Transit Center,10862,S,AT,213,35,248,43,Spring2018
6743,Gateway Transit Center,10863,S,AT,173,127,300,31,Spring2018
6744,SW 36th & Capitol Hwy,10865,S,NS,4,5,9,0,Spring2018
6745,NE 9th & Halsey,10866,N,NS,19,34,53,14,Spring2018
6746,NE 9th & Weidler,10867,S,NS,18,28,46,17,Spring2018
6747,Hollywood Transit Center,10868,E,AT,390,388,778,64,Spring2018
6748,Hollywood Transit Center,10869,E,AT,129,87,216,33,Spring2018
6749,Hollywood Transit Center,10870,E,AT,99,127,226,38,Spring2018
6750,Hollywood Transit Center,10871,E,AT,45,36,81,2,Spring2018
6751,Hollywood Transit Center,10872,N,AT,406,377,783,66,Spring2018
6752,SW Pacific Hwy & Main,10873,E,FS,20,8,28,1,Spring2018
6753,NE Sandy & 185th Dr,10874,W,FS,8,11,19,1,Spring2018
6754,NE Multnomah & 9th,10876,W,FS,83,50,133,18,Spring2018
6755,E Burnside & NE 102nd,10877,W,FS,96,137,233,75,Spring2018
6756,NE Kane & 29th (MHCC),10878,S,FS,107,132,239,7,Spring2018
6757,"NE Kane & 29th, MHCC",10879,N,NS,147,111,258,11,Spring2018
6758,SE 103rd Dr & Stark,10910,N,FS,77,116,193,59,Spring2018
6759,SW Walnut & 121st,10913,E,FS,4,7,11,0,Spring2018
6760,SW Capitol & 40th,10932,S,NS,0,2,2,0,Spring2018
6761,SW Capitol & Garden Home,10933,S,FS,8,25,33,0,Spring2018
6762,SW Capitol & Taylors Ferry,10935,N,FS,42,9,51,19,Spring2018
6763,5600 Block SE International Way,10939,N,AT,2,1,3,0,Spring2018
6764,NE Evergreen Pkwy & Imbrie Dr,10940,N,NS,28,10,38,1,Spring2018
6765,NE Evergreen Pkwy & Imbrie Dr,10941,S,NS,7,33,40,1,Spring2018
6766,SW Capitol & Huber,10952,S,NS,34,50,84,6,Spring2018
6767,NE Grand & Wasco,10953,N,NS,152,43,195,38,Spring2018
6768,NE Killingsworth & Garfield,10957,W,NS,142,110,252,51,Spring2018
6769,N Willamette & Burr,10975,S,OP,7,2,9,1,Spring2018
6770,NE Airport Way & 158th,10994,E,FS,2,9,11,1,Spring2018
6771,NE Airport Way & 158th,10995,W,NS,3,3,6,1,Spring2018
6772,SW Harbor & Montgomery,11001,S,OP,20,1,21,1,Spring2018
6773,SW Harbor & Montgomery,11002,N,NS,1,21,22,0,Spring2018
6774,SW Tualatin Valley Hwy & 153rd,11003,W,NS,4,5,9,1,Spring2018
6775,SE 103rd Dr & Washington,11005,N,NS,25,40,65,35,Spring2018
6776,N Marine & Portland Rd,11006,W,FS,0,0,0,0,Spring2018
6777,N Fessenden & Seneca,11007,E,FS,71,17,88,17,Spring2018
6784,NE Columbia Blvd & 52nd (NAYA),11009,W,OP,28,39,67,4,Spring2018
6785,SW Terwilliger & Campus,11010,S,NS,4,181,185,7,Spring2018
6786,SW Barnes & 117th,11012,W,OP,2,5,7,3,Spring2018
6787,NE Airport Way & Riverside,11014,E,NS,9,5,14,0,Spring2018
6788,NE Airport Way & Riverside,11015,W,NS,1,10,11,0,Spring2018
6789,NW St Helens & Riverview Drive,11016,N,OP,0,2,2,0,Spring2018
6790,NW Glencoe & Cody Ct,11024,S,FS,2,1,3,0,Spring2018
6791,10500 Block SE Cherry Blossom,11026,E,AT,8,15,23,16,Spring2018
6792,SE 106th & Cherry Blossom,11027,N,NS,40,48,88,39,Spring2018
6793,SE Harold & 133rd,11029,E,NS,0,4,4,0,Spring2018
6794,SW Pacific Hwy & Garrett,11030,E,FS,18,8,26,0,Spring2018
6795,SW Barbur & 22nd,11031,E,FS,20,7,27,1,Spring2018
6796,W Burnside & NW 12th,11032,W,FS,107,146,253,78,Spring2018
6797,SE Stark & 155th Pl,11071,W,NS,30,7,37,24,Spring2018
6798,NE Sandy & 158th,11072,W,NS,44,29,73,4,Spring2018
6799,SE 181st Ave & 180th Ave,11073,S,FS,13,19,32,4,Spring2018
6800,Washington & 14th,11111,S,NS,1,2,3,0,Spring2018
6801,SW Rose Garden Way & Sherwood,11151,S,NS,10,6,16,0,Spring2018
6802,NE Sunderland & 33rd Dr,11171,S,FS,1,5,6,3,Spring2018
6803,SW Bertha & Barbur,11211,E,NS,8,6,14,1,Spring2018
6804,NE 181st & Wilkes,11231,S,OP,11,5,16,13,Spring2018
6805,SE 82nd & Sunnybrook,11251,N,FS,7,14,21,5,Spring2018
6806,SW Barbur & 13th,11271,N,OP,30,28,58,1,Spring2018
6807,SW Palatine Hill & Lewis & Clark Gate 3,11311,N,FS,15,0,15,0,Spring2018
6808,SW Palatine Hill & Lewis & Clark Gate 6,11312,W,NS,0,6,6,0,Spring2018
6809,NE Sandy & Cesar Chavez Blvd,11313,W,NS,106,42,148,34,Spring2018
6810,2nd & Tumwater,11331,E,NS,5,10,15,1,Spring2018
6811,SE 106th & Cherry Blossom,11411,S,FS,54,35,89,35,Spring2018
6812,10000 Block SE Stevens Rd,11453,S,OP,1,14,15,3,Spring2018
6813,10100 Block SE Stevens Rd,11454,N,AT,9,4,13,2,Spring2018
6814,NE Alberta & 21st,11471,E,NS,42,41,83,5,Spring2018
6815,NE Alberta & 21st,11472,W,NS,38,42,80,6,Spring2018
6816,1400 Block Molalla,11473,N,OP,9,3,12,3,Spring2018
6817,Beavercreek & Fir St,11475,E,FS,0,6,6,0,Spring2018
6818,NE Alberta & 7th,11478,E,NS,22,15,37,2,Spring2018
6819,NW St Helens & Marina Way,11479,S,OP,0,0,0,0,Spring2018
6820,N Williams & NE Weidler,11480,N,NS,36,61,97,19,Spring2018
6821,500 Block Molalla,11481,S,AT,3,6,9,0,Spring2018
6822,500 Block Molalla,11482,N,OP,3,3,6,1,Spring2018
6823,SE Grand & Taylor,11483,N,NS,56,22,78,6,Spring2018
6824,SE Grand & Belmont,11484,N,FS,82,34,116,25,Spring2018
6825,SW 6th & Columbia,11486,N,NS,127,284,411,38,Spring2018
6826,NE Cesar Chavez Blvd & Halsey,11487,N,NS,1,22,23,4,Spring2018
6827,NW St Helens & 112th,11490,S,FS,2,0,2,0,Spring2018
6828,NE Multnomah & 3rd,11492,W,FS,59,19,78,15,Spring2018
6829,Expo Center MAX Station,11498,S,AT,605,620,1225,0,Spring2018
6830,Delta Park/Vanport MAX Station,11499,S,AT,984,43,1027,0,Spring2018
6837,Kenton/N Denver Ave MAX Station,11500,S,AT,502,93,595,0,Spring2018
6838,N Lombard TC MAX Station,11501,S,AT,1107,231,1338,0,Spring2018
6839,Rosa Parks MAX Station,11502,S,AT,548,147,695,0,Spring2018
6840,N Killingsworth St MAX Station,11503,S,AT,700,294,994,0,Spring2018
6841,N Prescott St MAX Station,11504,S,AT,408,171,579,0,Spring2018
6842,Overlook Park MAX Station,11505,S,AT,417,122,539,0,Spring2018
6843,Albina/Mississippi MAX Station,11506,S,AT,198,87,285,0,Spring2018
6844,Interstate/Rose Quarter MAX Station,11507,S,AT,244,1280,1524,0,Spring2018
6845,Interstate/Rose Quarter MAX Station,11508,N,AT,1248,481,1729,0,Spring2018
6846,Albina/Mississippi MAX Station,11509,N,AT,110,204,314,0,Spring2018
6847,Overlook Park MAX Station,11510,N,AT,123,436,559,0,Spring2018
6848,N Prescott St MAX Station,11511,N,AT,165,467,632,0,Spring2018
6849,N Killingsworth St MAX Station,11512,N,AT,268,752,1020,0,Spring2018
6850,Rosa Parks MAX Station,11513,N,AT,145,591,736,0,Spring2018
6851,N Lombard TC MAX Station,11514,N,AT,215,1139,1354,0,Spring2018
6852,Kenton/N Denver Ave MAX Station,11515,N,AT,81,442,523,0,Spring2018
6853,Delta Park/Vanport MAX Station,11516,N,AT,75,1045,1120,0,Spring2018
6854,SE Sunnyside & Stevens,11520,E,FS,13,30,43,10,Spring2018
6855,SW Scholls Ferry & Murray,11521,W,NS,68,56,124,4,Spring2018
6856,NE Alberta & 30th,11722,E,NS,20,31,51,4,Spring2018
6857,SE Powell & 125th Pl,11742,E,FS,13,44,57,11,Spring2018
6858,Willamette Falls Dr & West A,11762,N,NS,0,2,2,0,Spring2018
6859,Willamette Falls Dr & West A,11763,S,FS,1,3,4,0,Spring2018
6860,Willamette Falls Dr & 6th St,11764,W,OP,1,2,3,0,Spring2018
6861,Willamette Falls Dr & 6th St,11765,E,FS,2,0,2,0,Spring2018
6862,Willamette Falls Dr & 11th St,11766,E,NS,2,0,2,0,Spring2018
6863,E Main (W Baseline) & NE 63rd,11770,E,OP,3,3,6,0,Spring2018
6864,E Main (W Baseline) & NE 63rd,11771,W,NS,2,3,5,0,Spring2018
6865,NE Sandy & Arborcrest Dr,11772,W,FS,6,8,14,0,Spring2018
6866,NE Sandy & Blossom Hill,11773,E,FS,7,3,10,0,Spring2018
6867,Boones Ferry Rd & Mercantile Dr,11775,S,NS,1,2,3,0,Spring2018
6868,Boones Ferry Rd & Oakridge,11776,S,NS,2,3,5,13,Spring2018
6869,Boones Ferry Rd & Washington Ct,11777,S,NS,1,1,2,0,Spring2018
6870,Boones Ferry Rd & Pilkington,11778,S,OP,0,2,2,0,Spring2018
6871,Boones Ferry Rd & Jean,11779,S,NS,0,2,2,0,Spring2018
6872,Boones Ferry Rd & Jean,11780,N,NS,1,0,1,0,Spring2018
6873,Boones Ferry Rd & Pilkington,11781,N,NS,2,1,3,0,Spring2018
6874,Boones Ferry Rd & Washington Ct,11782,N,OP,1,0,1,0,Spring2018
6875,Boones Ferry Rd & Reese Rd,11783,N,FS,4,1,5,6,Spring2018
6876,Boones Ferry Rd & Mercantile Dr,11784,N,OP,3,2,5,0,Spring2018
6877,SE Powell & 156th,11786,W,FS,14,7,21,21,Spring2018
6878,SW Vermont & Idaho Dr,11789,E,FS,8,2,10,1,Spring2018
6879,3400 Block McNary,11804,W,AT,0,2,2,0,Spring2018
6880,South Shore & Patton,11805,E,OP,0,1,1,0,Spring2018
6881,SW Farmington & Hall,11810,E,FS,4,20,24,2,Spring2018
6882,N Interstate & Multnomah (Rose Quarter),11813,S,NS,30,129,159,10,Spring2018
6883,N Interstate & Rose Quarter TC,11814,N,AT,115,31,146,8,Spring2018
6890,NE Sandy & 172nd Pl,11815,W,FS,6,6,12,0,Spring2018
6891,NE Sandy & 172nd Pl,11816,E,NS,7,7,14,1,Spring2018
6892,Rose Quarter Transit Center,11817,E,NS,215,280,495,97,Spring2018
6893,N Macrum & Powers,11824,N,OP,1,0,1,0,Spring2018
6894,N Columbia Blvd & Oregonian,11825,W,NS,0,0,0,0,Spring2018
6895,N Columbia Blvd & Bank,11826,W,NS,0,0,0,0,Spring2018
6896,N Columbia Blvd & Upland Dr,11827,W,FS,0,0,0,0,Spring2018
6897,N Columbia Blvd & Swift,11828,W,FS,0,3,3,1,Spring2018
6898,N Marine & Pier 99 St,11829,S,OP,5,31,36,1,Spring2018
6899,NE Walker & N Vancouver Way,11830,W,NS,0,3,3,0,Spring2018
6900,NE Glisan & 74th,11831,W,NS,29,12,41,1,Spring2018
6901,N Marine & Pier 99 St,11832,N,NS,36,1,37,0,Spring2018
6902,N Columbia Blvd & Upland Dr,11833,E,NS,0,0,0,0,Spring2018
6903,N Columbia Blvd & Bank,11834,E,OP,0,0,0,0,Spring2018
6904,N Columbia Blvd & Oregonian,11835,E,FS,0,0,0,0,Spring2018
6905,N Macrum & Powers,11836,S,NS,0,1,1,0,Spring2018
6906,N Ivanhoe & Baltimore,11837,S,FS,2,12,14,2,Spring2018
6907,N Columbia Blvd & Hendricks,11838,E,NS,5,1,6,1,Spring2018
6908,N Interstate & Albina,11839,N,FS,16,8,24,1,Spring2018
6909,N Interstate & Tillamook,11840,N,FS,1,8,9,0,Spring2018
6910,N Interstate & Tillamook,11844,S,NS,3,1,4,0,Spring2018
6911,N Interstate & Larrabee,11845,S,NS,0,2,2,0,Spring2018
6912,Molalla & Garden Meadow,11846,S,FS,3,8,11,7,Spring2018
6913,9500 Block N Columbia Blvd,11849,S,OP,0,0,0,0,Spring2018
6914,9500 Block N Columbia Blvd,11850,N,AT,0,0,0,0,Spring2018
6915,SW Hocken & Cedar Hills Xing Entrance,11851,N,AT,29,41,70,36,Spring2018
6916,SW Hocken & Cedar Hills Xing Entrance,11852,S,OP,36,25,61,22,Spring2018
6917,SE Powell & 57th,11920,E,NS,23,31,54,2,Spring2018
6918,SE Powell & 62nd,11921,E,FS,10,26,36,1,Spring2018
6919,SE Powell & 75th,11922,E,OP,10,37,47,17,Spring2018
6920,SE Powell & 75th,11923,W,FS,43,10,53,34,Spring2018
6921,SE Powell & 65th,11924,W,FS,42,14,56,7,Spring2018
6922,SE Powell & 55th,11925,W,FS,38,55,93,3,Spring2018
6923,SE Bob Schumacher & Monterey,11926,S,FS,2,6,8,1,Spring2018
6924,SE Bob Schumacher & Monterey,11927,N,NS,4,4,8,0,Spring2018
6925,SE Sunnyside & Sunnybrook,11928,W,OP,1,0,1,0,Spring2018
6926,SE Sunnyside & 105th,11929,W,NS,8,3,11,0,Spring2018
6927,12700 Block SE Hwy 212,11930,E,AT,0,1,1,0,Spring2018
6928,12700 Block SE Hwy 212,11931,W,OP,1,0,1,0,Spring2018
6929,Molalla & Mountain View,11932,N,OP,12,3,15,2,Spring2018
6930,Molalla & Mountain View,11933,S,NS,5,11,16,2,Spring2018
6931,N Ivanhoe & New York,11934,N,FS,3,0,3,0,Spring2018
6932,N Ivanhoe & Chicago,11935,S,NS,0,1,1,0,Spring2018
6933,N St Louis & Central,11936,E,NS,10,2,12,16,Spring2018
6934,Sunset Transit Center,11939,W,AT,436,386,822,105,Spring2018
6935,16800 Block SW 72nd,11944,N,AT,145,13,158,5,Spring2018
6936,17000 Block SW 72nd,11945,S,AT,7,48,55,4,Spring2018
6943,N Cutter Circle & Leverman,11947,E,FS,6,27,33,0,Spring2018
6944,6000 Block N Cutter Circle,11948,N,AT,10,11,21,0,Spring2018
6945,6300 Block N Cutter Circle,11949,N,AT,1,1,2,0,Spring2018
6946,N Leverman & Cutter Circle,11950,S,NS,12,4,16,0,Spring2018
6947,SE 122nd & Summers Lane,11952,N,NS,23,2,25,0,Spring2018
6948,SE 122nd & Summers Lane,11953,S,FS,2,8,10,0,Spring2018
6949,SW Main & 2nd,11956,W,NS,138,1094,1232,55,Spring2018
6950,SE Clackamas Rd & Johnson,11958,W,NS,4,1,5,0,Spring2018
6951,SE Johnson & Cypress,11959,N,OP,1,0,1,0,Spring2018
6952,SE Johnson & Thiessen,11960,N,OP,2,1,3,0,Spring2018
6953,14400 Block SE Johnson,11961,N,AT,10,3,13,7,Spring2018
6954,SE Johnson & Lake,11962,N,FS,20,7,27,1,Spring2018
6955,SE Johnson & Lake,11963,S,OP,8,24,32,8,Spring2018
6956,14400 Block SE Johnson,11964,S,AT,4,1,5,0,Spring2018
6957,SE Johnson & Thiessen,11965,S,NS,1,2,3,0,Spring2018
6958,SE Johnson & Cypress,11966,S,NS,0,1,1,0,Spring2018
6959,SE Clackamas Rd & Johnson,11967,E,FS,1,2,3,0,Spring2018
6960,SE McKinley & Hood,11968,S,FS,1,2,3,0,Spring2018
6961,SE Sunnyside & Sunnybrook,11970,E,NS,0,2,2,0,Spring2018
6962,SW Walnut & 114th,11973,W,FS,2,1,3,0,Spring2018
6963,N Broadway & Benton,12374,W,NS,12,9,21,2,Spring2018
6964,N Leverman & Basin,12383,E,FS,2,9,11,0,Spring2018
6965,SW Taylors Ferry & Picasso Pl,12387,W,FS,1,1,2,0,Spring2018
6966,SE Stark & 187th,12397,W,NS,57,142,199,48,Spring2018
6967,SE Stark & 187th,12398,E,FS,112,55,167,48,Spring2018
6968,SW Hall & Greenburg,12402,W,NS,2,2,4,0,Spring2018
6969,SW Greenburg & Washington Square Rd,12403,N,FS,65,39,104,5,Spring2018
6970,SW Greenburg & Washington Square Rd,12404,S,NS,34,68,102,5,Spring2018
6971,SW Canyon & 103rd,12405,E,NS,15,18,33,9,Spring2018
6972,SW Canyon & 91st,12406,W,OP,5,8,13,0,Spring2018
6973,SW Farmington & Erickson,12451,W,NS,28,14,42,4,Spring2018
6974,10200 Block SE Main,12462,N,AT,0,1,1,0,Spring2018
6975,10200 Block SE Main,12463,S,OP,1,0,1,0,Spring2018
6976,N Marine & Portland Rd,12465,E,FS,0,0,0,0,Spring2018
6977,5700 Block SW Hamilton,12466,W,AT,0,0,0,0,Spring2018
6978,SW Chestnut & 12th Dr,12467,N,NS,3,1,4,0,Spring2018
6979,SW Hall & Wall,12468,S,NS,6,20,26,7,Spring2018
6980,NE Division & Kelly,12707,E,FS,20,2,22,5,Spring2018
6981,N Fessenden & Haven,12725,W,NS,80,121,201,8,Spring2018
6982,N Fessenden & Haven,12726,E,NS,134,84,218,5,Spring2018
6983,N Trenton & Newman,12727,W,NS,98,180,278,86,Spring2018
6984,10000 Block SW Terwilliger,12729,E,OP,0,3,3,0,Spring2018
6985,SW Bertha & Vermont,12730,N,NS,3,3,6,0,Spring2018
6986,SW Huddleson & Palatine Hill,12731,E,FS,16,16,32,0,Spring2018
6987,L & C Campus & Templeton Student Center,12732,N,AT,13,1,14,0,Spring2018
6988,Pacific Hwy & Tualatin Rvr Refuge,12743,W,AT,0,1,1,0,Spring2018
6989,SW Murray & Brockman,12746,N,NS,13,0,13,3,Spring2018
6996,N Trenton & Dwight,12750,E,NS,187,116,303,84,Spring2018
6997,4200 Block NW Yeon,12754,E,OP,1,0,1,0,Spring2018
6998,SE 82nd & Harrison,12755,N,NS,47,27,74,7,Spring2018
6999,SW Moody & Gibbs,12760,S,NS,104,99,203,11,Spring2018
7000,E Burnside & SE 69th,12761,E,FS,4,12,16,1,Spring2018
7001,SW 4th & Caruthers,12762,N,NS,25,50,75,4,Spring2018
7002,SW 4th & Hall,12763,N,NS,115,369,484,41,Spring2018
7003,SW 3rd & Madison,12787,S,NS,19,124,143,21,Spring2018
7004,SW Jefferson & 1st,12789,W,FS,4,321,325,3,Spring2018
7005,SW Jefferson between 4th & 5th,12790,W,FS,84,368,452,69,Spring2018
7006,SW Jefferson & 5th,12791,W,NS,123,202,325,24,Spring2018
7007,SW Columbia & 16th,12792,E,OP,112,43,155,7,Spring2018
7008,SW Columbia between 6th & 5th,12793,E,FS,183,275,458,38,Spring2018
7009,SW Columbia between 5th & 4th,12794,E,FS,397,12,409,42,Spring2018
7010,SW Columbia & 1st,12795,E,NS,238,8,246,2,Spring2018
7011,SW Oak & 1st,12798,W,NS,23,66,89,7,Spring2018
7012,NW Broadway & Hoyt,12805,S,NS,42,92,134,76,Spring2018
7013,E Columbia River Hwy & SE Harlow,12838,E,NS,0,1,1,0,Spring2018
7014,SE Main & Beta,12842,W,OP,1,3,4,0,Spring2018
7015,16200 Block SW Langer,12849,E,AT,20,6,26,4,Spring2018
7016,SE Tualatin Valley Hwy & Brookwood,12851,W,FS,47,68,115,18,Spring2018
7017,SW Lower Boones Ferry & 65th,12852,W,NS,1,6,7,1,Spring2018
7018,W Powell & N Main,12862,W,FS,23,4,27,7,Spring2018
7019,W Powell & NW Wilson,12863,W,FS,11,7,18,12,Spring2018
7020,W Powell & NW Willowbrook,12864,W,NS,2,1,3,0,Spring2018
7021,W Powell & NW Wilson,12866,E,OP,8,7,15,2,Spring2018
7022,W Powell & SW Eastman Parkway,12867,E,FS,14,37,51,18,Spring2018
7023,W Powell & NW Eastman Parkway,12868,W,FS,39,11,50,22,Spring2018
7024,"2800 Blk NE Brookwood Pkwy, Library",12875,N,AT,2,10,12,4,Spring2018
7025,SW Moody & Gaines,12880,S,FS,11,37,48,5,Spring2018
7026,NE Brookwood & Airport Rd,12884,N,FS,1,1,2,0,Spring2018
7027,SW Fairview & Kingston,12886,W,FS,2,0,2,0,Spring2018
7028,SE Hawthorne & 34th,12892,W,NS,119,45,164,10,Spring2018
7029,Merlo Rd/SW 158th MAX Stn Turnaround,12899,E,AT,246,241,487,27,Spring2018
7030,SE Holgate & 97th,12900,E,FS,3,21,24,3,Spring2018
7031,SE Sunnyside & 152nd,12901,E,FS,2,12,14,0,Spring2018
7032,SE Sunnyside & 157th,12902,W,NS,20,2,22,1,Spring2018
7033,SE Sunnyside & 152nd,12903,W,FS,10,2,12,0,Spring2018
7034,SE Foster & Cora,12904,W,NS,24,8,32,6,Spring2018
7035,SE 97th & Park Mountain Lane,12912,S,OP,1,7,8,0,Spring2018
7036,SE Holgate & 97th,12914,W,OP,19,3,22,1,Spring2018
7037,SE 50th & Mill,12917,N,NS,10,3,13,2,Spring2018
7038,Delta Park/Vanport,12918,S,AT,84,94,178,54,Spring2018
7039,Clackamas Town Center Mall,12921,E,AT,67,1306,1373,250,Spring2018
7040,Clackamas Town Center Mall,12922,W,AT,1342,64,1406,233,Spring2018
7041,SE Sunnyside & Misty Dr,12923,W,FS,19,2,21,1,Spring2018
7042,SE Sunnyside & 147th,12924,E,NS,4,21,25,3,Spring2018
7049,SE 152nd & Oregon Trail,12925,N,NS,0,0,0,0,Spring2018
7050,SW Center & Lombard,12932,E,NS,1,9,10,1,Spring2018
7051,SW Lombard & Center,12933,N,NS,10,2,12,1,Spring2018
7052,E Burnside & SE 99th,12934,E,NS,17,20,37,4,Spring2018
7053,19000 Block SE Hwy 224,12936,N,AT,0,0,0,0,Spring2018
7054,19300 Block SE Hwy 224,12937,S,AT,0,0,0,0,Spring2018
7055,9600 N Ramsey Blvd,12942,W,AT,0,0,0,0,Spring2018
7056,SE Stark & 130th,12943,W,OP,61,25,86,9,Spring2018
7057,SW Lombard & Broadway,12944,N,NS,8,161,169,24,Spring2018
7058,SW Lombard & Broadway,12945,S,NS,137,11,148,32,Spring2018
7059,SE Foster & 56th,12946,E,FS,10,26,36,2,Spring2018
7060,SE Foster & 61st,12947,E,FS,8,37,45,3,Spring2018
7061,SE Foster & 74th,12948,W,NS,28,7,35,16,Spring2018
7062,SE Stark & 142nd,12949,W,OP,41,17,58,1,Spring2018
7063,12600 Block SE Stark,12950,E,AT,19,48,67,11,Spring2018
7064,SE Powell & 28th Pl,12951,E,FS,107,115,222,14,Spring2018
7065,NE Kane & 15th,12952,S,OP,20,23,43,3,Spring2018
7066,SE Stark & 214th,12953,E,OP,8,16,24,5,Spring2018
7067,SE Stark & 169th,12954,E,FS,13,30,43,15,Spring2018
7068,E Burnside & SE 57th,12955,E,FS,2,14,16,3,Spring2018
7069,SE King & Cook Ct,12956,W,FS,30,25,55,3,Spring2018
7070,SE Stark & Cherry Park,12957,W,NS,77,38,115,38,Spring2018
7071,7500 Block SW Hunziker,12958,E,AT,4,5,9,0,Spring2018
7072,PCC Lower Drive (G St) & H St,12959,W,OP,6,0,6,0,Spring2018
7073,SW Barnes & 84th,12960,E,NS,9,2,11,0,Spring2018
7074,SE Stark & 238th,12961,E,FS,11,30,41,23,Spring2018
7075,7200 Block SW Durham,12962,N,OP,9,3,12,0,Spring2018
7076,SW Oleson & Skyhar Dr,12963,N,OP,5,1,6,0,Spring2018
7077,SW Oleson & Obrien,12964,N,OP,2,1,3,0,Spring2018
7078,2900 Block NW Front,12965,S,AT,10,0,10,0,Spring2018
7079,NE Prescott & 87th,12992,W,NS,7,4,11,16,Spring2018
7080,SW Cedar Hills & Foothill Dr,12993,S,NS,2,5,7,0,Spring2018
7081,SW Cedar Hills & Foothill Dr,13018,N,NS,3,1,4,0,Spring2018
7082,SW Palater & Palatine Hill,13022,E,OP,0,2,2,0,Spring2018
7083,SE Flavel & 69th,13024,W,NS,22,5,27,2,Spring2018
7084,"2800 Blk NE Brookwood Pkwy, Library",13025,S,OP,5,0,5,1,Spring2018
7085,NE Halsey & 159th Ct,13026,W,NS,15,2,17,0,Spring2018
7086,NE Kane & SE Stark,13031,S,FS,62,115,177,40,Spring2018
7087,SE Foster & 120th,13032,W,NS,7,12,19,1,Spring2018
7088,NE Hood & 2nd,13033,S,FS,41,7,48,20,Spring2018
7089,SW Walnut & Grant,13034,N,NS,3,3,6,0,Spring2018
7090,SW 197th & Brookfield,13035,S,NS,3,3,6,0,Spring2018
7091,SW 197th & Alderwood Ct,13036,N,NS,2,2,4,0,Spring2018
7092,SE 90th & Causey,13037,S,FS,8,25,33,15,Spring2018
7093,9400 Block NE Sunderland,13040,S,AT,3,15,18,15,Spring2018
7094,SW Canyon & 115th Ave,13042,E,FS,27,11,38,25,Spring2018
7095,SE Belmont & 26th Ave,13043,E,NS,64,135,199,28,Spring2018
7102,Bryant & Lamont Way,13044,S,NS,0,1,1,0,Spring2018
7105,Tigard TC WES Station,13068,S,AT,80,188,268,0,Spring2018
7108,NE Glisan & 120th,13071,W,NS,2,1,3,4,Spring2018
7109,Tigard TC WES Station,13073,N,AT,212,71,283,0,Spring2018
7110,NE Glisan & 152nd,13075,E,OP,0,2,2,0,Spring2018
7111,SE 182nd & Bush Terrace,13076,S,FS,0,2,2,0,Spring2018
7112,Kaiser Sunnyside Medical Center,13077,W,AT,21,10,31,9,Spring2018
7113,SW Boones Ferry Rd & Martinazzi,13078,W,FS,7,44,51,16,Spring2018
7114,SW Boones Ferry Rd & Nyberg,13079,S,NS,50,50,100,2,Spring2018
7115,SW Warm Springs & Boones Ferry,13080,E,FS,5,32,37,0,Spring2018
7116,SW Warm Springs & Martinazzi,13081,E,NS,12,30,42,5,Spring2018
7117,SW Warm Springs & Martinazzi,13082,W,FS,20,10,30,0,Spring2018
7118,SW Warm Springs & Boones Ferry,13083,W,NS,29,5,34,0,Spring2018
7119,SW Boones Ferry Rd & Seneca,13084,N,NS,50,13,63,4,Spring2018
7120,SW Boones Ferry Rd & Martinazzi,13085,E,NS,38,6,44,7,Spring2018
7121,22800 Block NE Sandy,13086,E,AT,1,1,2,0,Spring2018
7122,23500 Block NE Sandy,13088,E,AT,93,70,163,40,Spring2018
7123,NE 223rd & Arata,13089,S,OP,34,9,43,6,Spring2018
7124,23500 Block NE Sandy,13090,W,AT,60,92,152,37,Spring2018
7125,22800 Block NE Sandy,13092,W,AT,1,6,7,0,Spring2018
7126,1700 Block NW Naito Parkway,13098,N,AT,0,2,2,0,Spring2018
7127,3500 Block Willamette Falls Dr,13108,E,AT,0,0,0,1,Spring2018
7128,17500 Block SE Hwy 224,13113,W,AT,0,0,0,0,Spring2018
7129,NE Brookwood Pkwy & 49th Pl,13115,W,NS,1,0,1,0,Spring2018
7130,NE Shaver & 115th,13116,W,NS,9,0,9,1,Spring2018
7131,NE 125th Pl & Shaver,13117,S,NS,3,0,3,0,Spring2018
7132,4200 Block NE 125th Pl,13118,W,NS,11,1,12,0,Spring2018
7133,SE Harold & 104th,13122,W,NS,22,2,24,5,Spring2018
7134,SW 6th & Madison MAX Station,13123,N,NS,1150,784,1934,0,Spring2018
7135,SE Main St MAX Station,13124,S,NS,351,515,866,0,Spring2018
7136,SE Division St MAX Station,13125,S,FS,232,481,713,0,Spring2018
7137,SE Powell Blvd MAX Station,13126,S,FS,158,765,923,0,Spring2018
7138,SE Holgate Blvd MAX Station,13127,S,NS,123,494,617,0,Spring2018
7139,Lents/SE Foster Rd MAX Station,13128,S,NS,161,502,663,0,Spring2018
7140,SE Flavel St MAX Station,13129,S,FS,113,392,505,0,Spring2018
7141,SE Fuller Rd MAX Station,13130,S,AT,49,401,450,0,Spring2018
7142,Clackamas Town Center TC MAX Station,13132,N,AT,2224,2397,4621,0,Spring2018
7143,SE Fuller Rd MAX Station,13133,N,AT,377,47,424,0,Spring2018
7144,SE Flavel St MAX Station,13134,N,NS,431,101,532,0,Spring2018
7145,Lents/SE Foster Rd MAX Station,13135,N,FS,503,176,679,0,Spring2018
7146,SE Holgate Blvd MAX Station,13136,N,FS,509,117,626,0,Spring2018
7147,SE Powell Blvd MAX Station,13137,N,NS,642,181,823,0,Spring2018
7148,SE Division St MAX Station,13138,N,NS,444,244,688,0,Spring2018
7155,SE Main St MAX Station,13139,N,FS,511,315,826,0,Spring2018
7156,NE 148th & Rose Parkway,13141,S,NS,3,1,4,2,Spring2018
7157,NE 148th & Rose Parkway,13142,N,NS,2,3,5,1,Spring2018
7158,12700 Block NE San Rafael,13143,W,AT,1,0,1,0,Spring2018
7159,Flavel & I-205 Overpass,13145,E,FS,43,36,79,24,Spring2018
7160,15700 Block SE McKinley,13146,N,AT,0,0,0,0,Spring2018
7161,SE Lake & 41st Ct,13147,E,OP,1,1,2,0,Spring2018
7162,SE Lake & Vernie/41st Ct,13148,W,OP,1,1,2,0,Spring2018
7163,17100 Block SE Webster,13149,S,AT,1,5,6,2,Spring2018
7164,NE M L King & Columbia Blvd,13150,N,NS,13,64,77,13,Spring2018
7165,Webster & Cason,13153,S,NS,2,6,8,0,Spring2018
7166,E Burnside & 63rd,13155,E,FS,5,17,22,0,Spring2018
7167,SE Hwy 224 & Goosehollow,13156,S,NS,0,4,4,0,Spring2018
7168,200 Block NE Gertz Rd,13161,E,AT,3,21,24,2,Spring2018
7169,NE Gertz Rd & Vancouver Way,13162,E,NS,4,25,29,6,Spring2018
7170,NE Century (NW 229th) & Intel South Drwy,13163,N,OP,4,11,15,1,Spring2018
7171,NE Century (NW 229th) & Intel South Drwy,13164,S,NS,8,3,11,0,Spring2018
7172,SW 5th & Clay,13167,S,NS,271,139,410,34,Spring2018
7173,SW Oak & 6th,13168,W,NS,161,163,324,21,Spring2018
7174,SW Main & 6th,13169,W,NS,564,1182,1746,152,Spring2018
7175,SW Broadway & W Burnside,13170,N,NS,70,141,211,21,Spring2018
7176,W Burnside & SW 5th,13171,E,NS,182,120,302,78,Spring2018
7177,NW Naito Parkway & Couch,13176,S,FS,4,45,49,2,Spring2018
7178,NW Broadway & Everett,13178,S,NS,41,93,134,39,Spring2018
7179,SW Moody & Thomas,13183,S,NS,16,50,66,2,Spring2018
7180,SW Macadam & Lowell,13184,N,NS,20,14,34,0,Spring2018
7181,SW Macadam & Tram Tower,13185,N,AT,34,167,201,3,Spring2018
7182,13800 Block SE Oatfield,13186,N,AT,1,2,3,0,Spring2018
7183,Molalla & Harris,13187,N,FS,5,2,7,0,Spring2018
7184,NE Glisan & 24th,13193,E,FS,38,64,102,7,Spring2018
7185,NE Glisan & 24th,13194,W,NS,52,21,73,7,Spring2018
7186,SW Lower Boones Ferry & McEwan Rd,13195,E,FS,4,2,6,1,Spring2018
7187,SW Hall & Burnham,13196,N,NS,0,1,1,1,Spring2018
7188,SW Watson & 5th,13197,S,NS,37,36,73,33,Spring2018
7189,SW Highland & 14th Dr,13198,W,FS,0,0,0,0,Spring2018
7190,3500 Block SE 182nd,13199,S,AT,1,12,13,0,Spring2018
7191,NE Airport Way & Mason Ct,13200,W,NS,1,4,5,0,Spring2018
7192,NE Airport Way & Mason Ct,13201,E,NS,1,4,5,0,Spring2018
7193,SW 158th & Greystone Ct,13202,N,AT,0,1,1,0,Spring2018
7194,NW Cornell & 158th,13205,E,NS,3,3,6,0,Spring2018
7195,SW 68th & Atlanta,13210,S,FS,5,2,7,0,Spring2018
7196,NE Hood & 5th,13211,S,NS,2,0,2,0,Spring2018
7197,N Richmond & Syracuse,13212,S,FS,28,4,32,6,Spring2018
7198,NW St Helens & Larson,13214,N,FS,0,1,1,0,Spring2018
7199,18100 Block SE River Rd,13215,S,AT,0,0,0,0,Spring2018
7200,SE Holgate & SE Holgate Blvd MAX Stn,13218,E,OP,75,78,153,50,Spring2018
7201,SE Holgate & SE Holgate Blvd MAX Stn,13219,W,AT,82,115,197,49,Spring2018
7208,SE Foster & 94th,13236,W,FS,328,17,345,38,Spring2018
7209,NW 35th & Yeon,13237,S,OP,7,2,9,0,Spring2018
7210,3300 Block NW 35th,13238,S,OP,7,0,7,0,Spring2018
7211,NW 35th & Guam,13239,S,NS,17,1,18,0,Spring2018
7212,3300 Block NW Guam,13240,E,OP,6,2,8,0,Spring2018
7213,NW Guam & 31st,13241,E,NS,19,0,19,0,Spring2018
7214,3100 Block NW 31st,13242,E,AT,17,2,19,0,Spring2018
7215,NW Saltzman & Thompson,13243,N,NS,5,4,9,0,Spring2018
7216,SE Harold & 130th,13244,E,NS,1,6,7,0,Spring2018
7217,SE 136th & Foster,13245,S,NS,7,13,20,0,Spring2018
7218,Clackamas Town Center TC,13247,E,FS,13,779,792,149,Spring2018
7219,Clackamas Town Center Transit Center,13248,S,AT,1126,321,1447,225,Spring2018
7220,SE 60th & Harrison,13249,N,NS,23,5,28,3,Spring2018
7221,Oatfield & E Hereford,13252,N,OP,7,2,9,0,Spring2018
7222,SE 10th & Washington,13255,S,NS,0,17,17,1,Spring2018
7223,9300 Block SW Taylor,13256,W,OP,1,0,1,0,Spring2018
7224,SW Taylor & Morrison,13257,W,NS,3,0,3,0,Spring2018
7225,SW Taylor & Valeria View,13258,W,NS,17,0,17,0,Spring2018
7226,SW Barnes & Valeria View,13259,S,FS,0,0,0,0,Spring2018
7227,SW Valeria View & Barnes,13260,N,FS,0,0,0,0,Spring2018
7228,SW Taylor & Windwood Way,13261,E,NS,0,4,4,0,Spring2018
7229,SW Taylor & Morrison,13262,E,FS,0,2,2,0,Spring2018
7230,9300 Block SW Taylor,13263,E,AT,0,0,0,0,Spring2018
7231,SW Taylor & 90th,13264,E,NS,0,0,0,0,Spring2018
7232,NW Leahy & Oak,13265,N,FS,0,0,0,0,Spring2018
7233,NW Leahy & Trillium Hollow,13266,W,AT,0,1,1,0,Spring2018
7234,NW Saltzman & Dogwood,13267,N,FS,3,4,7,0,Spring2018
7235,NW Saltzman & Westlawn Terrace,13268,N,FS,0,0,0,0,Spring2018
7236,NW Saltzman & Marshall,13269,N,NS,0,0,0,0,Spring2018
7237,NW Saltzman & Coleman,13270,N,NS,0,0,0,0,Spring2018
7238,NW Saltzman & 128th,13271,W,FS,0,1,1,0,Spring2018
7239,NW Saltzman & Burton,13272,N,FS,0,0,0,0,Spring2018
7240,NW Saltzman & Bauer Woods,13273,N,FS,0,0,0,0,Spring2018
7241,NW Saltzman & Creekside,13274,N,FS,0,0,0,0,Spring2018
7242,NW Saltzman & Hartford,13275,N,NS,0,0,0,0,Spring2018
7243,NW Thompson & 126th,13276,E,OP,0,1,1,0,Spring2018
7244,NW Thompson & 120th,13277,E,FS,0,1,1,0,Spring2018
7245,NW Thompson & Permian,13278,E,NS,1,1,2,0,Spring2018
7246,NW Thompson & Gerritz,13279,E,FS,0,0,0,0,Spring2018
7247,NW Thompson & McDaniel,13280,E,NS,0,1,1,0,Spring2018
7248,NW McDaniel & 111th Ct,13281,W,FS,0,0,0,0,Spring2018
7249,NW McDaniel & Blackhawk,13282,W,FS,0,0,0,0,Spring2018
7250,11800 Block NW McDaniel,13283,W,OP,1,1,2,0,Spring2018
7251,NW 119th & Kathleen Dr,13284,S,FS,0,0,0,0,Spring2018
7252,NW 119th & Maple Hill,13285,S,FS,0,0,0,0,Spring2018
7253,NW 119th & Old Quarry,13286,S,FS,0,0,0,0,Spring2018
7254,NW 119th & Sunningdale,13287,S,FS,0,0,0,0,Spring2018
7261,NW 119th & Coleman,13288,S,FS,0,0,0,0,Spring2018
7262,NW 119th & Vallevue,13289,S,FS,0,0,0,0,Spring2018
7263,NW 119th & Lovejoy,13290,S,FS,0,0,0,0,Spring2018
7264,NW 119th & Kearney,13291,S,FS,0,0,0,0,Spring2018
7265,NW 119th & Reeves,13292,S,FS,1,0,1,0,Spring2018
7266,NW St Helens & Saltzman,13293,N,OP,1,6,7,0,Spring2018
7267,NW St Helens & Saltzman,13294,S,FS,4,1,5,0,Spring2018
7268,SE Division & SE Division St MAX Station,13297,E,AT,334,98,432,63,Spring2018
7269,SE Division & SE Division St MAX Station,13298,W,OP,87,304,391,62,Spring2018
7270,SW Harrison & 6th,13305,W,NS,64,466,530,78,Spring2018
7271,NW Cornell & Murray,13309,E,NS,11,31,42,5,Spring2018
7272,SW Taylor & Selba Terrace,13310,W,OP,0,0,0,0,Spring2018
7273,SW Taylor & Selba Terrace,13311,E,NS,0,0,0,0,Spring2018
7274,NW Division & Wonderview,13312,W,NS,9,8,17,1,Spring2018
7275,Glenn Otto Park,13314,E,AT,7,5,12,2,Spring2018
7276,E Columbia River Hwy & SE Kibling,13315,W,OP,2,0,2,0,Spring2018
7277,SE 185th Ave/Rockwood,13320,S,NS,1,3,4,0,Spring2018
7278,2800 Block SW Hocken,13325,N,AT,4,9,13,0,Spring2018
7279,E Burnside & SE Sandy,13327,E,FS,205,364,569,163,Spring2018
7280,NE Couch & 12th,13328,W,NS,297,241,538,118,Spring2018
7281,NE Couch & 7th,13329,W,NS,142,104,246,18,Spring2018
7282,NE Couch & M L King,13330,W,NS,280,264,544,106,Spring2018
7283,E Columbia River Hwy & SE Jackson Park,13331,S,NS,0,0,0,0,Spring2018
7284,E Columbia River Hwy & SE Jackson Park,13332,N,OP,1,0,1,0,Spring2018
7285,E Burnside & E 181st Ave Park & Ride,13345,E,AT,0,1,1,0,Spring2018
7286,SW Capitol & Carson,13347,N,FS,6,1,7,1,Spring2018
7287,Civic Drive MAX Station,13449,W,AT,324,83,407,0,Spring2018
7288,Civic Drive MAX Station,13450,E,AT,90,323,413,0,Spring2018
7289,NW McDaniel & Harding Ct,13455,W,FS,1,0,1,0,Spring2018
7290,Oatfield & Webster,13458,N,FS,7,1,8,1,Spring2018
7291,Webster & Oatfield,13459,N,FS,5,2,7,0,Spring2018
7292,NW Cornell & 118th,13465,E,FS,12,6,18,0,Spring2018
7293,NE Kane & SE 1st,13468,S,NS,6,3,9,1,Spring2018
7294,SE Kane & 5th St,13469,S,FS,0,1,1,2,Spring2018
7295,SE Kane & 5th St,13470,N,NS,1,1,2,2,Spring2018
7296,SE Division & 156th,13471,E,OP,33,84,117,44,Spring2018
7297,NE Columbia Blvd & 47th,13472,W,FS,25,46,71,3,Spring2018
7298,E Powell & NE Elliott,13473,W,NS,0,0,0,0,Spring2018
7299,E Powell & NE Elliott,13474,E,OP,0,1,1,0,Spring2018
7300,SE 257th/Kane & Powell Valley,13475,S,FS,0,2,2,0,Spring2018
7301,SE Kane & Powell Valley,13476,N,FS,5,13,18,0,Spring2018
7302,SE Jackson & Main,13477,E,FS,171,188,359,37,Spring2018
7303,N Fessenden & Iris Way,13479,W,FS,16,77,93,15,Spring2018
7304,NE Glisan & 127th,13480,W,FS,1,1,2,0,Spring2018
7305,8300 Block SW Hall,13481,W,AT,55,27,82,12,Spring2018
7306,SE 21st & Jackson,13482,S,NS,112,285,397,82,Spring2018
7307,10100 Block SW Commerce Circle,13493,E,AT,40,39,79,38,Spring2018
7314,SE Hwy 224 & Dowty Rd,13495,S,FS,0,0,0,0,Spring2018
7315,SE Hwy 224 & Dowty Rd,13496,N,OP,0,0,0,0,Spring2018
7316,50 Block NE Gertz Rd,13497,E,OP,9,59,68,19,Spring2018
7317,SW 198th & Rock Rd,13498,N,NS,6,6,12,0,Spring2018
7318,3300 Block SW 198th,13499,N,OP,17,44,61,8,Spring2018
7319,SW Heiney & 18th Terrace,13500,N,OP,1,2,3,0,Spring2018
7320,SW Heiney & 18th Terrace,13501,S,NS,4,2,6,0,Spring2018
7321,SW Towle & 17th Ct,13502,N,NS,1,0,1,0,Spring2018
7322,NE Halsey & 208th Pl,13505,W,FS,14,5,19,0,Spring2018
7323,Gresham Transit Center,13506,E,FS,1,12,13,2,Spring2018
7324,SW 198th & Oak Ct,13517,S,FS,3,3,6,0,Spring2018
7325,19400 Block SE Stark,13523,W,AT,16,16,32,6,Spring2018
7326,N Columbia Blvd & Burgard,13526,N,NS,0,0,0,0,Spring2018
7327,N Lombard & Burgard,13527,S,NS,0,0,0,1,Spring2018
7328,NE Evergreen & Evergreen Middle School,13528,W,OP,1,1,2,0,Spring2018
7329,NE Century (NW 229th) & Brighton St,13529,S,FS,3,5,8,0,Spring2018
7330,NW Cornell & 188th,13530,E,FS,18,28,46,5,Spring2018
7331,NW Graham/257th & W Columbia River Hwy,13532,N,FS,3,57,60,3,Spring2018
7332,SE Powell & Powell Garage Dr,13542,E,NS,0,24,24,1,Spring2018
7333,SW Langer & Holland,13546,W,FS,3,19,22,3,Spring2018
7334,SE Stark & 169th,13547,W,NS,31,10,41,14,Spring2018
7335,E Main & SE 33rd,13548,E,NS,12,5,17,1,Spring2018
7336,SE Powell Valley & Ironwood Flag Stop,13551,E,AT,0,0,0,0,Spring2018
7337,SE 282nd & Salquist Flag Stop,13552,S,FS,1,0,1,0,Spring2018
7338,SE 282nd & Welch Rd,13553,S,NS,1,0,1,0,Spring2018
7339,SE 257th/Kane & 11th,13554,S,NS,0,1,1,0,Spring2018
7340,SE Orient Dr & Chase,13555,S,OP,0,1,1,0,Spring2018
7341,SE Orient Dr & Chase,13558,N,FS,0,0,0,0,Spring2018
7342,SE 257th/Kane & 11th,13559,N,NS,3,0,3,0,Spring2018
7343,SE 282nd & Welch Rd,13560,N,FS,0,2,2,0,Spring2018
7344,SE 282nd & Salquist Flag Stop,13561,N,OP,0,2,2,0,Spring2018
7345,Powell Valley & Old Woods Lp Flag Stop,13562,W,AT,0,0,0,0,Spring2018
7346,S Buxton & SW 2nd,13569,S,FS,6,1,7,1,Spring2018
7347,NE M L King & Winchell,13570,S,NS,63,15,78,10,Spring2018
7348,SW Dosch & Doschview,13571,N,NS,0,0,0,0,Spring2018
7349,2600 Block SW Ravensview,13572,N,AT,3,0,3,0,Spring2018
7350,2500 Block SW Vista,13573,W,OP,0,3,3,0,Spring2018
7351,SE Mather & Summers Ln,13576,N,FS,0,8,8,0,Spring2018
7352,12900 Block SW Canyon,13577,E,AT,3,33,36,1,Spring2018
7353,6500 Block SW Taylors Ferry,13578,W,OP,0,1,1,0,Spring2018
7354,SW Farmington & Rosa Rd,13579,W,NS,12,19,31,0,Spring2018
7355,9900 Block SW Hall,13581,S,AT,5,7,12,1,Spring2018
7356,SW Blum & Palmblad,13582,W,FS,1,5,6,0,Spring2018
7357,72nd & Cardinal,13583,S,FS,0,6,6,0,Spring2018
7358,SE M L King & Morrison,13584,S,FS,29,106,135,31,Spring2018
7359,NW Cornell & 118th,13586,W,OP,7,14,21,0,Spring2018
7360,SW Hamilton & 52nd,13587,W,FS,0,2,2,0,Spring2018
7367,SW Summit Dr & Greenburg,13588,E,NS,20,16,36,0,Spring2018
7368,SW Summit Dr & Palmblad,13589,W,NS,12,17,29,1,Spring2018
7369,SW 72nd & Cherry Dr,13590,S,NS,1,3,4,0,Spring2018
7370,NE Sandy & 104th,13591,W,OP,25,25,50,6,Spring2018
7371,Beavercreek & Danielson Dr,13592,W,NS,74,14,88,18,Spring2018
7372,NE 238th & Halsey,13594,N,FS,15,23,38,4,Spring2018
7373,SE Stark & 85th,13596,W,NS,21,5,26,2,Spring2018
7374,SE Grand & Stark,13597,N,FS,129,49,178,77,Spring2018
7375,800 Block NE 181st,13598,S,OP,7,6,13,0,Spring2018
7376,SW Moody & Meade South,13601,S,AT,74,27,101,10,Spring2018
7377,Willamette Dr & Webb,13603,N,NS,2,0,2,0,Spring2018
7378,SE M L King & Stark,13613,S,FS,43,116,159,64,Spring2018
7379,700 Block NW Naito Parkway,13621,S,AT,2,3,5,0,Spring2018
7380,N Hayden Island Dr & Tomahawk Island Dr,13629,N,FS,7,50,57,8,Spring2018
7381,Relay Resources,13630,N,AT,8,15,23,3,Spring2018
7382,Hwy 224 & Paul Bunyan Ln,13631,E,NS,0,0,0,0,Spring2018
7383,Hwy 224  & Paul Bunyan Ln,13632,W,OP,0,0,0,0,Spring2018
7384,NE 9th & Hassalo,13633,S,NS,47,32,79,3,Spring2018
7385,N Vancouver Way & Jubitz,13635,N,OP,10,19,29,6,Spring2018
7386,SW Main & Commercial,13636,E,FS,76,87,163,6,Spring2018
7387,NW Yeon & 44th,13637,E,NS,28,95,123,2,Spring2018
7388,NE 102nd & Sandy,13639,N,NS,8,8,16,2,Spring2018
7389,SW Jenkins & Murray,13640,W,NS,2,1,3,0,Spring2018
7390,N Vancouver Way & Jubitz,13643,S,AT,28,10,38,4,Spring2018
7391,Kerr & Hidalgo,13645,S,FS,3,4,7,0,Spring2018
7392,SW 40th & Troy,13647,S,FS,1,3,4,1,Spring2018
7393,N Vancouver Way & NE Middlefield,13648,N,NS,2,20,22,0,Spring2018
7394,900 Block Washington,13649,S,AT,3,3,6,12,Spring2018
7395,SE Orient Dr & Elsa St,13650,E,NS,0,0,0,0,Spring2018
7396,NE Sandy & 87th,13651,E,OP,3,20,23,7,Spring2018
7397,20300 Block SE Hwy 224,13654,W,AT,0,0,0,0,Spring2018
7398,20200 Block SE Hwy 224,13655,E,AT,0,0,0,0,Spring2018
7399,SE Hwy 224 & McPartland,13657,W,FS,0,0,0,0,Spring2018
7400,SE Hwy 224 & Eckert Ln,13662,N,NS,3,0,3,0,Spring2018
7401,SE Hwy 224 & Goosehollow,13663,N,NS,4,0,4,0,Spring2018
7402,NW Laidlaw & Preakness,13666,W,FS,6,3,9,0,Spring2018
7403,NW Laidlaw & 167th Pl,13667,W,OP,1,0,1,0,Spring2018
7404,NW Laidlaw & Cove,13668,S,OP,2,1,3,0,Spring2018
7405,NW Laidlaw & West Union,13669,S,FS,4,2,6,0,Spring2018
7406,NW Laidlaw & Emerald Canyon,13670,S,FS,2,1,3,0,Spring2018
7407,NW 174th & Lonerock,13671,S,FS,3,1,4,1,Spring2018
7408,NW 174th & Bethany Elem School,13672,S,AT,5,2,7,0,Spring2018
7409,NW 174th & Parkview,13673,S,FS,1,2,3,0,Spring2018
7410,NW Bronson & 179th,13674,W,FS,0,1,1,0,Spring2018
7411,3100 Block NW Bronson,13675,W,AT,8,6,14,0,Spring2018
7412,3100 Block NW Bronson,13676,E,OP,6,8,14,0,Spring2018
7413,NW 174th & Bethany Elem School,13678,N,OP,1,3,4,0,Spring2018
7420,NW 174th & Lonerock,13679,N,FS,2,3,5,0,Spring2018
7421,NW Laidlaw & Emerald Canyon,13680,N,FS,1,3,4,0,Spring2018
7422,NW Laidlaw & Cove,13681,N,FS,2,2,4,0,Spring2018
7423,NW Laidlaw & 167th Pl,13682,E,FS,0,1,1,0,Spring2018
7424,NW Laidlaw & Preakness,13683,E,OP,2,5,7,0,Spring2018
7425,NW Laidlaw & Bethany,13685,E,NS,4,21,25,1,Spring2018
7426,Morrison Bridge/Belmont & Grand,13689,E,NS,84,98,182,48,Spring2018
7427,NW Laidlaw & West Union,13691,N,NS,1,4,5,0,Spring2018
7428,NW 174th & Parkview,13692,N,NS,2,2,4,0,Spring2018
7429,SE 17th & Rhine,13693,N,FS,53,46,99,1,Spring2018
7430,SE Division & 42nd,13696,E,OP,31,53,84,22,Spring2018
7431,SW Shattuck & 59th Ct,13703,N,FS,3,4,7,0,Spring2018
7432,SE 17th & Rhine,13704,S,FS,41,45,86,3,Spring2018
7433,3300 Block SW 198th,13705,S,AT,31,22,53,7,Spring2018
7434,SW 197th & Limestone Ct,13706,N,FS,6,5,11,30,Spring2018
7435,SE 82nd & Center,13707,S,NS,56,184,240,36,Spring2018
7436,Lincoln St/SW 3rd Ave MAX Station,13710,E,AT,332,216,548,0,Spring2018
7437,South Waterfront/SW Moody MAX Station,13711,E,AT,600,501,1101,0,Spring2018
7438,OMSI/SE Water MAX Station,13712,E,AT,169,174,343,0,Spring2018
7439,Clinton St/SE 12th Ave MAX Station,13713,E,AT,142,338,480,0,Spring2018
7440,SE 17th Ave & Rhine St MAX Station,13714,S,AT,102,293,395,0,Spring2018
7441,SE 17th Ave & Holgate Blvd MAX Station,13715,S,AT,102,356,458,0,Spring2018
7442,SE Bybee Blvd MAX Station,13716,S,AT,46,456,502,0,Spring2018
7443,SE Tacoma/Johnson Creek MAX Station,13717,S,AT,55,682,737,0,Spring2018
7444,Milwaukie/Main St MAX Station,13718,S,AT,56,693,749,0,Spring2018
7445,SE Park Ave MAX Station,13720,N,AT,1767,1767,3534,0,Spring2018
7446,Milwaukie/Main St MAX Station,13721,N,AT,689,46,735,0,Spring2018
7447,SE Tacoma/Johnson Creek MAX Station,13722,N,AT,694,52,746,0,Spring2018
7448,SE Bybee Blvd MAX Station,13723,N,AT,423,44,467,0,Spring2018
7449,SE 17th Ave & Holgate Blvd MAX Station,13724,N,AT,378,85,463,0,Spring2018
7450,SE 17th Ave & Rhine St MAX Station,13725,N,AT,291,76,367,0,Spring2018
7451,Clinton St/SE 12th Ave MAX Station,13726,W,AT,340,143,483,0,Spring2018
7452,OMSI/SE Water MAX Station,13727,W,AT,155,169,324,0,Spring2018
7453,South Waterfront/SW Moody MAX Station,13728,W,AT,449,667,1116,0,Spring2018
7454,Lincoln St/SW 3rd Ave MAX Station,13729,W,AT,250,402,652,0,Spring2018
7455,South Waterfront/SW Moody,13732,E,AT,388,92,480,35,Spring2018
7456,South Waterfront/SW Moody,13733,W,AT,143,380,523,44,Spring2018
7457,SW Boones Ferry & Orchard Hill,13735,N,FS,5,0,5,0,Spring2018
7458,SW Beveland & 69th,13736,W,FS,57,6,63,0,Spring2018
7459,NE Glisan & 45th,13737,E,NS,18,39,57,17,Spring2018
7460,SE Division & 23rd,13741,W,FS,34,28,62,9,Spring2018
7461,Washington & 12th,13743,S,NS,1,5,6,12,Spring2018
7462,SE 32nd & Furat Ct,13744,S,FS,3,14,17,1,Spring2018
7463,12100 N Pavilion,13748,N,NS,101,5,106,34,Spring2018
7464,27400 Block SE Eagle Creek Rd,13749,S,OP,0,0,0,0,Spring2018
7465,SE Division & 36th,13753,E,FS,31,95,126,10,Spring2018
7466,SE River Rd & Torbank,13756,S,NS,3,7,10,1,Spring2018
7473,SE Ellis & 89th,13757,W,NS,6,1,7,0,Spring2018
7474,SW Langer & Holland,13766,E,NS,25,2,27,7,Spring2018
7475,1500 Block SW Sunset Blvd,13767,S,OP,0,0,0,0,Spring2018
7476,SW Vermont & 34th,13768,W,FS,2,27,29,0,Spring2018
7477,SW Vermont & 34th,13769,E,FS,26,4,30,1,Spring2018
7478,SE Tacoma Park & Ride,13770,S,AT,11,48,59,2,Spring2018
7479,SE Tacoma Park & Ride,13771,N,AT,38,15,53,4,Spring2018
7480,OMSI/SE Water,13772,E,AT,83,29,112,19,Spring2018
7481,OMSI/SE Water,13773,W,AT,39,89,128,17,Spring2018
7482,SE 122nd & Raymond,13775,S,FS,5,26,31,19,Spring2018
7483,SE 21st & Adams,13776,N,NS,9,29,38,4,Spring2018
7484,SE Washington & 21st,13777,E,NS,125,110,235,29,Spring2018
7485,SE Division Pl & 8th,13778,E,NS,18,27,45,2,Spring2018
7486,SW Hall & 5th,13780,W,NS,28,312,340,47,Spring2018
7487,SE Bybee & Bybee Blvd MAX Station,13781,E,AT,67,10,77,30,Spring2018
7488,SE Bybee & Bybee Blvd MAX Station,13782,W,AT,16,65,81,13,Spring2018
7489,SE Linwood & King,13783,N,FS,6,7,13,1,Spring2018
7490,SE Linwood & King,13784,S,NS,3,5,8,0,Spring2018
7491,SE Linwood & Needham Ct,13785,N,NS,2,1,3,0,Spring2018
7492,9700 Block SE Linwood,13786,S,AT,1,2,3,0,Spring2018
7493,SE Johnson Creek & 58th Dr,13787,W,FS,3,1,4,3,Spring2018
7494,SE Johnson Creek & Wichita,13788,E,NS,1,4,5,0,Spring2018
7495,SE Johnson Creek & Stanley,13789,W,FS,3,2,5,0,Spring2018
7496,SE Johnson Creek & Stanley,13790,E,OP,1,4,5,0,Spring2018
7497,SE Milwaukie & Gideon,13791,S,FS,115,73,188,27,Spring2018
7498,SE Powell & 12th,13792,E,NS,243,197,440,46,Spring2018
7499,3700 Block SW Huber,13794,E,AT,1,0,1,0,Spring2018
7500,4900 Block SE Johnson Creek,13805,W,AT,2,1,3,0,Spring2018
7501,4900 Block SE Johnson Creek,13806,E,OP,1,2,3,0,Spring2018
7502,SE Johnson Creek & 32nd,13807,E,FS,2,1,3,1,Spring2018
7503,NE Halsey & Wood Village,13809,W,FS,69,19,88,25,Spring2018
7504,SW Kelly & Gibbs,13815,S,FS,11,4,15,1,Spring2018
7505,SW Macadam & Sellwood Bridge,13816,S,NS,3,6,9,2,Spring2018
7506,SW Macadam & Sellwood Bridge,13817,N,FS,5,3,8,1,Spring2018
7507,10400 Block NE 6th Dr,13818,S,OP,2,0,2,0,Spring2018
7508,SE 7th & Tilikum Way,13825,N,NS,23,27,50,3,Spring2018
7509,SW Tualatin-Sherwood Rd & 90th,13827,W,NS,3,0,3,0,Spring2018
7510,SW Tualatin-Sherwood Rd & 95th,13828,W,NS,0,2,2,0,Spring2018
7511,SW Tualatin-Sherwood Rd & Teton,13829,W,NS,0,5,5,0,Spring2018
7512,SW Tualatin-Sherwood Rd & 112th,13830,W,NS,1,6,7,0,Spring2018
7513,SW Tualatin-Sherwood Rd & 115th,13831,W,NS,1,6,7,0,Spring2018
7514,SW Tualatin-Sherwood Rd & 124th,13832,W,NS,0,0,0,0,Spring2018
7515,SW Tualatin-Sherwood Rd & Cipole,13833,W,NS,1,2,3,0,Spring2018
7516,SW Tualatin-Sherwood Rd & Oregon St,13834,W,OP,0,3,3,0,Spring2018
7517,SW Tualatin-Sherwood Rd & Gerda Ln,13835,W,NS,0,3,3,0,Spring2018
7518,SW Tualatin-Sherwood Rd & Langer Farms,13836,W,OP,0,4,4,0,Spring2018
7519,SW Tualatin-Sherwood Rd & Langer Farms,13837,E,FS,3,0,3,0,Spring2018
7526,SW Tualatin-Sherwood Rd & Gerda Ln,13838,E,OP,2,0,2,0,Spring2018
7527,SW Tualatin-Sherwood Rd & Oregon St,13839,E,NS,2,0,2,0,Spring2018
7528,SW Tualatin-Sherwood Rd & Cipole,13840,E,OP,2,1,3,0,Spring2018
7529,SW Tualatin-Sherwood Rd & 124th,13841,E,OP,0,0,0,0,Spring2018
7530,SW Tualatin-Sherwood Rd & 115th,13842,E,NS,5,1,6,0,Spring2018
7531,SW Tualatin-Sherwood Rd & Avery,13843,E,NS,4,1,5,0,Spring2018
7532,SW Tualatin-Sherwood Rd & Teton,13844,E,NS,2,1,3,0,Spring2018
7533,SW Tualatin-Sherwood Rd & 95th,13845,E,NS,1,1,2,0,Spring2018
7534,SW Tualatin-Sherwood Rd & 90th,13846,E,NS,0,2,2,0,Spring2018
7535,SW Tualatin-Sherwood Rd & Boones Ferry,13847,E,NS,0,13,13,0,Spring2018
7536,Jean Rd & Pilkington,13854,W,FS,2,2,4,1,Spring2018
7537,Jean Rd & Jean Way,13855,W,NS,0,1,1,0,Spring2018
7538,Jean Rd & Jean Way,13856,E,FS,0,0,0,0,Spring2018
7539,Jean Rd & Pilkington,13857,E,FS,2,1,3,0,Spring2018
7540,NE Cornell & Elam Young East,13858,E,FS,5,4,9,1,Spring2018
7541,SE 282nd & Powell Valley,13867,N,NS,1,3,4,5,Spring2018
7542,1400 Block NW Naito Parkway,13868,S,OP,1,1,2,0,Spring2018
7543,N Syracuse & Chicago,13869,S,FS,9,32,41,40,Spring2018
7544,SW Pacific Hwy & Dartmouth,13870,N,FS,45,38,83,9,Spring2018
7545,SE Monterey & Fuller,13871,E,FS,6,4,10,0,Spring2018
7546,8000 Block SE Monterey,13872,E,OP,1,4,5,2,Spring2018
7547,8000 Block SE Monterey,13873,W,AT,3,1,4,0,Spring2018
7548,SE Monterey & Fuller,13874,W,NS,6,3,9,2,Spring2018
7549,N St Louis & Lombard,13876,W,NS,2,88,90,25,Spring2018
7550,N Lombard & St Louis,13877,N,NS,83,108,191,59,Spring2018
7551,SE Division & 178th,13878,E,OP,21,76,97,13,Spring2018
7552,2500 Block NW Division,13879,W,AT,15,8,23,2,Spring2018
7553,2600 Block NW Division,13880,E,AT,14,18,32,3,Spring2018
7554,14200 Block SE Division,13881,E,AT,16,52,68,3,Spring2018
7555,NE Halsey & 92nd,13883,W,FS,8,6,14,1,Spring2018
7556,SE Sunnyside & 157th,13884,E,NS,1,21,22,0,Spring2018
7557,SE Sunnyside & 162nd,13885,E,NS,4,12,16,0,Spring2018
7558,SE 169th & Misty,13887,N,NS,7,25,32,1,Spring2018
7559,SE 172nd & Sunnyside,13888,S,NS,21,16,37,4,Spring2018
7560,SE Sunnyside & 169th,13889,W,NS,9,0,9,0,Spring2018
7561,SE Sunnyside & 162nd,13890,W,FS,9,1,10,1,Spring2018
7562,SW Boones Ferry & Trillium,13891,S,NS,0,1,1,0,Spring2018
7563,NE Multnomah & 21st,13892,W,FS,5,3,8,0,Spring2018
7564,SE Division & Tamarack,13893,W,FS,40,47,87,21,Spring2018
7565,NE M L King & Stanton,13898,N,FS,10,39,49,2,Spring2018
7566,NW 21st & Pettygrove,13899,S,NS,76,2,78,2,Spring2018
7567,SW Hall & Langtree,13900,S,NS,1,6,7,0,Spring2018
7568,Division & 14th,13903,S,FS,3,7,10,7,Spring2018
7569,SE 72nd & Clatsop,13904,N,FS,22,9,31,9,Spring2018
7570,N Hayden Meadows Dr & Kerby,13905,E,NS,5,3,8,1,Spring2018
7571,N Union Ct & East Delta Park Entrance,13906,N,FS,4,4,8,3,Spring2018
7572,N Union Ct & East Delta Park Entrance,13907,S,AT,1,10,11,3,Spring2018
7579,N Hayden Meadows Dr & Kerby,13908,W,FS,1,6,7,1,Spring2018
7580,1100 Block N Hayden Meadows Dr,13909,S,AT,20,56,76,55,Spring2018
7581,9800 Block N Whitaker,13910,N,NS,16,19,35,4,Spring2018
7582,9800 Block NE Prescott,13913,W,AT,2,6,8,1,Spring2018
7583,NE Prescott & 96th,13914,W,NS,1,15,16,10,Spring2018
7584,SW Farmington & Rose Ln,13916,W,FS,18,36,54,14,Spring2018
7585,SW Farmington & Rose Ln,13917,E,NS,36,18,54,16,Spring2018
7586,SW Alder & 18th,13918,E,NS,77,178,255,17,Spring2018
7587,SW Denney & Queen,13924,E,FS,2,5,7,0,Spring2018
7588,SW Denney & 111th,13925,E,OP,2,4,6,0,Spring2018
7589,SW Hall & Oak,13927,S,NS,2,2,4,1,Spring2018
7590,SW Hall & Pfaffle,13928,S,NS,1,5,6,0,Spring2018
7591,11700 Block SW Hall,13929,S,OP,0,5,5,1,Spring2018
7592,SW Hall & Hunziker/Scoffins,13930,S,NS,2,2,4,0,Spring2018
7593,SW Lombard & Bruce Ln,13931,S,NS,4,9,13,10,Spring2018
7594,SW Hall & Scoffins/Hunziker,13932,N,NS,1,2,3,0,Spring2018
7595,11700 Block SW Hall,13933,N,AT,3,1,4,1,Spring2018
7596,SW Hall & Pfaffle,13934,N,FS,7,1,8,1,Spring2018
7597,SW Hall & Oak,13935,N,NS,2,1,3,0,Spring2018
7598,SW Denney & 103rd,13936,W,NS,10,5,15,4,Spring2018
7599,SW Denney & 111th,13937,W,NS,5,2,7,0,Spring2018
7600,SW Lombard & Cheshire,13938,N,FS,9,3,12,1,Spring2018
7601,NE 166th & Airport Way,13939,N,FS,1,1,2,0,Spring2018
7602,16200 Block NE Cameron,13940,W,AT,4,2,6,0,Spring2018
7603,NE 158th & Airport Way,13941,S,NS,4,0,4,0,Spring2018
7604,NE 158th & Mason,13942,S,NS,2,0,2,0,Spring2018
7605,NE 162nd & Fargo,13943,S,NS,5,0,5,1,Spring2018
7606,NE 162nd & Thompson,13944,S,NS,3,0,3,0,Spring2018
7607,NE 162nd & San Rafael,13945,S,NS,2,0,2,0,Spring2018
7608,NE 162nd & Halsey,13946,S,NS,17,4,21,5,Spring2018
7609,NE 162nd & Holladay,13947,S,FS,2,1,3,1,Spring2018
7610,NE 162nd & Glisan,13948,S,FS,16,5,21,3,Spring2018
7611,NE 162nd & E Burnside,13949,S,NS,26,29,55,12,Spring2018
7612,600 Block SE 162nd,13950,S,OP,34,15,49,12,Spring2018
7613,SE 162nd & Main,13951,S,FS,6,4,10,5,Spring2018
7614,SE Division & 49th,13952,E,FS,24,52,76,14,Spring2018
7615,SE 162nd & Mill,13953,S,FS,1,4,5,2,Spring2018
7616,SE 162nd & Grant,13954,S,NS,1,5,6,4,Spring2018
7617,SE 162nd & Division,13955,S,FS,10,46,56,24,Spring2018
7618,SE 162nd & Tibbets,13956,S,OP,0,3,3,0,Spring2018
7619,SE Powell & 162nd,13957,E,FS,9,43,52,5,Spring2018
7620,3700 Block SE 162nd,13958,N,AT,6,1,7,2,Spring2018
7621,SE 162nd & Tibbets,13959,N,FS,4,1,5,0,Spring2018
7622,SE 162nd & Division,13960,N,FS,49,12,61,20,Spring2018
7623,2000 Block SE162nd,13961,N,AT,5,1,6,2,Spring2018
7624,SE 162nd & Mill,13962,N,FS,8,2,10,1,Spring2018
7625,SE 162nd & Main,13963,N,FS,5,7,12,6,Spring2018
7632,SE 162nd & Stark,13964,N,FS,15,29,44,16,Spring2018
7633,NE 162nd & E Burnside,13965,N,FS,22,42,64,14,Spring2018
7634,600 Block NE 162nd,13966,N,OP,7,17,24,6,Spring2018
7635,NE 162nd & Holladay,13967,N,NS,0,2,2,1,Spring2018
7636,NE 162nd & Halsey,13968,N,FS,3,19,22,3,Spring2018
7637,NE 162nd & San Rafael,13969,N,FS,0,2,2,0,Spring2018
7638,NE 162nd & Thompson,13970,N,OP,0,2,2,0,Spring2018
7639,NE 162nd & Fargo,13971,N,NS,0,6,6,1,Spring2018
7640,NE 158th & Mason,13972,N,FS,2,2,4,0,Spring2018
7641,SE 1st & 3rd,13973,S,NS,6,8,14,3,Spring2018
7642,SE 3rd & 1st,13974,N,NS,3,0,3,4,Spring2018
7643,1200 Block NW Swigert Way,13975,E,AT,2,3,5,0,Spring2018
7644,1500 Block NE Graham Rd,13976,S,FS,1,0,1,0,Spring2018
7645,900 Block NE Graham Rd,13977,S,AT,3,0,3,0,Spring2018
7646,SE Hwy 224 & Oak,13978,E,NS,2,1,3,1,Spring2018
7647,SE Harmony & Fuller,13980,E,FS,1,0,1,0,Spring2018
7648,7700 Blk SE Harmony (Clack. Comm. College),13981,E,AT,1,1,2,0,Spring2018
7649,SE Harmony & Fuller,13983,W,FS,5,3,8,0,Spring2018
7650,SE Harmony & Cedarcrest,13984,W,NS,7,11,18,0,Spring2018
7651,SE Harmony & International Way,13985,S,NS,2,4,6,0,Spring2018
7652,SE Hwy 224 & Oak,13986,N,FS,2,3,5,2,Spring2018
7653,900 Block NE Graham Rd,13988,N,OP,2,5,7,0,Spring2018
7654,1500 Block NE Graham Rd,13989,N,AT,0,0,0,0,Spring2018
7655,NW Graham & N Entrance Rd,13990,W,NS,0,0,0,0,Spring2018
7656,NW Sundial & Rogers Circle,13991,N,OP,10,13,23,0,Spring2018
7657,SW Hall & Locust,13992,N,NS,4,3,7,0,Spring2018
7658,Molalla & Warner-Milne,13993,N,FS,4,1,5,1,Spring2018
7659,SW Moody & River Pkwy,13994,S,FS,7,11,18,12,Spring2018
7660,10800 SW Walnut,14000,E,AT,1,0,1,0,Spring2018
7661,SW Denney & 100th Terr,14003,E,NS,3,13,16,0,Spring2018
7662,SE Stark & 127th,14004,W,NS,20,12,32,9,Spring2018
