,location,location_id,direction,position,ons,offs,total,lifts,period
747,A Ave & Chandler,2,E,NS,0,1,1,0,Fall2018
748,A Ave & Second St,3,E,FS,21,9,30,1,Fall2018
744,A Ave & 10th St,4,W,NS,1,0,1,0,Fall2018
745,A Ave & 8th St,6,E,NS,0,2,2,0,Fall2018
746,A Ave & 8th St,7,W,NS,1,0,1,0,Fall2018
694,900 Block Abernethy,8,E,AT,0,0,0,0,Fall2018
749,Abernethy & Barclay,9,N,NS,1,0,1,0,Fall2018
750,Abernethy & Barclay,10,S,OP,1,1,2,0,Fall2018
751,Abernethy & Beatrice,11,E,FS,0,0,0,0,Fall2018
752,Abernethy & Center,12,W,NS,1,1,2,0,Fall2018
753,Abernethy & Duniway,13,N,NS,0,0,0,0,Fall2018
754,Abernethy & Duniway,14,S,OP,0,0,0,1,Fall2018
755,Abernethy & Portland Ave,16,W,FS,3,4,7,7,Fall2018
756,Abernethy & Portland Ave,17,E,NS,3,3,6,4,Fall2018
378,2800 Block NE 92nd,20,N,AT,0,0,0,0,Fall2018
379,2800 Block NE 92nd,21,S,AT,0,0,0,0,Fall2018
443,3400 Block NE 92nd,25,N,AT,2,5,7,0,Fall2018
2186,NE 92nd & Hill,26,S,NS,7,1,8,0,Fall2018
1282,N Adair & 7th,27,W,FS,10,25,35,2,Fall2018
318,2200 Block Baseline,28,W,AT,46,73,119,40,Fall2018
1276,N Adair & 10th,30,W,NS,1,6,7,0,Fall2018
1277,N Adair & 12th,31,W,NS,37,87,124,4,Fall2018
1278,N Adair & 14th,32,W,NS,23,51,74,6,Fall2018
1279,N Adair & 17th,33,W,FS,9,15,24,2,Fall2018
1280,N Adair & 20th,34,W,FS,24,38,62,9,Fall2018
1281,N Adair & 4th,35,W,FS,55,140,195,57,Fall2018
1648,N Trenton & Alaska,40,E,NS,55,20,75,46,Fall2018
1284,N Alaska & Chautauqua,41,E,NS,41,8,49,4,Fall2018
1285,N Alaska & Chautauqua Pl,42,E,OP,37,15,52,7,Fall2018
1286,N Alaska & Chautauqua Pl,43,W,NS,13,32,45,2,Fall2018
1287,N Alaska & Foss,44,E,OP,21,14,35,21,Fall2018
1288,N Alaska & University Park,45,W,OP,11,28,39,18,Fall2018
2243,NE Alberta & M L King ,46,E,FS,115,45,160,27,Fall2018
2218,NE Alberta & 11th,48,E,NS,12,15,27,2,Fall2018
2219,NE Alberta & 11th,49,W,NS,11,12,23,6,Fall2018
2226,NE Alberta & 13th,50,E,NS,25,14,39,23,Fall2018
2227,NE Alberta & 13th,51,W,NS,13,20,33,14,Fall2018
2228,NE Alberta & 15th,52,E,NS,83,89,172,29,Fall2018
2229,NE Alberta & 15th,53,W,NS,100,100,200,28,Fall2018
2230,NE Alberta & 18th,54,E,NS,31,32,63,5,Fall2018
2231,NE Alberta & 18th,55,W,NS,3,13,16,0,Fall2018
2234,NE Alberta & 24th,60,E,NS,28,28,56,4,Fall2018
2235,NE Alberta & 24th,61,W,NS,31,28,59,4,Fall2018
2236,NE Alberta & 27th,63,E,NS,43,41,84,15,Fall2018
2237,NE Alberta & 27th,64,W,NS,44,44,88,17,Fall2018
4227,SE Alberta & 70th,67,E,OP,5,7,12,5,Fall2018
4228,SE Alberta & 70th,68,W,NS,4,5,9,4,Fall2018
2241,NE Alberta & 9th,69,E,NS,39,35,74,16,Fall2018
2242,NE Alberta & 9th,70,W,NS,32,33,65,10,Fall2018
1289,N Albina & Ainsworth,71,N,FS,20,33,53,4,Fall2018
1290,N Albina & Ainsworth,72,S,NS,37,20,57,4,Fall2018
1291,N Albina & Alberta,73,N,NS,23,51,74,15,Fall2018
1292,N Albina & Alberta,74,S,FS,51,26,77,9,Fall2018
1293,N Albina & Blandena,76,N,FS,28,52,80,62,Fall2018
1294,N Albina & Blandena,77,S,FS,58,30,88,93,Fall2018
1295,N Albina & Bryant,78,N,NS,11,22,33,4,Fall2018
1296,N Albina & Bryant,79,S,NS,28,15,43,3,Fall2018
1297,N Albina & Buffalo,80,N,NS,3,11,14,0,Fall2018
1298,N Albina & Buffalo,81,S,NS,14,5,19,1,Fall2018
1299,N Albina & Dekum,82,N,NS,9,18,27,13,Fall2018
1300,N Albina & Dekum,83,S,NS,24,15,39,23,Fall2018
1301,N Albina & Holman,84,N,OP,2,9,11,1,Fall2018
1302,N Albina & Killingsworth,88,N,FS,239,245,484,64,Fall2018
1303,N Albina & Killingsworth,89,S,FS,263,228,491,60,Fall2018
1304,N Albina & Lombard St,90,S,FS,66,19,85,3,Fall2018
1306,N Albina & Rosa Parks Way,91,N,FS,19,33,52,9,Fall2018
1307,N Albina & Rosa Parks Way,92,S,FS,42,19,61,23,Fall2018
1305,N Albina & Lombard St,93,N,NS,8,62,70,4,Fall2018
1308,N Albina & Sumner,94,N,NS,41,46,87,3,Fall2018
1309,N Albina & Sumner,95,S,NS,47,55,102,2,Fall2018
5958,SW Allen & Dale,99,E,NS,9,2,11,0,Fall2018
5959,SW Allen & Erickson,100,E,NS,37,9,46,1,Fall2018
5960,SW Allen & Erickson,101,W,FS,8,31,39,3,Fall2018
5961,SW Allen & Hall,102,E,NS,9,45,54,6,Fall2018
5962,SW Allen & Hall,103,W,NS,37,23,60,6,Fall2018
5966,SW Allen & Menlo,104,E,NS,23,5,28,0,Fall2018
5967,SW Allen & Menlo,105,W,NS,6,23,29,1,Fall2018
5968,SW Allen & Murray,106,E,FS,26,5,31,6,Fall2018
5969,SW Allen & Taralynn,108,W,FS,5,13,18,2,Fall2018
5970,SW Allen & Wilson,111,E,NS,18,4,22,0,Fall2018
5971,SW Allen & Wilson,112,W,OP,5,16,21,0,Fall2018
5956,SW Allen & 141st,113,E,OP,18,3,21,1,Fall2018
5957,SW Allen & 141st,114,W,NS,3,18,21,2,Fall2018
1310,N Anchor & Channel,115,E,NS,291,195,486,31,Fall2018
1947,NE 21st & Argyle,118,S,FS,22,0,22,0,Fall2018
7480,W Arlington & Barton,121,E,NS,34,6,40,8,Fall2018
7481,W Arlington & Barton,122,W,NS,0,6,6,1,Fall2018
7482,W Arlington & Beatrice,123,E,NS,2,0,2,0,Fall2018
7483,W Arlington & Beatrice,124,W,NS,0,1,1,0,Fall2018
7484,W Arlington & Bellevue,125,E,NS,0,1,1,0,Fall2018
7485,W Arlington & Bellevue,126,W,NS,1,1,2,0,Fall2018
914,E Arlington & Cornell,131,E,NS,3,1,4,0,Fall2018
915,E Arlington & Cornell,132,W,NS,2,1,3,1,Fall2018
916,E Arlington & Harvard,133,E,NS,2,1,3,0,Fall2018
917,E Arlington & Harvard,134,W,NS,0,1,1,0,Fall2018
7486,W Arlington & McLoughlin,135,W,NS,3,32,35,7,Fall2018
7487,W Arlington & Portland Ave,136,E,NS,7,4,11,1,Fall2018
918,E Arlington & Portland Ave,137,W,NS,3,2,5,1,Fall2018
913,E Arlington & 82nd Dr,140,E,NS,6,5,11,2,Fall2018
670,82nd Dr & E Berkeley,141,S,FS,3,5,8,1,Fall2018
5979,SW Arthur & 1st,142,E,NS,30,49,79,19,Fall2018
5980,SW Arthur & 1st,143,W,NS,81,64,145,18,Fall2018
278,19th & B St,146,E,FS,273,188,461,101,Fall2018
761,B Ave & Second St,147,W,NS,15,28,43,1,Fall2018
12,10100 Block SW Barbur,150,E,AT,14,17,31,4,Fall2018
32,10700 Block SW Barbur,152,S,AT,1,5,6,0,Fall2018
53,11100 Block SW Barbur,153,W,AT,1,1,2,0,Fall2018
54,11100 Block SW Barbur,154,E,OP,2,1,3,0,Fall2018
521,4900 Block SW Barbur,155,S,OP,56,63,119,4,Fall2018
522,4900 Block SW Barbur,156,N,AT,67,59,126,7,Fall2018
5993,SW Barbur & 26th Ave,159,E,OP,46,7,53,3,Fall2018
717,9500 Block SW Barbur,160,E,AT,13,4,17,1,Fall2018
6000,SW Barbur & Alice ,162,E,FS,25,8,33,9,Fall2018
6001,SW Barbur & Alice ,163,W,NS,6,22,28,6,Fall2018
6026,SW Barbur & Taylors Ferry ,164,W,NS,5,15,20,1,Fall2018
6002,SW Barbur & Barbur Ct ,165,W,OP,6,33,39,8,Fall2018
6006,SW Barbur & Capitol Hwy ,168,E,NS,64,35,99,5,Fall2018
6005,SW Barbur & Capitol Hill ,170,S,FS,38,130,168,16,Fall2018
6009,SW Barbur & Hamilton ,172,N,FS,144,97,241,17,Fall2018
6010,SW Barbur & Hamilton ,173,W,NS,100,166,266,13,Fall2018
6011,SW Barbur & Hooker ,174,N,NS,26,16,42,1,Fall2018
6012,SW Barbur & Hooker ,175,S,NS,26,34,60,1,Fall2018
6014,SW Barbur & Lane ,176,S,NS,8,25,33,1,Fall2018
6015,SW Barbur & Lane ,177,N,OP,30,15,45,0,Fall2018
6016,SW Barbur & Luradel ,178,S,OP,20,48,68,1,Fall2018
6017,SW Barbur & Luradel ,179,N,FS,44,21,65,0,Fall2018
6018,SW Barbur & Moss ,180,N,NS,22,6,28,0,Fall2018
6020,SW Barbur & Parkhill Dr ,181,S,FS,3,5,8,0,Fall2018
6019,SW Barbur & Parkhill ,182,N,FS,6,3,9,0,Fall2018
55,11200 Block SW Barbur,183,E,AT,11,7,18,0,Fall2018
56,11200 Block SW Barbur,184,W,OP,5,11,16,0,Fall2018
6021,SW Barbur & Pennoyer ,185,S,OP,5,11,16,0,Fall2018
6022,SW Barbur & Pennoyer ,186,N,FS,12,7,19,1,Fall2018
6023,SW Barbur & Primrose ,187,W,NS,23,64,87,33,Fall2018
6007,SW Barbur & Capitol Hwy ,188,S,FS,4,9,13,0,Fall2018
6024,SW Barbur & Slavin/Capitol Hwy,189,N,OP,5,4,9,0,Fall2018
6027,SW Barbur & Terwilliger ,191,W,FS,30,68,98,3,Fall2018
6028,SW Barbur & Terwilliger ,193,E,FS,66,20,86,4,Fall2018
693,8900 Block SW Barbur,194,W,AT,2,29,31,3,Fall2018
6029,SW Barbur & Whitaker ,195,N,FS,20,24,44,0,Fall2018
6030,SW Barbur & Whitaker ,196,S,OP,28,20,48,0,Fall2018
6031,SW Barbur & Woods ,197,N,NS,9,7,16,0,Fall2018
6032,SW Barbur & Woods ,198,S,OP,5,7,12,0,Fall2018
6003,SW Barbur & Bertha ,199,W,FS,117,192,309,26,Fall2018
5989,SW Barbur & 13th,200,W,FS,17,27,44,21,Fall2018
6008,SW Barbur & Evans ,201,S,NS,3,20,23,3,Fall2018
5991,SW Barbur & 19th,202,E,NS,101,33,134,8,Fall2018
5995,SW Barbur & 2nd,203,N,NS,54,4,58,1,Fall2018
5997,SW Barbur & 3rd,207,W,NS,12,61,73,1,Fall2018
5996,SW Barbur & 30th,208,E,FS,85,20,105,35,Fall2018
5998,SW Barbur & 53rd,209,W,NS,7,15,22,1,Fall2018
5999,SW Barbur & 53rd,210,E,FS,19,10,29,0,Fall2018
6891,SW Pacific Hwy & 64th,211,E,NS,44,23,67,0,Fall2018
762,Barbur Transit Center,212,E,AT,555,52,607,20,Fall2018
83,12200 Block NW Barnes,227,S,AT,45,8,53,0,Fall2018
3218,NW Barnes & Saltzman,228,N,AT,14,17,31,2,Fall2018
645,7600 Block SW Barnes,229,E,FS,32,8,40,0,Fall2018
667,8200 Block SW Barnes (Art School),230,E,OP,9,9,18,0,Fall2018
668,8200 Block SW Barnes (Art School),231,W,AT,9,13,22,0,Fall2018
709,9300 Block SW Barnes,233,E,AT,7,8,15,2,Fall2018
91,12400 Block NW Barnes,234,N,OP,14,36,50,1,Fall2018
690,8800 Block SW Barnes (Catlin Gabel School),235,W,NS,3,12,15,0,Fall2018
6050,SW Barnes & Leahy,236,E,NS,93,24,117,0,Fall2018
6051,SW Barnes & Leahy,237,W,NS,18,83,101,1,Fall2018
6052,SW Barnes & Miller,238,E,FS,34,25,59,1,Fall2018
6053,SW Barnes & Miller,239,W,FS,20,55,75,1,Fall2018
6055,SW Barnes & Monterey/St Vincent Hosp Dr,240,W,NS,2,6,8,0,Fall2018
6054,SW Barnes & Monterey,241,E,NS,6,2,8,1,Fall2018
6058,SW Barnes & W Stark,247,E,FS,24,9,33,1,Fall2018
6035,SW Barnes & 70th,251,E,OP,3,1,4,0,Fall2018
6042,SW Barnes & 70th,252,W,FS,1,8,9,0,Fall2018
6043,SW Barnes & 84th,253,W,FS,2,4,6,0,Fall2018
6045,SW Barnes & 88th,255,E,NS,13,3,16,0,Fall2018
919,E Baseline & Valley View,256,E,OP,4,1,5,2,Fall2018
5576,SE Tualatin Valley Hwy & 44th,257,W,NS,42,24,66,128,Fall2018
612,700 Block Baseline,258,E,AT,13,6,19,1,Fall2018
6062,SW Baseline & Adams,259,W,NS,84,11,95,17,Fall2018
998,E Main & NE Brookwood,260,W,FS,7,16,23,2,Fall2018
1014,E Main & SE Brookwood,261,E,NS,16,6,22,2,Fall2018
775,Baseline St & S 26th,263,E,NS,40,15,55,3,Fall2018
6067,SW Baseline St & 17th,264,W,OP,27,44,71,12,Fall2018
7492,W Baseline Rd & SW Lisa,265,W,FS,3,0,3,0,Fall2018
319,2200 Block Baseline,267,E,AT,50,29,79,24,Fall2018
3,1000 Block SW Baseline St,268,W,AT,22,55,77,12,Fall2018
7493,W Baseline Rd & SW Willow Creek Dr,269,E,NS,0,18,18,1,Fall2018
774,Baseline St & S 1st,270,E,FS,20,18,38,3,Fall2018
771,Baseline St & S 10th,271,E,NS,12,16,28,4,Fall2018
772,Baseline St & S 12th,272,E,FS,98,34,132,12,Fall2018
773,Baseline St & S 14th,273,E,NS,45,27,72,2,Fall2018
7489,W Baseline Rd & SW 185th,275,W,FS,5,1,6,0,Fall2018
766,Baseline & S 20th,277,E,NS,50,36,86,4,Fall2018
7490,W Baseline Rd & SW 194th,278,E,FS,1,2,3,0,Fall2018
7491,W Baseline Rd & SW 195th,279,W,NS,1,1,2,0,Fall2018
4229,SE Baseline St & 2nd,280,W,NS,120,160,280,45,Fall2018
767,Baseline St & N 26th,284,W,FS,7,34,41,3,Fall2018
768,Baseline St & N 29th/Hobbs,285,E,OP,11,5,16,0,Fall2018
769,Baseline St & N 29th/Hobbs,286,W,FS,8,16,24,0,Fall2018
770,Baseline St & N 31st,287,W,FS,3,8,11,2,Fall2018
994,E Main & NE 32nd,288,W,NS,3,9,12,0,Fall2018
6059,SW Baseline & 331st,290,W,OP,1,2,3,0,Fall2018
6060,SW Baseline & 331st,291,E,FS,3,1,4,0,Fall2018
6065,SW Baseline & NW 334th,292,W,FS,1,4,5,0,Fall2018
6066,SW Baseline & NW 334th,293,E,OP,4,1,5,0,Fall2018
764,Baseline & NW 338th,296,W,FS,1,3,4,0,Fall2018
765,Baseline & NW 338th,297,E,OP,2,3,5,0,Fall2018
777,Baseline St & Valley View,298,W,AT,2,9,11,1,Fall2018
6061,SW Baseline & 345th,300,E,NS,11,4,15,3,Fall2018
995,E Main & NE 37th,301,W,NS,4,5,9,0,Fall2018
1013,E Main & SE 37th,302,E,NS,5,5,10,0,Fall2018
776,Baseline St & S 4th,303,E,NS,112,32,144,33,Fall2018
4230,SE Baseline St & 3rd,304,W,NS,84,108,192,11,Fall2018
996,E Main & NE 40th,305,W,NS,2,1,3,0,Fall2018
997,E Main & NE 40th,306,E,OP,5,2,7,0,Fall2018
4231,SE Baseline St & 5th,307,W,NS,9,40,49,18,Fall2018
4232,SE Baseline St & 7th,308,W,NS,38,74,112,27,Fall2018
4233,SE Baseline St & 9th,310,W,NS,75,129,204,24,Fall2018
590,6200 Block N Basin,313,E,AT,2,0,2,1,Fall2018
594,6300 Block N Basin,314,N,AT,1,4,5,0,Fall2018
1315,N Basin & Fathom,315,S,FS,6,0,6,0,Fall2018
606,6700 Block N Basin (Coast Guard),316,E,AT,7,6,13,0,Fall2018
1311,N Basin & Emerson,317,S,OP,11,0,11,1,Fall2018
1312,N Basin & Emerson,318,N,FS,2,11,13,5,Fall2018
1313,N Basin & Ensign,319,S,NS,15,1,16,0,Fall2018
1314,N Basin & Ensign,320,N,FS,19,51,70,1,Fall2018
1316,N Basin & Fathom,321,N,NS,15,29,44,0,Fall2018
1317,N Basin & Leverman,322,S,OP,3,1,4,0,Fall2018
1318,N Basin & Pacific Pride,324,N,AT,0,11,11,0,Fall2018
356,2600 Block SW Beaverton-Hillsdale,325,E,AT,16,6,22,0,Fall2018
455,3600 Block SW Beaverton-Hillsdale,326,E,AT,6,3,9,1,Fall2018
456,3600 Block SW Beaverton-Hillsdale,327,W,OP,2,5,7,0,Fall2018
6097,SW Beaverton-Hillsdale & 59th,328,E,OP,54,12,66,57,Fall2018
589,6100 Block SW Beaverton-Hillsdale,329,W,AT,30,44,74,27,Fall2018
636,7300 Block SW Beaverton-Hillsdale,331,E,OP,8,11,19,5,Fall2018
637,7400 Block SW Beaverton-Hillsdale,332,W,AT,7,19,26,2,Fall2018
649,7700 Block SW Beaverton-Hillsdale,333,E,AT,31,32,63,21,Fall2018
6107,SW Beaverton-Hillsdale & Apple Way ,335,E,NS,7,6,13,0,Fall2018
6108,SW Beaverton-Hillsdale & Bertha ,336,E,NS,11,3,14,3,Fall2018
6109,SW Beaverton-Hillsdale & Dosch ,340,W,NS,24,97,121,1,Fall2018
6110,SW Beaverton-Hillsdale & Griffith ,341,W,FS,20,55,75,30,Fall2018
6111,SW Beaverton-Hillsdale & Griffith ,342,E,NS,52,19,71,28,Fall2018
6112,SW Beaverton-Hillsdale & Jamieson ,343,W,OP,34,29,63,8,Fall2018
6113,SW Beaverton-Hillsdale & Jamieson ,344,E,FS,27,33,60,5,Fall2018
6123,SW Beaverton-Hillsdale & White Pine Ln ,345,E,FS,20,9,29,0,Fall2018
6114,SW Beaverton-Hillsdale & Laurelwood ,346,W,NS,11,25,36,2,Fall2018
6115,SW Beaverton-Hillsdale & Laurelwood ,347,E,NS,23,11,34,2,Fall2018
6116,SW Beaverton-Hillsdale & Oleson ,348,E,NS,136,48,184,20,Fall2018
6118,SW Beaverton-Hillsdale & Poplar Ln ,349,W,NS,4,3,7,0,Fall2018
6117,SW Beaverton-Hillsdale & Oleson ,350,W,NS,33,67,100,9,Fall2018
6119,SW Beaverton-Hillsdale & Shattuck ,351,E,NS,65,20,85,18,Fall2018
6120,SW Beaverton-Hillsdale & Shattuck ,352,W,FS,1,21,22,7,Fall2018
6121,SW Beaverton-Hillsdale & Western ,354,E,NS,18,35,53,13,Fall2018
6122,SW Beaverton-Hillsdale & Western ,355,W,OP,36,26,62,13,Fall2018
6124,SW Beaverton-Hillsdale & White Pine Ln ,356,W,NS,10,12,22,1,Fall2018
6069,SW Beaverton-Hillsdale & 101st,357,E,FS,8,6,14,0,Fall2018
6070,SW Beaverton-Hillsdale & 101st,358,W,NS,3,4,7,0,Fall2018
6068,SW Beaverton- Hillsdale & 107th,359,W,NS,35,34,69,11,Fall2018
6071,SW Beaverton-Hillsdale & 107th,360,E,NS,28,47,75,15,Fall2018
6072,SW Beaverton-Hillsdale & 110th,361,W,NS,23,12,35,6,Fall2018
6073,SW Beaverton-Hillsdale & 110th,362,E,OP,12,21,33,6,Fall2018
6074,SW Beaverton-Hillsdale & 18th Dr,363,W,NS,50,61,111,13,Fall2018
6075,SW Beaverton-Hillsdale & 25th,364,E,FS,17,6,23,0,Fall2018
6076,SW Beaverton-Hillsdale & 25th,365,W,NS,8,30,38,0,Fall2018
357,2600 Block SW Beaverton-Hillsdale,366,W,FS,5,6,11,0,Fall2018
6077,SW Beaverton-Hillsdale & 30th,367,E,NS,78,16,94,1,Fall2018
6078,SW Beaverton-Hillsdale & 33rd,368,E,NS,33,11,44,9,Fall2018
6079,SW Beaverton-Hillsdale & 35th,369,E,FS,34,9,43,0,Fall2018
6080,SW Beaverton-Hillsdale & 35th,370,W,OP,17,32,49,3,Fall2018
6081,SW Beaverton-Hillsdale & 39th Dr,371,E,OP,35,7,42,10,Fall2018
6082,SW Beaverton-Hillsdale & 39th Dr,372,W,NS,5,34,39,1,Fall2018
6083,SW Beaverton-Hillsdale & 42nd,373,E,FS,35,9,44,4,Fall2018
6084,SW Beaverton-Hillsdale & 42nd,374,W,NS,9,36,45,13,Fall2018
6085,SW Beaverton-Hillsdale & 45th,375,E,FS,68,22,90,9,Fall2018
6086,SW Beaverton-Hillsdale & 45th,376,W,NS,23,79,102,5,Fall2018
6087,SW Beaverton-Hillsdale & 50th,377,E,NS,22,4,26,0,Fall2018
6088,SW Beaverton-Hillsdale & 50th,378,W,OP,4,35,39,1,Fall2018
6095,SW Beaverton-Hillsdale & 56th,379,E,OP,46,14,60,7,Fall2018
6096,SW Beaverton-Hillsdale & 56th,380,W,FS,30,94,124,34,Fall2018
6098,SW Beaverton-Hillsdale & 59th,381,W,NS,14,38,52,75,Fall2018
6099,SW Beaverton-Hillsdale & 62nd,382,E,FS,47,30,77,40,Fall2018
601,6500 Block SW Beaverton-Hillsdale,383,E,AT,24,14,38,5,Fall2018
6100,SW Beaverton-Hillsdale & 65th,384,W,OP,22,39,61,6,Fall2018
6101,SW Beaverton-Hillsdale & 78th,385,W,NS,45,34,79,9,Fall2018
6102,SW Beaverton-Hillsdale & 78th,386,E,NS,23,28,51,2,Fall2018
6103,SW Beaverton-Hillsdale & 91st,387,W,FS,28,28,56,23,Fall2018
6104,SW Beaverton-Hillsdale & 91st,388,E,OP,24,17,41,18,Fall2018
6105,SW Beaverton-Hillsdale & 99th,389,W,NS,10,11,21,4,Fall2018
6106,SW Beaverton-Hillsdale & 99th,390,E,OP,9,8,17,4,Fall2018
4243,SE Bell & Our Ct ,394,N,NS,7,11,18,30,Fall2018
4240,SE Bell & Johnson Creek,395,N,NS,21,12,33,1,Fall2018
4241,SE Bell & Johnson Creek,396,S,FS,12,20,32,1,Fall2018
4244,SE Bell & Pierce ,397,N,NS,7,5,12,1,Fall2018
4242,SE Bell & Jordan ,398,S,NS,4,7,11,0,Fall2018
4246,SE Belmont & 11th,400,E,FS,131,165,296,57,Fall2018
4247,SE Belmont & 14th,402,E,NS,31,65,96,26,Fall2018
4248,SE Belmont & 17th,404,E,NS,16,58,74,8,Fall2018
4249,SE Belmont & 20th,406,E,NS,34,106,140,8,Fall2018
4250,SE Belmont & 23rd,408,E,NS,12,40,52,6,Fall2018
4251,SE Belmont & 26th,410,W,NS,120,67,187,68,Fall2018
4253,SE Belmont & 30th,417,W,FS,168,42,210,41,Fall2018
4254,SE Belmont & 30th,418,E,FS,49,143,192,75,Fall2018
4255,SE Belmont & 34th,422,E,FS,52,163,215,33,Fall2018
4256,SE Belmont & 34th,423,W,FS,173,52,225,26,Fall2018
4257,SE Belmont & 37th,425,E,FS,13,71,84,26,Fall2018
4258,SE Belmont & 38th,426,W,FS,82,14,96,34,Fall2018
4282,SE Belmont & Cesar Chavez Blvd,427,E,FS,94,179,273,63,Fall2018
4283,SE Belmont & Cesar Chavez Blvd,428,W,NS,150,79,229,43,Fall2018
4259,SE Belmont & 42nd,429,E,NS,17,78,95,4,Fall2018
4260,SE Belmont & 42nd,430,W,FS,116,21,137,11,Fall2018
4261,SE Belmont & 46th,435,W,NS,96,33,129,51,Fall2018
4262,SE Belmont & 46th,436,E,OP,39,102,141,62,Fall2018
4263,SE Belmont & 49th,439,E,NS,14,29,43,9,Fall2018
4264,SE Belmont & 49th,440,W,NS,42,13,55,9,Fall2018
4265,SE Belmont & 50th,442,E,FS,7,15,22,0,Fall2018
4267,SE Belmont & 53rd,443,E,FS,4,26,30,2,Fall2018
4268,SE Belmont & 53rd,444,W,NS,29,4,33,3,Fall2018
4269,SE Belmont & 55th,445,E,NS,4,27,31,5,Fall2018
4270,SE Belmont & 55th,446,W,NS,23,6,29,2,Fall2018
4271,SE Belmont & 58th,448,E,OP,3,17,20,7,Fall2018
4272,SE Belmont & 58th,449,W,NS,16,2,18,6,Fall2018
4273,SE Belmont & 60th,450,E,FS,54,128,182,12,Fall2018
4274,SE Belmont & 60th,451,W,NS,110,30,140,15,Fall2018
4275,SE Belmont & 62nd,453,E,OP,3,4,7,0,Fall2018
4276,SE Belmont & 62nd,454,W,FS,7,5,12,0,Fall2018
4277,SE Belmont & 65th,456,E,OP,1,5,6,0,Fall2018
4278,SE Belmont & 65th,457,W,NS,4,1,5,0,Fall2018
4279,SE Belmont & 67th,459,E,NS,2,10,12,0,Fall2018
4280,SE Belmont & 68th,460,W,NS,27,4,31,1,Fall2018
4281,SE Belmont & 9th,465,E,NS,51,86,137,13,Fall2018
146,1400 Block SW Bertha,467,E,AT,2,1,3,0,Fall2018
6129,SW Binford Lake & Heiney ,469,W,NS,1,6,7,4,Fall2018
6130,SW Binford Lake & Towle ,470,E,NS,6,1,7,0,Fall2018
6131,SW Binford Lake & Towle ,471,W,FS,0,4,4,0,Fall2018
57,11200 Block SW Boones Ferry Rd,492,N,AT,2,0,2,0,Fall2018
251,18200 Block SW Boones Ferry Rd,495,S,AT,2,21,23,1,Fall2018
253,18400 Block SW Boones Ferry Rd,496,N,AT,31,6,37,2,Fall2018
6141,SW Boones Ferry Rd & Alsea ,500,S,NS,1,7,8,0,Fall2018
6148,SW Boones Ferry Rd & Apache ,501,S,NS,0,5,5,0,Fall2018
6149,SW Boones Ferry Rd & Apache ,502,N,OP,2,0,2,0,Fall2018
6150,SW Boones Ferry Rd & Arapaho ,503,N,NS,4,0,4,0,Fall2018
6151,SW Boones Ferry Rd & Arnold ,506,S,FS,0,3,3,0,Fall2018
6152,SW Boones Ferry Rd & Arnold ,507,N,OP,2,0,2,0,Fall2018
6155,SW Boones Ferry Rd & Blake ,510,N,NS,8,0,8,0,Fall2018
815,Boones Ferry Rd & Bryant,512,N,FS,3,3,6,1,Fall2018
6752,SW Lower Boones Ferry & Childs Rd,513,E,FS,2,0,2,0,Fall2018
6753,SW Lower Boones Ferry & Childs Rd,514,W,OP,0,8,8,0,Fall2018
6156,SW Boones Ferry Rd & Clara Ln ,515,W,FS,0,3,3,0,Fall2018
6157,SW Boones Ferry Rd & Colony Dr ,516,S,OP,0,1,1,0,Fall2018
6158,SW Boones Ferry Rd & Colony Dr ,517,N,FS,1,0,1,0,Fall2018
6159,SW Boones Ferry Rd & Coronado ,520,S,FS,0,2,2,0,Fall2018
6160,SW Boones Ferry Rd & Day ,521,N,OP,2,0,2,1,Fall2018
6161,SW Boones Ferry Rd & Day ,522,S,FS,0,4,4,2,Fall2018
816,Boones Ferry Rd & Firwood,529,S,NS,4,2,6,0,Fall2018
6164,SW Boones Ferry Rd & Ibach ,530,S,FS,1,13,14,0,Fall2018
6165,SW Boones Ferry Rd & Ibach ,531,N,NS,8,0,8,0,Fall2018
6162,SW Boones Ferry Rd & Greenhill Ln,533,S,OP,0,0,0,0,Fall2018
6163,SW Boones Ferry Rd & Greenhill Ln,534,N,NS,0,0,0,0,Fall2018
6168,SW Boones Ferry Rd & Killarney ,535,S,NS,0,3,3,0,Fall2018
819,Boones Ferry Rd & Kruse Way Pl,536,S,FS,2,9,11,0,Fall2018
247,18000 Block SW Lower Boones Ferry,537,E,AT,15,2,17,1,Fall2018
828,Boones Ferry Rd & SW Madrona,538,N,OP,1,1,2,1,Fall2018
829,Boones Ferry Rd & SW Madrona,539,S,NS,1,1,2,0,Fall2018
6171,SW Boones Ferry Rd & Norwood ,542,S,OP,0,3,3,0,Fall2018
6172,SW Boones Ferry Rd & Norwood ,543,N,NS,4,0,4,2,Fall2018
6174,SW Boones Ferry Rd & Palatine ,545,N,FS,1,0,1,0,Fall2018
825,Boones Ferry Rd & Rainbow,553,S,OP,0,1,1,0,Fall2018
826,Boones Ferry Rd & Rainbow,554,N,FS,2,0,2,0,Fall2018
248,18000 Block SW Lower Boones Ferry,558,W,AT,3,16,19,2,Fall2018
6176,SW Boones Ferry Rd & Siletz ,562,N,NS,3,0,3,0,Fall2018
6177,SW Boones Ferry Rd & Siletz ,563,S,NS,0,3,3,0,Fall2018
830,Boones Ferry Rd & Spring Lane,564,N,NS,8,2,10,1,Fall2018
6178,SW Boones Ferry Rd & Stephenson,565,N,FS,2,0,2,0,Fall2018
6179,SW Boones Ferry Rd & Stephenson,566,W,FS,0,3,3,0,Fall2018
831,Boones Ferry Rd & Twin Fir,568,S,OP,0,2,2,0,Fall2018
832,Boones Ferry Rd & Twin Fir,569,N,FS,2,0,2,0,Fall2018
6751,SW Lower Boones Ferry & Boones Ferry,570,E,FS,5,1,6,0,Fall2018
835,Boones Ferry Rd & West Sunset Dr,576,S,NS,0,0,0,0,Fall2018
836,Boones Ferry Rd & West Sunset Dr,577,N,OP,0,0,0,0,Fall2018
6137,SW Boones Ferry Rd & 19th ,580,E,FS,1,0,1,0,Fall2018
6138,SW Boones Ferry Rd & 22nd ,581,S,OP,0,5,5,0,Fall2018
6139,SW Boones Ferry Rd & 4th ,583,W,OP,0,1,1,0,Fall2018
6140,SW Boones Ferry Rd & 4th ,584,E,FS,0,0,0,0,Fall2018
6715,SW Laurelwood & Brentwood,593,N,NS,0,0,0,0,Fall2018
6180,SW Brentwood & 78th,595,E,NS,2,0,2,0,Fall2018
3250,NW Bridge Ave & St Helens,596,N,NS,0,2,2,0,Fall2018
3246,NW Bridge Ave & Germantown,597,N,OP,0,0,0,0,Fall2018
3247,NW Bridge Ave & Germantown,598,S,NS,0,0,0,0,Fall2018
3248,NW Bridge Ave & Springville,599,N,OP,0,5,5,0,Fall2018
3249,NW Bridge Ave & Springville,600,S,NS,6,0,6,0,Fall2018
2264,NE Broadway & Grand ,605,W,NS,6,25,31,22,Fall2018
6183,SW Broadway & Hall ,607,S,FS,4,8,12,0,Fall2018
1325,N Broadway & Benton,611,E,FS,7,19,26,2,Fall2018
6184,SW Broadway & Lincoln ,614,S,NS,0,1,1,0,Fall2018
6185,SW Broadway & Market ,616,S,FS,2,26,28,0,Fall2018
2265,NE Broadway & M L King,622,W,FS,31,16,47,25,Fall2018
3254,NW Broadway & Irving,625,N,NS,71,67,138,55,Fall2018
1327,N Broadway & Vancouver,627,W,NS,13,29,42,27,Fall2018
2244,NE Broadway & 12th ,629,W,NS,178,111,289,190,Fall2018
2245,NE Broadway & 16th ,631,W,FS,104,57,161,35,Fall2018
2252,NE Broadway & 2nd ,633,W,NS,14,7,21,7,Fall2018
2246,NE Broadway & 21st ,634,W,FS,120,35,155,45,Fall2018
2247,NE Broadway & 24th ,635,W,FS,115,53,168,49,Fall2018
2248,NE Broadway & 26th ,636,E,FS,16,28,44,23,Fall2018
2249,NE Broadway & 26th ,637,W,FS,27,11,38,9,Fall2018
2250,NE Broadway & 28th ,638,E,FS,48,72,120,53,Fall2018
2251,NE Broadway & 28th ,639,W,NS,78,61,139,33,Fall2018
2253,NE Broadway & 32nd ,642,E,FS,71,66,137,25,Fall2018
2254,NE Broadway & 33rd ,644,W,FS,73,65,138,26,Fall2018
2255,NE Broadway & 35th ,646,E,FS,5,8,13,6,Fall2018
2256,NE Broadway & 35th ,647,W,NS,5,3,8,1,Fall2018
2257,NE Broadway & 37th ,648,E,NS,5,20,25,12,Fall2018
2258,NE Broadway & 37th ,649,W,NS,18,5,23,2,Fall2018
2259,NE Broadway & 44th ,650,W,NS,36,23,59,49,Fall2018
2260,NE Broadway & 44th ,651,E,FS,26,40,66,90,Fall2018
2261,NE Broadway & 47th ,653,E,NS,6,10,16,0,Fall2018
6182,SW Broadway & 5th ,654,W,NS,11,117,128,11,Fall2018
2262,NE Broadway & 7th ,655,W,NS,26,9,35,12,Fall2018
2263,NE Broadway & 9th ,656,W,NS,49,14,63,71,Fall2018
837,Bryant & Black Forest Ct,663,N,OP,1,0,1,0,Fall2018
838,Bryant & Chapman Way,664,N,FS,0,0,0,0,Fall2018
839,Bryant & Lakeview,665,N,NS,4,1,5,0,Fall2018
235,17500 Block Bryant,667,S,AT,0,0,0,0,Fall2018
841,Bryant & Lords Ln,668,N,NS,0,0,0,0,Fall2018
848,Bryant & Wildwood,669,S,FS,0,0,0,0,Fall2018
1140,Kerr & Jefferson Pkwy,672,S,NS,3,7,10,0,Fall2018
509,4600 Block W Burnside,682,W,AT,0,2,2,0,Fall2018
7533,W Burnside & SW Fischer Ln,685,E,NS,3,0,3,1,Fall2018
7506,W Burnside & NW Barnes,686,N,OP,13,2,15,0,Fall2018
7507,W Burnside & NW Barnes,687,W,FS,1,16,17,0,Fall2018
7494,W Burnside & Burnside Bridge,689,W,AT,79,333,412,148,Fall2018
7496,W Burnside & Mt. Calvary Cemetery,690,E,AT,5,2,7,0,Fall2018
7495,W Burnside & Mt Calvary Cemetery,691,W,AT,1,7,8,0,Fall2018
705,9100 Block E Burnside,696,E,OP,10,18,28,0,Fall2018
706,9100 Block E Burnside,697,W,AT,20,11,31,1,Fall2018
978,E Burnside & SE Floral,701,E,NS,3,9,12,0,Fall2018
946,E Burnside & NE Floral,702,W,NS,7,4,11,0,Fall2018
947,E Burnside & NE Grand,704,E,NS,315,362,677,133,Fall2018
7508,W Burnside & NW Hermosa,706,E,OP,3,0,3,0,Fall2018
7509,W Burnside & NW Hermosa,707,W,FS,1,3,4,0,Fall2018
979,E Burnside & SE Laurelhurst,710,E,NS,2,8,10,0,Fall2018
954,E Burnside & NE Laurelhurst,711,W,NS,5,2,7,1,Fall2018
7536,W Burnside & SW Tichner,712,E,FS,16,2,18,1,Fall2018
7511,W Burnside & NW Macleay,713,W,FS,2,19,21,0,Fall2018
7531,W Burnside & SW 8th,715,E,NS,71,85,156,68,Fall2018
7514,W Burnside & NW Park,716,W,NS,135,87,222,88,Fall2018
7535,W Burnside & SW St Clair,718,E,NS,271,93,364,54,Fall2018
7516,W Burnside & SW 13th,723,E,NS,144,82,226,111,Fall2018
7517,W Burnside & SW 15th,725,E,NS,58,10,68,17,Fall2018
955,E Burnside & SE 16th,726,E,FS,30,51,81,6,Fall2018
923,E Burnside & NE 18th,730,W,NS,31,16,47,11,Fall2018
7500,W Burnside & NW 19th,735,W,NS,62,134,196,45,Fall2018
956,E Burnside & SE 20th,740,E,NS,55,107,162,18,Fall2018
7501,W Burnside & NW 20th Pl,742,W,NS,182,397,579,189,Fall2018
7510,W Burnside & NW King,747,W,NS,41,120,161,42,Fall2018
7526,W Burnside & SW 21st,749,E,NS,167,52,219,48,Fall2018
7502,W Burnside & NW 23rd,755,W,NS,82,326,408,85,Fall2018
957,E Burnside & SE 24th,759,E,FS,55,85,140,4,Fall2018
925,E Burnside & NE 24th,760,W,FS,85,36,121,2,Fall2018
958,E Burnside & SE 28th,763,E,NS,102,154,256,13,Fall2018
926,E Burnside & NE 28th,764,W,FS,156,97,253,13,Fall2018
927,E Burnside & NE 32nd,768,W,FS,45,27,72,5,Fall2018
959,E Burnside & SE 32nd,769,E,NS,29,53,82,3,Fall2018
977,E Burnside & SE Cesar Chavez Blvd,770,E,NS,91,119,210,27,Fall2018
945,E Burnside & NE Cesar Chavez Blvd,771,W,NS,93,96,189,26,Fall2018
960,E Burnside & SE 41st,774,E,NS,4,11,15,0,Fall2018
928,E Burnside & NE 41st,775,W,NS,5,5,10,0,Fall2018
961,E Burnside & SE 44th,776,E,NS,6,10,16,1,Fall2018
929,E Burnside & NE 44th,777,W,NS,12,3,15,1,Fall2018
930,E Burnside & NE 47th,778,W,NS,33,18,51,10,Fall2018
962,E Burnside & SE 47th,779,E,FS,13,41,54,6,Fall2018
7504,W Burnside & NW 48th Ave,780,W,NS,0,4,4,0,Fall2018
7528,W Burnside & SW 48th Dr,781,E,FS,4,1,5,0,Fall2018
7505,W Burnside & NW 5th,782,W,FS,366,370,736,195,Fall2018
931,E Burnside & NE 52nd,785,W,NS,51,13,64,7,Fall2018
963,E Burnside & SE 52nd,786,E,FS,13,42,55,4,Fall2018
964,E Burnside & SE 55th,787,E,FS,30,47,77,26,Fall2018
932,E Burnside & NE 55th,788,W,NS,37,21,58,17,Fall2018
933,E Burnside & NE 58th,791,W,NS,18,3,21,0,Fall2018
7530,W Burnside & SW 6th,792,E,NS,760,447,1207,310,Fall2018
966,E Burnside & SE 60th,793,E,NS,56,77,133,18,Fall2018
934,E Burnside & NE 60th,794,W,NS,77,49,126,13,Fall2018
935,E Burnside & NE 62nd,796,W,NS,12,6,18,0,Fall2018
967,E Burnside & SE 67th,799,E,OP,5,15,20,1,Fall2018
936,E Burnside & NE 67th,800,W,NS,14,6,20,1,Fall2018
937,E Burnside & NE 69th,801,W,NS,10,5,15,1,Fall2018
969,E Burnside & SE 72nd,806,E,NS,7,17,24,0,Fall2018
938,E Burnside & NE 72nd,807,W,NS,20,6,26,2,Fall2018
970,E Burnside & SE 74th,808,E,NS,6,20,26,1,Fall2018
939,E Burnside & NE 74th,809,W,NS,24,8,32,0,Fall2018
940,E Burnside & NE 79th,811,W,NS,47,16,63,5,Fall2018
971,E Burnside & SE 79th,812,E,NS,11,35,46,1,Fall2018
972,E Burnside & SE 82nd,813,E,NS,229,157,386,80,Fall2018
941,E Burnside & NE 82nd,814,W,NS,135,253,388,104,Fall2018
973,E Burnside & SE 87th,817,E,NS,6,21,27,9,Fall2018
942,E Burnside & NE 87th,818,W,NS,15,5,20,7,Fall2018
974,E Burnside & SE 8th,820,E,NS,107,156,263,26,Fall2018
975,E Burnside & SE 94th,822,E,FS,7,10,17,4,Fall2018
943,E Burnside & NE 94th,823,W,NS,8,8,16,4,Fall2018
3687,S Buxton & SW Cherry Park,830,N,FS,0,2,2,0,Fall2018
3688,S Buxton & SW Cherry Park,831,S,NS,5,0,5,0,Fall2018
849,Buxton & E Columbia River Hwy,832,N,NS,3,12,15,1,Fall2018
3689,S Buxton & SW Martine,833,S,NS,1,0,1,0,Fall2018
3684,S Buxton & SE 6th,836,N,NS,1,0,1,0,Fall2018
3685,S Buxton & SE 8th,837,N,NS,1,1,2,0,Fall2018
4302,SE Bybee & Milwaukie,838,W,NS,83,63,146,24,Fall2018
4303,SE Bybee & Milwaukie,839,E,NS,9,18,27,7,Fall2018
4286,SE Bybee & 14th ,843,W,NS,2,2,4,0,Fall2018
4293,SE Bybee & 14th,844,E,FS,2,3,5,2,Fall2018
4294,SE Bybee & 17th,845,E,NS,58,51,109,16,Fall2018
4295,SE Bybee & 22nd,852,E,FS,8,11,19,17,Fall2018
4296,SE Bybee & 22nd,853,W,NS,8,5,13,10,Fall2018
4297,SE Bybee & 23rd,855,W,NS,1,7,8,13,Fall2018
4298,SE Bybee & 27th,858,E,FS,3,7,10,2,Fall2018
341,2400 Block SE Bybee,859,W,AT,2,2,4,2,Fall2018
4299,SE Bybee & 28th,860,S,NS,0,2,2,0,Fall2018
508,4600 Block SW Cameron,861,E,AT,1,1,2,0,Fall2018
6202,SW Cameron & Fairvale Ct,862,E,NS,3,4,7,0,Fall2018
6203,SW Cameron & Shattuck ,863,E,FS,3,4,7,0,Fall2018
6201,SW Cameron & 53rd ,865,E,NS,7,9,16,0,Fall2018
6205,SW Campus Dr & OHSU Garage F,868,E,OP,25,9,34,6,Fall2018
6206,SW Campus Dr & Terwilliger,870,E,NS,24,3,27,1,Fall2018
6204,SW Campus Dr & Loading Dock 5,871,W,AT,102,8,110,2,Fall2018
641,7500 Block SW Canyon,882,W,AT,1,8,9,0,Fall2018
6230,SW Canyon & Canyon Dr,883,W,OP,2,29,31,1,Fall2018
6224,SW Canyon & Benz Park,885,W,NS,1,3,4,0,Fall2018
6231,SW Canyon & Copel ,890,W,NS,1,5,6,0,Fall2018
6233,SW Canyon & Jade ,892,N,FS,4,1,5,0,Fall2018
6234,SW Canyon & Linden ,893,E,OP,1,0,1,0,Fall2018
1105,Hwy 26 On Ramp & SW Skyline,894,E,FS,48,12,60,11,Fall2018
1106,Hwy 26/Canyon Rd Ramp & SW Skyline,895,W,FS,11,53,64,8,Fall2018
6236,SW Canyon & Walker ,898,W,FS,20,21,41,5,Fall2018
6237,SW Canyon & Walker ,899,E,OP,13,24,37,10,Fall2018
6208,SW Canyon & 104th,904,W,NS,12,9,21,3,Fall2018
6209,SW Canyon & 107th,906,E,NS,32,22,54,5,Fall2018
6210,SW Canyon & 107th,907,W,NS,21,28,49,4,Fall2018
6211,SW Canyon & 110th,908,E,NS,9,8,17,3,Fall2018
6212,SW Canyon & 110th,909,W,FS,7,8,15,1,Fall2018
6213,SW Canyon & 115th,910,W,NS,5,24,29,13,Fall2018
6215,SW Canyon & 73rd,912,E,NS,4,0,4,0,Fall2018
6216,SW Canyon & 87th,913,E,FS,64,25,89,3,Fall2018
6217,SW Canyon & 87th,914,W,FS,24,22,46,2,Fall2018
6218,SW Canyon & 91st,915,E,NS,8,7,15,3,Fall2018
6220,SW Canyon & 93rd,917,W,OP,3,3,6,0,Fall2018
6221,SW Canyon & 93rd,918,E,NS,1,2,3,0,Fall2018
6222,SW Canyon & 96th,919,W,OP,1,2,3,0,Fall2018
6223,SW Canyon & 96th,920,E,NS,4,2,6,0,Fall2018
6246,SW Capitol & Alice ,921,S,NS,2,9,11,0,Fall2018
6247,SW Capitol & Alice ,922,N,NS,9,2,11,0,Fall2018
6254,SW Capitol & Barbur,923,N,NS,70,35,105,7,Fall2018
6255,SW Capitol & Bertha Ct,925,E,FS,118,104,222,35,Fall2018
718,9500 Block SW Capitol,926,S,OP,1,8,9,0,Fall2018
6258,SW Capitol & Carson,927,S,NS,3,8,11,2,Fall2018
6280,SW Capitol & Sunset,929,E,OP,324,424,748,31,Fall2018
6282,SW Capitol & Taylors Ferry,930,S,NS,9,49,58,22,Fall2018
6260,SW Capitol & Dickinson,931,S,FS,2,29,31,4,Fall2018
6261,SW Capitol & Dickinson,932,N,NS,30,3,33,3,Fall2018
6262,SW Capitol & Dolph,933,S,OP,1,12,13,2,Fall2018
6263,SW Capitol & Dolph,934,N,FS,11,1,12,2,Fall2018
6264,SW Capitol & Florida,935,S,FS,6,24,30,0,Fall2018
6265,SW Capitol & Galeburn,936,S,OP,9,52,61,0,Fall2018
6266,SW Capitol & Galeburn,937,N,NS,37,8,45,0,Fall2018
6267,SW Capitol & Garden Home,939,N,OP,21,8,29,0,Fall2018
6270,SW Capitol & Idaho,942,N,NS,33,2,35,3,Fall2018
6271,SW Capitol & Idaho,943,W,FS,3,24,27,1,Fall2018
6272,SW Capitol & Marigold,946,N,FS,14,1,15,1,Fall2018
6273,SW Capitol & Marigold,947,S,FS,2,10,12,2,Fall2018
6274,SW Capitol & Miles,948,N,NS,30,4,34,0,Fall2018
6275,SW Capitol & Miles,949,S,FS,4,39,43,2,Fall2018
6278,SW Capitol & Pomona,951,S,FS,3,41,44,3,Fall2018
6279,SW Capitol & Pomona,952,N,NS,35,4,39,7,Fall2018
6281,SW Capitol & Sunset,955,W,NS,381,356,737,34,Fall2018
6284,SW Capitol & Terwilliger,956,E,NS,17,19,36,1,Fall2018
6285,SW Capitol & Terwilliger,957,W,FS,22,21,43,1,Fall2018
6286,SW Capitol & Texas,958,S,FS,1,13,14,0,Fall2018
6257,SW Capitol & California,959,N,NS,13,9,22,0,Fall2018
6276,SW Capitol & Nebraska,963,E,FS,26,3,29,0,Fall2018
6277,SW Capitol & Nebraska,964,W,OP,16,37,53,3,Fall2018
6240,SW Capitol & 26th ,965,E,FS,104,20,124,5,Fall2018
6241,SW Capitol & 26th ,966,W,FS,27,107,134,18,Fall2018
6242,SW Capitol & 33rd ,970,W,NS,16,94,110,7,Fall2018
6243,SW Capitol & 33rd ,971,E,OP,92,13,105,7,Fall2018
6244,SW Capitol & 35th ,972,E,NS,114,38,152,26,Fall2018
6256,SW Capitol & Brugger,975,E,NS,8,1,9,0,Fall2018
679,8600 Block SE Causey,984,W,AT,22,9,31,8,Fall2018
682,8800 Block SE Causey,987,E,OP,7,16,23,4,Fall2018
4306,SE Causey & 82nd,989,W,NS,17,11,28,21,Fall2018
6288,SW Cedar Hills & Butner,993,S,FS,15,21,36,0,Fall2018
440,3300 Block SW Cedar Hills,995,N,AT,5,14,19,4,Fall2018
6289,SW Cedar Hills & Butner,996,N,NS,26,13,39,0,Fall2018
6292,SW Cedar Hills & Fairfield,1002,N,NS,38,74,112,35,Fall2018
6293,SW Cedar Hills & Fairfield,1003,S,OP,95,37,132,52,Fall2018
6296,SW Cedar Hills & Huntington,1010,E,OP,0,0,0,0,Fall2018
6297,SW Cedar Hills & Huntington,1011,W,NS,0,1,1,0,Fall2018
6298,SW Cedar Hills & Jenkins,1013,N,NS,15,37,52,9,Fall2018
6299,SW Cedar Hills & Jenkins,1014,S,FS,17,23,40,9,Fall2018
6300,SW Cedar Hills & Lynnridge,1017,E,FS,3,2,5,0,Fall2018
6307,SW Cedar Hills & Lynnridge,1018,W,FS,1,4,5,0,Fall2018
6308,SW Cedar Hills & Park Way,1019,N,NS,12,13,25,3,Fall2018
6309,SW Cedar Hills & Park Way,1020,S,FS,15,8,23,3,Fall2018
6310,SW Cedar Hills & Walker,1021,N,NS,21,36,57,26,Fall2018
6311,SW Cedar Hills & Walker,1022,S,FS,34,33,67,28,Fall2018
1121,Jantzen Beach Main Stop,1026,S,OP,308,347,655,121,Fall2018
6312,SW Center & 125th,1034,E,FS,10,17,27,5,Fall2018
6313,SW Center & 125th,1035,W,FS,16,15,31,3,Fall2018
1328,N Channel Ave & Anchor,1041,E,FS,0,22,22,0,Fall2018
1329,N Channel Ave & Ballast,1042,E,OP,0,0,0,0,Fall2018
1330,N Channel Ave & Commerce,1043,S,OP,0,1,1,0,Fall2018
1331,N Channel Ave & Dolphin,1044,S,OP,3,0,3,0,Fall2018
1333,N Chautauqua & Washburne,1045,N,NS,2,4,6,0,Fall2018
1334,N Chautauqua & Washburne,1046,S,OP,2,1,3,0,Fall2018
1332,N Chautauqua & Alaska,1047,N,NS,10,37,47,4,Fall2018
1335,N Chautauqua & Willis,1050,S,NS,12,7,19,2,Fall2018
6318,SW Chestnut & Bertha,1051,W,NS,7,0,7,0,Fall2018
6315,SW Chestnut & 12th,1053,S,NS,2,1,3,0,Fall2018
6317,SW Chestnut & 14th,1056,N,NS,6,2,8,0,Fall2018
855,Clackamas Community College,1068,N,AT,306,304,610,126,Fall2018
4360,SE Clinton & 21st,1092,W,NS,10,9,19,0,Fall2018
4361,SE Clinton & 23rd,1093,E,NS,4,4,8,0,Fall2018
4362,SE Clinton & 23rd,1094,W,FS,6,1,7,0,Fall2018
4363,SE Clinton & 26th,1095,E,NS,33,12,45,0,Fall2018
3677,Rose Quarter Transit Center,1097,N,AT,885,107,992,126,Fall2018
445,3500 Block NE Columbia Blvd,1099,W,AT,3,12,15,0,Fall2018
446,3500 Block NE Columbia Blvd,1100,E,OP,5,3,8,0,Fall2018
462,3800 Block NE Columbia Blvd,1101,W,AT,0,6,6,0,Fall2018
463,3800 Block NE Columbia Blvd,1102,E,AT,6,1,7,0,Fall2018
6324,SW Columbia & Park Ave,1108,E,NS,126,108,234,24,Fall2018
6320,SW Columbia & 12th,1111,E,NS,82,60,142,76,Fall2018
5751,SW 18th & Goose Hollow MAX Station,1114,E,AT,289,132,421,51,Fall2018
2306,NE Columbia Blvd & 27th,1115,W,OP,0,2,2,0,Fall2018
2310,NE Columbia Blvd & 42nd,1116,W,FS,2,5,7,0,Fall2018
2311,NE Columbia Blvd & 42nd,1117,E,FS,5,1,6,0,Fall2018
2312,NE Columbia Blvd & 47th,1118,E,NS,43,17,60,4,Fall2018
6327,SW Commercial & Hall,1122,N,FS,3,9,12,0,Fall2018
6328,SW Commercial & Hall,1123,S,NS,8,7,15,0,Fall2018
6337,SW Corbett & Abernethy,1125,S,NS,0,0,0,0,Fall2018
6338,SW Corbett & Abernethy,1126,N,NS,0,0,0,0,Fall2018
6339,SW Corbett & Bancroft,1127,S,NS,0,1,1,0,Fall2018
6340,SW Corbett & Bancroft,1128,N,NS,1,1,2,0,Fall2018
6341,SW Corbett & Boundary St,1129,N,NS,4,2,6,1,Fall2018
6342,SW Corbett & Carolina,1130,N,NS,1,0,1,0,Fall2018
6343,SW Corbett & Carolina,1131,S,NS,0,2,2,0,Fall2018
6344,SW Corbett & Curry,1132,S,NS,1,1,2,0,Fall2018
6345,SW Corbett & Curry,1133,N,NS,2,1,3,0,Fall2018
6346,SW Corbett & Flower,1134,S,NS,0,1,1,0,Fall2018
6347,SW Corbett & Flower,1135,N,NS,1,0,1,0,Fall2018
6348,SW Corbett & Gaines,1136,N,NS,3,1,4,1,Fall2018
6349,SW Corbett & Gaines,1137,S,NS,2,2,4,0,Fall2018
6350,SW Corbett & Gibbs,1138,S,NS,8,2,10,0,Fall2018
6351,SW Corbett & Gibbs,1139,N,NS,2,12,14,0,Fall2018
6352,SW Corbett & Hamilton,1140,S,NS,2,1,3,0,Fall2018
6353,SW Corbett & Hamilton,1141,N,NS,1,4,5,0,Fall2018
6360,SW Corbett & Mitchell,1146,N,FS,1,0,1,0,Fall2018
6361,SW Corbett & Mitchell,1147,S,NS,2,3,5,0,Fall2018
6362,SW Corbett & Nebraska,1148,S,OP,0,1,1,0,Fall2018
6363,SW Corbett & Pendleton,1149,N,NS,4,1,5,0,Fall2018
6364,SW Corbett & Pendleton,1150,S,NS,1,2,3,0,Fall2018
6365,SW Corbett & Richardson,1151,S,FS,0,3,3,2,Fall2018
6366,SW Corbett & Richardson,1152,N,NS,4,0,4,0,Fall2018
6367,SW Corbett & Sweeney,1155,S,OP,1,1,2,0,Fall2018
2419,NE Evergreen Pkwy & Cornelius Pass Rd,1158,W,FS,7,2,9,0,Fall2018
2417,NE Evergreen Pkwy & 106th (NW 188th),1159,W,NS,28,17,45,4,Fall2018
84,12200 Block NW Cornell,1160,E,AT,12,6,18,12,Fall2018
85,12200 Block NW Cornell,1161,W,OP,1,8,9,9,Fall2018
111,12900 Block NW Cornell,1162,W,AT,11,7,18,0,Fall2018
3297,NW Cornell & Dale ,1163,E,NS,28,12,40,29,Fall2018
138,13900 Block NW Cornell,1165,W,AT,2,2,4,1,Fall2018
150,14100 Block NW Cornell,1166,E,OP,1,0,1,0,Fall2018
151,14100 Block NW Cornell,1167,W,AT,2,8,10,0,Fall2018
3290,NW Cornell & Barnes ,1171,E,NS,12,18,30,0,Fall2018
3298,NW Cornell & Dale ,1172,W,NS,14,11,25,7,Fall2018
3301,NW Cornell & Murray ,1174,W,FS,36,34,70,24,Fall2018
3312,NW Cornell & Saltzman ,1182,W,FS,46,49,95,8,Fall2018
3313,NW Cornell & Saltzman ,1183,E,NS,46,33,79,19,Fall2018
3314,NW Cornell & Science Park Dr,1184,W,OP,14,30,44,1,Fall2018
136,13800 Block NW Cornell (Sunset HS),1186,E,AT,2,5,7,0,Fall2018
3316,NW Cornell & Trail ,1187,W,FS,14,19,33,5,Fall2018
3317,NW Cornell & Trail ,1188,E,OP,21,13,34,3,Fall2018
171,14600 Block NW Cornell,1189,E,AT,28,14,42,1,Fall2018
3296,NW Cornell & Cornell Woods,1190,W,OP,10,18,28,0,Fall2018
3259,NW Cornell & 110th,1194,E,FS,0,0,0,0,Fall2018
3260,NW Cornell & 110th,1195,W,NS,0,0,0,0,Fall2018
3295,NW Cornell & Cedar Hills Blvd,1196,E,NS,6,3,9,0,Fall2018
3261,NW Cornell & 113th,1199,W,FS,4,8,12,0,Fall2018
3264,NW Cornell & 119th,1200,E,OP,7,4,11,1,Fall2018
3265,NW Cornell & 119th,1201,W,NS,8,9,17,2,Fall2018
3266,NW Cornell & 123rd,1203,W,FS,4,13,17,3,Fall2018
3267,NW Cornell & 143rd,1204,E,OP,31,13,44,1,Fall2018
3268,NW Cornell & 153rd,1205,E,FS,12,9,21,1,Fall2018
488,4100 Block SW Council Crest,1207,E,AT,0,1,1,0,Fall2018
6368,SW Council Crest & Chehalem,1211,N,FS,1,0,1,0,Fall2018
6369,SW Council Crest & Chehalem,1212,E,NS,2,2,4,0,Fall2018
6370,SW Council Crest & Chehalem,1213,W,OP,3,0,3,0,Fall2018
6371,SW Council Crest & Chehalem (south leg),1214,S,NS,0,1,1,0,Fall2018
6372,SW Council Crest & Greenway,1215,E,FS,1,3,4,0,Fall2018
6373,SW Council Crest & Tualatin,1217,S,OP,0,2,2,0,Fall2018
6374,SW Council Crest & Tualatin,1218,W,NS,1,1,2,0,Fall2018
613,700 Block Country Club,1219,W,AT,0,0,0,0,Fall2018
867,Country Club & Boones Ferry Rd,1220,W,NS,1,2,3,0,Fall2018
870,Country Club & Iron Mtn,1221,W,FS,1,1,2,0,Fall2018
871,Country Club & Iron Mtn,1222,E,NS,0,2,2,0,Fall2018
872,Country Club & Knaus Rd,1223,W,NS,2,1,3,0,Fall2018
873,Country Club & Knaus Rd,1224,E,OP,0,1,1,0,Fall2018
344,2500 Block Country Club,1225,E,AT,17,18,35,27,Fall2018
869,Country Club & Hazel Road,1226,W,FS,20,19,39,27,Fall2018
874,Country Club & Redwood,1227,W,NS,0,0,0,0,Fall2018
868,Country Club & Bridge,1228,E,NS,0,0,0,0,Fall2018
875,Country Club & Sundeleaf,1229,W,OP,1,0,1,0,Fall2018
876,Country Club & Sundeleaf,1230,E,NS,0,3,3,0,Fall2018
877,Country Club & Uplands,1231,W,OP,0,0,0,0,Fall2018
878,Country Club & Uplands,1232,E,NS,0,0,0,0,Fall2018
879,Country Club & Wembley Park,1233,W,OP,0,0,0,0,Fall2018
880,Country Club & Wembley Park,1234,E,NS,0,1,1,0,Fall2018
2360,NE Cully & Shaver,1239,S,FS,6,1,7,0,Fall2018
2358,NE Cully & Prescott,1240,N,NS,40,107,147,71,Fall2018
2359,NE Cully & Prescott,1241,S,FS,126,43,169,67,Fall2018
2355,NE Cully & Killingsworth,1243,N,FS,4,1,5,0,Fall2018
2356,NE Cully & Mason,1244,N,FS,6,32,38,3,Fall2018
2357,NE Cully & Mason,1245,S,NS,17,5,22,1,Fall2018
4365,SE Currin & Hwy 211-224,1252,S,NS,1,0,1,0,Fall2018
985,E Dartmouth & Cornell,1255,E,NS,4,2,6,0,Fall2018
986,E Dartmouth & Cornell,1256,W,NS,2,6,8,1,Fall2018
987,E Dartmouth & Harvard,1257,E,NS,5,1,6,1,Fall2018
988,E Dartmouth & Harvard,1258,W,NS,0,5,5,1,Fall2018
989,E Dartmouth & Portland Ave,1259,W,NS,2,15,17,8,Fall2018
2377,NE Dekum & Dean,1264,E,NS,45,13,58,4,Fall2018
2378,NE Dekum & Durham,1265,E,FS,67,16,83,25,Fall2018
2385,NE Dekum & Durham,1267,W,NS,22,54,76,12,Fall2018
2387,NE Dekum & Saratoga,1271,W,NS,9,9,18,14,Fall2018
2386,NE Dekum & M L King,1273,W,NS,26,102,128,26,Fall2018
2376,NE Dekum & Claremont,1275,W,FS,15,46,61,7,Fall2018
2361,NE Dekum & 15th,1277,W,NS,27,18,45,3,Fall2018
2362,NE Dekum & 15th,1278,E,NS,20,25,45,4,Fall2018
2363,NE Dekum & 18th,1280,W,FS,18,14,32,1,Fall2018
2364,NE Dekum & 18th,1281,E,NS,13,17,30,1,Fall2018
2365,NE Dekum & 22nd,1282,W,NS,13,6,19,1,Fall2018
2366,NE Dekum & 22nd,1283,E,FS,8,12,20,1,Fall2018
2367,NE Dekum & 24th,1284,E,NS,6,9,15,12,Fall2018
2368,NE Dekum & 27th,1285,W,NS,25,20,45,13,Fall2018
2369,NE Dekum & 27th,1286,E,NS,42,25,67,11,Fall2018
2370,NE Dekum & 29th,1287,W,FS,24,22,46,2,Fall2018
2371,NE Dekum & 29th,1288,E,FS,19,33,52,0,Fall2018
2372,NE Dekum & 32nd Pl,1289,W,OP,34,23,57,2,Fall2018
2373,NE Dekum & 33rd,1290,E,NS,30,40,70,3,Fall2018
2374,NE Dekum & 6th,1292,W,NS,11,40,51,5,Fall2018
2375,NE Dekum & 6th,1293,E,NS,134,48,182,48,Fall2018
1346,N Denver & Russet,1299,S,OP,4,17,21,13,Fall2018
1347,N Denver & Terry,1300,N,NS,2,14,16,1,Fall2018
1348,N Denver & Terry,1301,S,NS,10,1,11,0,Fall2018
1349,N Denver & Watts,1303,N,FS,3,12,15,3,Fall2018
1350,N Denver & Watts,1304,S,NS,8,2,10,0,Fall2018
120,13100 Block SE Division,1309,W,AT,24,8,32,1,Fall2018
218,16900 Block SE Division,1310,W,AT,70,22,92,63,Fall2018
430,3100 Block NW Division,1312,E,AT,6,15,21,1,Fall2018
4466,SE Division & 68th,1313,W,FS,73,34,107,10,Fall2018
629,7300 Block SE Division,1314,E,AT,11,37,48,4,Fall2018
3326,NW Division & Civic Dr ,1315,E,FS,5,38,43,10,Fall2018
3327,NW Division & Civic Dr ,1316,W,FS,41,7,48,10,Fall2018
2396,NE Division & Hogan Pl,1317,W,FS,32,47,79,35,Fall2018
2400,NE Division & Palmblad Dr,1320,E,FS,4,14,18,17,Fall2018
3325,NW Division & Birdsdale ,1321,E,NS,11,14,25,2,Fall2018
891,Division & Buchanan,1323,E,OP,3,1,4,0,Fall2018
2388,NE Division & Burnside,1324,E,FS,40,32,72,30,Fall2018
2389,NE Division & Burnside,1325,W,FS,7,11,18,12,Fall2018
271,19200 Block SE Division,1326,W,AT,7,7,14,2,Fall2018
2390,NE Division & Cleveland,1327,W,FS,2,11,13,2,Fall2018
2391,NE Division & Cleveland,1328,E,NS,11,5,16,4,Fall2018
3328,NW Division & Eastman Parkway,1331,E,FS,11,103,114,40,Fall2018
3329,NW Division & Eastman Parkway,1332,W,NS,69,6,75,24,Fall2018
3330,NW Division & Eastwood ,1334,W,NS,18,7,25,9,Fall2018
2392,NE Division & Fleming,1335,E,NS,6,6,12,1,Fall2018
2393,NE Division & Fleming,1336,W,OP,4,4,8,0,Fall2018
2394,NE Division & Francis,1338,W,OP,6,15,21,13,Fall2018
2395,NE Division & Hogan,1339,E,FS,33,21,54,25,Fall2018
2397,NE Division & Kelly,1340,W,NS,1,22,23,5,Fall2018
4487,SE Division & Ladd ,1341,W,FS,70,66,136,33,Fall2018
3331,NW Division & Miller ,1342,W,FS,19,2,21,3,Fall2018
892,Division & Morton,1343,N,NS,7,5,12,1,Fall2018
3332,NW Division & Norman ,1344,E,FS,2,22,24,8,Fall2018
3340,NW Division & Riverview,1346,E,NS,3,3,6,1,Fall2018
3341,NW Division & Riverview,1347,W,FS,8,8,16,0,Fall2018
2399,NE Division & Main,1348,E,FS,4,52,56,10,Fall2018
4410,SE Division & 165th,1350,W,OP,14,16,30,12,Fall2018
893,Division & Selma,1351,E,NS,2,0,2,0,Fall2018
2401,NE Division & Village Squire Ct,1355,E,OP,10,10,20,2,Fall2018
2402,NE Division & Village Squire Ct,1356,W,NS,13,12,25,13,Fall2018
3342,NW Division & Wallula,1357,E,FS,4,22,26,1,Fall2018
3343,NW Division & Wallula,1358,W,FS,20,7,27,0,Fall2018
4366,SE Division & 101st,1359,E,NS,15,37,52,5,Fall2018
4367,SE Division & 101st,1360,W,NS,22,16,38,13,Fall2018
4368,SE Division & 103rd,1361,E,NS,9,20,29,10,Fall2018
4369,SE Division & 104th Dr,1362,W,NS,24,7,31,5,Fall2018
4370,SE Division & 105th,1363,E,FS,5,16,21,2,Fall2018
4371,SE Division & 106th,1364,W,NS,9,6,15,6,Fall2018
4372,SE Division & 109th,1365,E,NS,14,37,51,30,Fall2018
4373,SE Division & 110th,1367,W,NS,20,6,26,19,Fall2018
4374,SE Division & 112th,1368,E,FS,35,72,107,19,Fall2018
4375,SE Division & 112th,1369,W,NS,68,40,108,33,Fall2018
4377,SE Division & 116th,1370,E,OP,11,23,34,6,Fall2018
4376,SE Division & 115th,1371,W,FS,20,9,29,1,Fall2018
4378,SE Division & 119th,1373,E,FS,30,118,148,38,Fall2018
4379,SE Division & 119th,1374,W,OP,50,17,67,13,Fall2018
4384,SE Division & 12th,1375,E,NS,176,87,263,15,Fall2018
4385,SE Division & 12th,1376,W,FS,77,164,241,14,Fall2018
885,Division & 12th,1377,S,NS,5,4,9,3,Fall2018
4380,SE Division & 122nd,1379,E,FS,188,180,368,133,Fall2018
4381,SE Division & 122nd,1381,W,FS,210,150,360,123,Fall2018
4382,SE Division & 124th,1382,W,NS,65,76,141,50,Fall2018
4383,SE Division & 125th,1383,E,NS,31,84,115,33,Fall2018
886,Division & 13th,1385,N,OP,6,3,9,2,Fall2018
4386,SE Division & 130th,1386,E,NS,44,100,144,24,Fall2018
4387,SE Division & 130th,1387,W,FS,132,46,178,31,Fall2018
4388,SE Division & 131st,1388,E,FS,11,36,47,2,Fall2018
4390,SE Division & 136th,1389,E,FS,42,114,156,30,Fall2018
4389,SE Division & 135th,1390,W,NS,100,30,130,37,Fall2018
4391,SE Division & 138th,1391,E,NS,17,30,47,5,Fall2018
4392,SE Division & 139th,1392,W,FS,58,24,82,7,Fall2018
887,Division & 13th,1393,S,NS,2,5,7,0,Fall2018
4399,SE Division & 142nd,1396,W,NS,60,15,75,10,Fall2018
4400,SE Division & 145th,1398,E,FS,52,145,197,78,Fall2018
4401,SE Division & 145th,1399,W,NS,89,28,117,43,Fall2018
4402,SE Division & 148th,1400,E,FS,68,56,124,33,Fall2018
888,Division & 15th,1403,S,FS,4,8,12,6,Fall2018
889,Division & 15th,1404,N,NS,12,4,16,4,Fall2018
4404,SE Division & 151st,1405,E,FS,6,25,31,2,Fall2018
4405,SE Division & 152nd,1407,W,NS,33,11,44,5,Fall2018
4406,SE Division & 156th,1408,W,NS,96,34,130,30,Fall2018
4408,SE Division & 162nd,1415,E,FS,69,192,261,66,Fall2018
4409,SE Division & 162nd,1416,W,NS,186,67,253,69,Fall2018
4411,SE Division & 165th,1417,E,FS,13,21,34,17,Fall2018
4412,SE Division & 168th,1418,E,NS,23,60,83,75,Fall2018
4417,SE Division & 17th,1419,E,NS,21,38,59,2,Fall2018
4418,SE Division & 17th,1420,W,OP,47,18,65,7,Fall2018
4413,SE Division & 174th,1422,E,NS,42,100,142,20,Fall2018
4414,SE Division & 174th,1423,W,NS,95,41,136,18,Fall2018
4415,SE Division & 176th Pl,1425,W,OP,58,17,75,7,Fall2018
4419,SE Division & 182nd,1427,E,FS,69,141,210,69,Fall2018
4420,SE Division & 182nd,1428,W,FS,150,51,201,72,Fall2018
4421,SE Division & 185th,1429,E,FS,6,11,17,4,Fall2018
4422,SE Division & 185th,1430,W,NS,16,21,37,4,Fall2018
4423,SE Division & 190th,1433,E,NS,7,16,23,7,Fall2018
4424,SE Division & 190th,1434,W,FS,11,4,15,10,Fall2018
4425,SE Division & 20th,1435,E,NS,87,114,201,23,Fall2018
4426,SE Division & 23rd,1439,E,NS,28,26,54,2,Fall2018
4428,SE Division & 26th,1441,E,NS,56,56,112,4,Fall2018
4429,SE Division & 26th,1442,W,FS,58,54,112,3,Fall2018
4430,SE Division & 28th Pl,1444,W,NS,39,26,65,0,Fall2018
4431,SE Division & 28th Pl,1445,E,NS,27,40,67,0,Fall2018
4432,SE Division & 30th,1447,E,NS,13,48,61,1,Fall2018
4433,SE Division & 30th,1448,W,NS,40,14,54,1,Fall2018
4434,SE Division & 32nd,1449,E,NS,24,65,89,4,Fall2018
4435,SE Division & 32nd,1450,W,NS,63,23,86,0,Fall2018
4436,SE Division & 34th,1451,E,NS,22,76,98,3,Fall2018
4437,SE Division & 34th,1452,W,NS,76,29,105,6,Fall2018
4439,SE Division & 37th,1457,W,NS,111,30,141,8,Fall2018
4485,SE Division & Cesar Chavez Blvd,1458,E,NS,145,141,286,57,Fall2018
4486,SE Division & Cesar Chavez Blvd,1459,W,NS,117,181,298,78,Fall2018
4440,SE Division & 41st,1461,W,NS,38,21,59,8,Fall2018
4441,SE Division & 41st,1462,E,NS,31,41,72,12,Fall2018
4444,SE Division & 45th,1465,E,FS,14,36,50,2,Fall2018
4445,SE Division & 45th,1466,W,NS,44,9,53,1,Fall2018
4452,SE Division & 48th,1467,E,NS,18,49,67,4,Fall2018
4453,SE Division & 48th,1468,W,NS,49,10,59,1,Fall2018
4455,SE Division & 50th,1470,W,NS,66,59,125,15,Fall2018
4456,SE Division & 52nd,1471,E,FS,115,68,183,17,Fall2018
4457,SE Division & 52nd,1472,W,NS,76,63,139,13,Fall2018
4458,SE Division & 55th,1475,E,FS,105,49,154,10,Fall2018
4459,SE Division & 58th,1476,W,FS,39,90,129,13,Fall2018
4460,SE Division & 60th,1477,E,OP,21,61,82,17,Fall2018
4461,SE Division & 60th,1478,W,FS,47,13,60,18,Fall2018
4463,SE Division & 64th,1480,E,NS,16,38,54,2,Fall2018
4464,SE Division & 64th,1481,W,OP,33,11,44,1,Fall2018
4465,SE Division & 67th,1483,E,FS,39,67,106,13,Fall2018
4467,SE Division & 71st,1486,E,FS,11,36,47,1,Fall2018
4468,SE Division & 71st,1487,W,OP,31,10,41,1,Fall2018
4469,SE Division & 74th,1488,W,OP,52,13,65,3,Fall2018
4470,SE Division & 76th,1489,E,OP,13,74,87,5,Fall2018
4471,SE Division & 76th,1490,W,NS,32,10,42,1,Fall2018
4472,SE Division & 77th,1492,W,NS,54,6,60,3,Fall2018
4473,SE Division & 79th,1493,E,NS,7,57,64,5,Fall2018
4480,SE Division & 8th,1496,W,FS,5,23,28,4,Fall2018
4474,SE Division & 82nd,1497,E,FS,392,300,692,115,Fall2018
4475,SE Division & 82nd,1499,W,FS,303,393,696,114,Fall2018
4476,SE Division & 85th,1500,E,NS,19,35,54,3,Fall2018
4477,SE Division & 85th,1501,W,NS,26,19,45,2,Fall2018
4478,SE Division & 89th,1502,W,NS,27,16,43,0,Fall2018
4479,SE Division & 89th,1503,E,FS,15,20,35,2,Fall2018
890,Division & 9th,1504,W,FS,0,1,1,0,Fall2018
4481,SE Division & 92nd,1505,E,NS,21,36,57,9,Fall2018
4482,SE Division & 92nd,1506,W,FS,41,21,62,5,Fall2018
4484,SE Division & 98th,1508,W,FS,37,15,52,9,Fall2018
432,3100 Block SW Dosch,1510,S,AT,0,0,0,0,Fall2018
6386,SW Dosch & Doschview,1511,S,OP,0,0,0,0,Fall2018
448,3500 Block SW Dosch,1513,S,AT,0,0,0,0,Fall2018
6382,SW Dosch & Bridlemile,1515,E,NS,0,2,2,0,Fall2018
6383,SW Dosch & Bridlemile,1516,W,OP,4,0,4,0,Fall2018
6384,SW Dosch & Dosch Ct,1517,S,FS,0,9,9,0,Fall2018
6385,SW Dosch & Dosch Ct,1518,N,OP,8,0,8,0,Fall2018
6388,SW Dosch & Hamilton,1519,N,NS,0,1,1,0,Fall2018
6389,SW Dosch & Martins,1520,S,OP,0,0,0,0,Fall2018
6390,SW Dosch & Martins,1521,N,FS,0,0,0,0,Fall2018
6391,SW Dosch & Newby,1522,S,OP,0,0,0,0,Fall2018
6392,SW Dosch & Newby,1523,N,FS,1,0,1,0,Fall2018
6393,SW Dosch & Patton,1524,N,NS,13,1,14,0,Fall2018
546,5400 Block SE Duke,1528,E,AT,5,10,15,2,Fall2018
4512,SE Duke & 78th,1529,W,OP,29,3,32,1,Fall2018
4493,SE Duke & 52nd ,1530,W,NS,10,7,17,1,Fall2018
4494,SE Duke & 57th ,1531,E,FS,2,11,13,7,Fall2018
4495,SE Duke & 57th ,1532,W,FS,12,2,14,4,Fall2018
4496,SE Duke & 60th ,1534,W,NS,49,16,65,31,Fall2018
4498,SE Duke & 64th ,1537,E,NS,9,28,37,4,Fall2018
4505,SE Duke & 65th,1538,W,NS,30,8,38,7,Fall2018
4506,SE Duke & 67th,1539,E,NS,10,36,46,48,Fall2018
4497,SE Duke & 60th ,1540,E,NS,19,44,63,33,Fall2018
4507,SE Duke & 67th,1541,W,NS,34,6,40,40,Fall2018
4508,SE Duke & 72nd,1544,E,NS,18,66,84,12,Fall2018
4509,SE Duke & 72nd,1545,W,FS,58,18,76,8,Fall2018
4511,SE Duke & 75th,1546,E,NS,4,26,30,11,Fall2018
4510,SE Duke & 74th,1547,W,NS,34,6,40,11,Fall2018
4513,SE Duke & 78th,1548,E,NS,2,29,31,2,Fall2018
4515,SE Duke & 82nd,1550,E,NS,6,101,107,45,Fall2018
4514,SE Duke & 81st,1551,W,NS,92,7,99,33,Fall2018
4516,SE Eagle Creek Rd & Currin,1555,N,FS,0,0,0,0,Fall2018
391,28200 Block SE Eagle Creek Rd,1556,S,AT,2,1,3,0,Fall2018
392,28400 Block SE Eagle Creek Rd,1557,N,AT,2,2,4,0,Fall2018
353,25800 Block SE Eagle Creek Rd,1558,N,AT,6,4,10,0,Fall2018
4528,SE Eagle Creek Rd & Riverside Way,1559,S,FS,4,5,9,1,Fall2018
4519,SE Eagle Creek Rd & Folsom,1560,S,NS,0,0,0,0,Fall2018
4520,SE Eagle Creek Rd & Heiple Rd,1561,N,OP,1,0,1,0,Fall2018
4521,SE Eagle Creek Rd & Heiple Rd,1562,S,FS,0,1,1,0,Fall2018
4523,SE Eagle Creek Rd & Hwy 211,1563,S,FS,2,2,4,0,Fall2018
4524,SE Eagle Creek Rd & Hwy 211,1564,N,NS,1,3,4,0,Fall2018
4525,SE Eagle Creek Rd & Risberg,1565,N,OP,2,0,2,0,Fall2018
4526,SE Eagle Creek Rd & Risberg,1566,S,NS,1,2,3,0,Fall2018
4530,SE Eagle Creek Rd & Wildcat Mtn,1567,S,NS,0,2,2,0,Fall2018
4531,SE Eagle Creek Rd & Wildcat Mtn,1568,N,FS,2,1,3,0,Fall2018
6404,SW Eastman & Birdsdale,1569,N,OP,6,1,7,1,Fall2018
6405,SW Eastman & Birdsdale,1570,S,FS,1,2,3,0,Fall2018
176,1500 Block NW Eastman,1571,S,AT,4,15,19,14,Fall2018
3348,NW Eastman & Division,1572,N,FS,90,3,93,14,Fall2018
3911,SE 223rd & NW 20th,1576,S,NS,2,8,10,5,Fall2018
6406,SW Eastman & Florence,1577,E,OP,1,0,1,0,Fall2018
6413,SW Eastman & Florence ,1578,W,FS,0,1,1,0,Fall2018
116,1300 Block NW Eastman,1579,S,AT,2,100,102,15,Fall2018
6414,SW Eastman & W Powell ,1580,N,NS,1,3,4,0,Fall2018
3350,NW Eastman & W Powell,1581,S,NS,1,1,2,1,Fall2018
573,600 Block NW Eastman (Townfair),1582,N,AT,0,0,0,0,Fall2018
574,600 Block NW Eastman (Townfair),1583,S,OP,1,0,1,0,Fall2018
3345,NW Eastman & 3rd,1585,N,FS,2,2,4,0,Fall2018
3346,NW Eastman & 3rd,1586,S,OP,1,1,2,0,Fall2018
6402,SW Eastman & 4th,1587,E,OP,1,0,1,0,Fall2018
6403,SW Eastman & 4th,1588,S,FS,0,1,1,0,Fall2018
4537,SE Ellis & Foster,1596,W,NS,3,17,20,0,Fall2018
4538,SE Ellis & Foster,1597,E,FS,2,3,5,0,Fall2018
4532,SE Ellis & 86th Ave,1598,W,NS,9,3,12,0,Fall2018
4533,SE Ellis & 86th Ct,1600,E,OP,4,10,14,0,Fall2018
4534,SE Ellis & 89th,1602,E,OP,1,7,8,1,Fall2018
4536,SE Ellis & 92nd,1604,E,NS,1,13,14,0,Fall2018
3357,NW Everett & Broadway,1606,E,NS,23,45,68,12,Fall2018
3351,NW Everett & 11th,1607,E,FS,79,33,112,15,Fall2018
3352,NW Everett & 14th,1608,E,NS,42,16,58,3,Fall2018
3353,NW Everett & 19th,1611,E,NS,90,21,111,42,Fall2018
3355,NW Everett & 2nd,1612,E,NS,305,146,451,93,Fall2018
3354,NW Everett & 21st,1615,E,FS,117,35,152,48,Fall2018
362,2700 Block SW Fairview,1618,E,AT,0,0,0,0,Fall2018
363,2700 Block SW Fairview,1619,W,OP,0,0,0,0,Fall2018
387,2800 Block SW Fairview,1620,W,AT,0,0,0,0,Fall2018
388,2800 Block SW Fairview,1622,S,OP,0,0,0,0,Fall2018
389,2800 Block SW Fairview,1623,N,AT,0,0,0,0,Fall2018
484,4000 Block SW Fairview (Arboretum),1624,N,AT,2,1,3,0,Fall2018
485,4000 Block SW Fairview (Arboretum),1625,S,OP,1,1,2,0,Fall2018
6417,SW Fairview & Bennington ,1626,E,OP,0,2,2,0,Fall2018
6418,SW Fairview & Bennington ,1627,S,FS,3,0,3,0,Fall2018
6419,SW Fairview & Canterbury ,1628,N,NS,1,0,1,0,Fall2018
6420,SW Fairview & Cascade ,1629,S,NS,2,0,2,0,Fall2018
6421,SW Fairview & Champlain ,1632,E,OP,0,0,0,0,Fall2018
6422,SW Fairview & Kingston ,1633,E,NS,9,18,27,1,Fall2018
399,2900 Block SW Fairview,1635,W,AT,0,1,1,0,Fall2018
400,2900 Block SW Fairview,1636,E,OP,0,0,0,0,Fall2018
6424,SW Fairview & View Place ,1637,S,FS,0,2,2,0,Fall2018
6425,SW Fairview & Wildwood Trail,1638,N,AT,0,0,0,0,Fall2018
6426,SW Fairview & Wildwood Trail,1639,S,AT,0,0,0,0,Fall2018
6432,SW Farmington & 156th,1640,E,OP,51,27,78,0,Fall2018
6433,SW Farmington & 157th Pl,1641,W,OP,31,48,79,1,Fall2018
252,18200 Block SW Farmington,1642,E,AT,1,0,1,0,Fall2018
6449,SW Farmington & Erickson ,1646,E,FS,6,27,33,2,Fall2018
6451,SW Farmington & Hall ,1648,W,NS,46,6,52,7,Fall2018
6453,SW Farmington & Hocken ,1649,W,NS,9,3,12,1,Fall2018
6454,SW Farmington & Hocken ,1650,E,FS,3,10,13,1,Fall2018
6455,SW Farmington & Kinnaman ,1651,W,FS,22,62,84,4,Fall2018
6456,SW Farmington & Kinnaman ,1652,E,NS,34,18,52,5,Fall2018
237,17500 Block SW Farmington,1657,W,OP,68,68,136,43,Fall2018
6459,SW Farmington & Remington Dr,1658,E,FS,84,77,161,28,Fall2018
6457,SW Farmington & Murray ,1660,W,FS,47,53,100,12,Fall2018
6458,SW Farmington & Murray ,1661,E,NS,65,62,127,12,Fall2018
6470,SW Farmington & Watson ,1665,E,NS,4,65,69,3,Fall2018
6427,SW Farmington & 142nd,1668,W,FS,10,24,34,5,Fall2018
6428,SW Farmington & 142nd,1669,E,FS,17,11,28,1,Fall2018
6469,SW Farmington & St Marys Dr ,1670,W,FS,19,27,46,36,Fall2018
6429,SW Farmington & 149th,1671,E,NS,37,18,55,36,Fall2018
6430,SW Farmington & 153rd,1672,E,FS,14,4,18,0,Fall2018
6431,SW Farmington & 153rd,1673,W,NS,8,18,26,0,Fall2018
6434,SW Farmington & 160th,1674,W,FS,19,23,42,13,Fall2018
6435,SW Farmington & 160th,1675,E,FS,21,19,40,16,Fall2018
6436,SW Farmington & 165th,1678,W,FS,6,12,18,1,Fall2018
6437,SW Farmington & 165th,1679,E,FS,10,6,16,0,Fall2018
6438,SW Farmington & 170th,1682,W,FS,14,22,36,2,Fall2018
6439,SW Farmington & 170th,1683,E,FS,20,17,37,2,Fall2018
6440,SW Farmington & 179th,1688,E,NS,20,11,31,7,Fall2018
6443,SW Farmington & 188th Ct,1689,W,FS,11,7,18,0,Fall2018
6444,SW Farmington & 188th Ct,1690,E,NS,8,8,16,0,Fall2018
6445,SW Farmington & 192nd,1691,W,FS,5,4,9,0,Fall2018
6446,SW Farmington & 192nd,1692,E,FS,6,4,10,0,Fall2018
6447,SW Farmington & 195th,1693,E,NS,21,11,32,1,Fall2018
6448,SW Farmington & 196th,1694,W,NS,9,17,26,0,Fall2018
1352,N Fessenden & Allegheny,1698,W,NS,6,25,31,6,Fall2018
1353,N Fessenden & Allegheny,1699,E,FS,24,6,30,2,Fall2018
1354,N Fessenden & Berkeley,1700,W,FS,10,28,38,8,Fall2018
1355,N Fessenden & Burr,1703,E,NS,150,51,201,9,Fall2018
1356,N Fessenden & Burr,1704,W,NS,56,145,201,6,Fall2018
1357,N Fessenden & Columbia Way,1707,E,FS,151,21,172,18,Fall2018
1358,N Fessenden & Columbia Way,1708,W,NS,22,124,146,12,Fall2018
1359,N Fessenden & Geneva,1709,E,FS,56,22,78,10,Fall2018
1363,N Fessenden & Midway,1712,E,FS,60,21,81,3,Fall2018
1364,N Fessenden & Midway,1713,W,NS,18,62,80,4,Fall2018
1367,N Fessenden & Richmond,1714,E,FS,59,19,78,7,Fall2018
1368,N Fessenden & Richmond,1715,W,OP,14,48,62,9,Fall2018
1370,N Fessenden & Tioga,1718,W,NS,7,17,24,2,Fall2018
1365,N Fessenden & Portsmouth,1719,W,NS,8,18,26,2,Fall2018
1366,N Fessenden & Portsmouth,1720,E,NS,16,6,22,0,Fall2018
1378,N Fessenden & Van Houten,1721,W,NS,12,33,45,0,Fall2018
1379,N Fessenden & Van Houten,1722,E,NS,39,15,54,4,Fall2018
1380,N Fessenden & Wall,1723,W,OP,10,27,37,6,Fall2018
692,8900 Block SE Flavel,1728,E,OP,1,13,14,1,Fall2018
689,8800 Block SE Flavel,1729,W,OP,13,0,13,0,Fall2018
4539,SE Flavel & 52nd,1731,W,NS,45,15,60,7,Fall2018
4540,SE Flavel & 52nd,1732,E,FS,12,41,53,8,Fall2018
4541,SE Flavel & 57th,1737,W,NS,17,5,22,0,Fall2018
4542,SE Flavel & 57th,1738,E,FS,3,18,21,1,Fall2018
4543,SE Flavel & 60th,1739,E,NS,23,59,82,26,Fall2018
4544,SE Flavel & 60th,1740,W,NS,41,20,61,21,Fall2018
4545,SE Flavel & 62nd,1743,W,NS,28,8,36,12,Fall2018
4546,SE Flavel & 64th,1745,E,NS,7,31,38,18,Fall2018
4548,SE Flavel & 66th Place,1748,E,NS,6,30,36,1,Fall2018
4547,SE Flavel & 66th,1749,W,NS,35,7,42,1,Fall2018
4550,SE Flavel & 70th,1754,E,NS,3,12,15,1,Fall2018
4551,SE Flavel & 72nd,1755,W,FS,65,18,83,10,Fall2018
4558,SE Flavel & 82nd,1759,E,FS,14,22,36,31,Fall2018
4559,SE Flavel & 83rd,1760,W,NS,15,11,26,25,Fall2018
4560,SE Flavel & 85th,1761,E,OP,2,4,6,0,Fall2018
4561,SE Flavel & 86th,1762,W,FS,12,1,13,0,Fall2018
4562,SE Flavel & 87th,1763,E,NS,1,8,9,0,Fall2018
4563,SE Flavel & 92nd,1764,E,FS,2,41,43,24,Fall2018
4564,SE Flavel & 92nd,1765,W,FS,28,1,29,2,Fall2018
4576,SE Foster & 120th,1766,E,OP,13,9,22,8,Fall2018
121,13100 Block SE Foster,1769,W,AT,3,7,10,0,Fall2018
4581,SE Foster & 131st,1770,E,OP,7,6,13,6,Fall2018
4570,SE Foster & 103rd,1772,E,OP,6,2,8,1,Fall2018
62,11600 Block SE Foster,1773,E,OP,17,11,28,1,Fall2018
63,11600 Block SE Foster,1774,W,AT,12,25,37,0,Fall2018
4622,SE Foster & Gladstone,1775,E,FS,6,23,29,4,Fall2018
4623,SE Foster & Holgate,1778,W,NS,79,24,103,15,Fall2018
4568,SE Foster & 101st,1779,E,NS,20,2,22,2,Fall2018
4569,SE Foster & 101st,1780,W,NS,3,11,14,1,Fall2018
4571,SE Foster & 103rd,1781,W,NS,3,7,10,0,Fall2018
4572,SE Foster & 107th,1782,E,OP,1,0,1,0,Fall2018
4573,SE Foster & 107th,1783,W,FS,1,1,2,0,Fall2018
4574,SE Foster & 110th Dr,1784,E,FS,13,12,25,1,Fall2018
4575,SE Foster & 111th,1785,W,NS,13,13,26,1,Fall2018
87,12300 Block SE Foster,1786,E,AT,7,4,11,1,Fall2018
4578,SE Foster & 122nd,1787,W,FS,22,95,117,19,Fall2018
4579,SE Foster & 128th,1788,E,FS,14,12,26,0,Fall2018
4580,SE Foster & 128th,1789,W,FS,16,13,29,1,Fall2018
4582,SE Foster & 134th,1790,E,FS,9,6,15,0,Fall2018
4583,SE Foster & 134th,1791,W,FS,5,7,12,0,Fall2018
4624,SE Foster & Powell,1792,S,FS,42,76,118,17,Fall2018
4584,SE Foster & 52nd,1793,W,NS,72,52,124,26,Fall2018
4585,SE Foster & 52nd,1794,E,FS,94,102,196,23,Fall2018
4586,SE Foster & 56th,1798,W,NS,21,7,28,1,Fall2018
4588,SE Foster & 58th,1799,W,NS,35,5,40,2,Fall2018
4591,SE Foster & 65th,1802,E,FS,31,77,108,32,Fall2018
4592,SE Foster & 65th,1803,W,NS,41,21,62,14,Fall2018
4593,SE Foster & 67th,1804,E,FS,19,46,65,21,Fall2018
4594,SE Foster & 67th,1805,W,NS,33,12,45,17,Fall2018
4595,SE Foster & 69th,1807,W,FS,27,13,40,12,Fall2018
4596,SE Foster & 70th,1808,E,NS,9,17,26,2,Fall2018
4597,SE Foster & 72nd,1810,E,FS,23,78,101,29,Fall2018
4598,SE Foster & 72nd,1811,W,FS,77,22,99,14,Fall2018
4600,SE Foster & 75th,1812,E,OP,2,12,14,2,Fall2018
4601,SE Foster & 77th,1814,E,FS,8,47,55,10,Fall2018
4602,SE Foster & 78th,1815,W,NS,69,14,83,13,Fall2018
4603,SE Foster & 79th,1816,E,FS,6,35,41,16,Fall2018
4604,SE Foster & 82nd,1818,W,FS,235,124,359,54,Fall2018
4611,SE Foster & 82nd,1819,E,NS,59,170,229,44,Fall2018
4612,SE Foster & 85th,1821,E,NS,0,10,10,1,Fall2018
4613,SE Foster & 86th,1823,E,FS,1,40,41,9,Fall2018
4614,SE Foster & 86th,1824,W,FS,33,5,38,0,Fall2018
4615,SE Foster & 88th,1826,W,FS,44,3,47,12,Fall2018
4616,SE Foster & 89th,1827,E,FS,1,55,56,15,Fall2018
4617,SE Foster & 91st,1829,W,FS,71,1,72,10,Fall2018
4619,SE Foster & 94th (I-205 Overpass),1831,W,NS,112,176,288,17,Fall2018
4620,SE Foster & 97th,1832,W,NS,2,15,17,0,Fall2018
2484,NE Fremont & Alameda,1834,E,NS,1,1,2,0,Fall2018
2491,NE Fremont & Alameda,1835,W,FS,2,0,2,0,Fall2018
1382,N Fremont & Borthwick,1837,E,NS,8,19,27,4,Fall2018
2494,NE Fremont & Cleveland,1838,E,NS,14,3,17,4,Fall2018
1383,N Fremont & Gantenbein,1841,W,NS,43,53,96,9,Fall2018
2498,NE Fremont & Mallory,1842,E,OP,2,0,2,0,Fall2018
1381,N Fremont & Albina,1843,W,FS,6,41,47,3,Fall2018
2499,NE Fremont & Mallory,1845,W,NS,2,7,9,2,Fall2018
2496,NE Fremont & M L King,1846,E,NS,15,3,18,4,Fall2018
2497,NE Fremont & M L King,1847,W,NS,2,23,25,7,Fall2018
2426,NE Fremont & 12th,1851,E,NS,6,1,7,0,Fall2018
2425,NE Fremont & 11th,1852,W,NS,2,5,7,0,Fall2018
2427,NE Fremont & 138th,1853,W,FS,1,1,2,0,Fall2018
2428,NE Fremont & 15th,1856,E,FS,15,6,21,2,Fall2018
2429,NE Fremont & 15th,1857,W,NS,8,19,27,4,Fall2018
2430,NE Fremont & 18th,1858,E,NS,2,1,3,0,Fall2018
2431,NE Fremont & 18th,1859,W,NS,1,4,5,0,Fall2018
2438,NE Fremont & 21st,1860,E,NS,2,1,3,0,Fall2018
2439,NE Fremont & 21st,1861,W,FS,2,3,5,0,Fall2018
2440,NE Fremont & 24th,1862,W,FS,3,9,12,0,Fall2018
2441,NE Fremont & 24th,1863,E,NS,10,3,13,0,Fall2018
2442,NE Fremont & 27th,1864,W,NS,1,4,5,0,Fall2018
2443,NE Fremont & 27th,1865,E,NS,5,1,6,0,Fall2018
2444,NE Fremont & 31st,1868,E,NS,1,1,2,0,Fall2018
2495,NE Fremont & Edgehill Place,1869,W,NS,1,1,2,0,Fall2018
2446,NE Fremont & 33rd Place,1870,W,OP,2,4,6,1,Fall2018
2445,NE Fremont & 33rd,1871,E,NS,3,5,8,0,Fall2018
2447,NE Fremont & 35th,1872,E,NS,1,0,1,0,Fall2018
2448,NE Fremont & 35th,1873,W,FS,1,1,2,0,Fall2018
2492,NE Fremont & Cesar Chavez Blvd,1874,E,NS,1,1,2,0,Fall2018
2493,NE Fremont & Cesar Chavez Blvd,1875,W,NS,1,1,2,0,Fall2018
2449,NE Fremont & 41st,1876,E,NS,10,18,28,0,Fall2018
2450,NE Fremont & 42nd,1877,W,FS,20,11,31,0,Fall2018
2453,NE Fremont & 48th,1882,E,NS,4,5,9,2,Fall2018
2454,NE Fremont & 48th,1883,W,FS,5,6,11,4,Fall2018
2455,NE Fremont & 51st,1887,W,FS,3,2,5,0,Fall2018
2457,NE Fremont & 54th,1888,E,NS,2,1,3,0,Fall2018
2458,NE Fremont & 54th,1889,W,OP,7,1,8,0,Fall2018
2459,NE Fremont & 57th,1890,E,FS,4,14,18,2,Fall2018
2460,NE Fremont & 57th,1891,W,FS,16,4,20,6,Fall2018
2461,NE Fremont & 61st,1893,W,NS,2,2,4,0,Fall2018
2462,NE Fremont & 61st,1894,E,NS,3,2,5,0,Fall2018
2463,NE Fremont & 64th,1895,E,NS,2,4,6,2,Fall2018
2464,NE Fremont & 64th,1896,W,FS,3,3,6,0,Fall2018
2466,NE Fremont & 67th,1898,W,NS,4,2,6,0,Fall2018
2474,NE Fremont & 7th,1899,W,NS,1,6,7,0,Fall2018
2475,NE Fremont & 7th,1900,E,FS,9,1,10,1,Fall2018
2468,NE Fremont & 69th,1902,W,NS,6,7,13,15,Fall2018
2469,NE Fremont & 71st,1903,W,NS,5,6,11,2,Fall2018
2470,NE Fremont & 74th,1904,E,NS,4,2,6,2,Fall2018
2471,NE Fremont & 74th,1905,W,NS,2,3,5,3,Fall2018
2472,NE Fremont & 77th,1906,E,NS,1,3,4,0,Fall2018
2473,NE Fremont & 77th,1907,W,NS,3,1,4,0,Fall2018
2476,NE Fremont & 80th,1908,E,NS,1,5,6,1,Fall2018
2477,NE Fremont & 80th,1909,W,NS,1,1,2,0,Fall2018
2478,NE Fremont & 82nd,1910,W,FS,24,8,32,6,Fall2018
2479,NE Fremont & 82nd,1911,E,FS,9,19,28,7,Fall2018
2480,NE Fremont & 85th,1912,E,OP,2,2,4,1,Fall2018
2481,NE Fremont & 85th,1913,W,FS,3,3,6,3,Fall2018
2482,NE Fremont & 88th,1916,W,NS,7,4,11,0,Fall2018
2483,NE Fremont & 89th,1917,E,NS,9,6,15,0,Fall2018
2501,NE Fremont Ct & 145th,1919,E,NS,4,3,7,37,Fall2018
497,4300 Block NW Front,1921,W,AT,0,6,6,0,Fall2018
515,4800 Block NW Front,1922,W,AT,1,5,6,0,Fall2018
505,4500 Block NW Front,1924,W,AT,0,1,1,0,Fall2018
513,4700 Block NW Front,1925,W,AT,0,4,4,0,Fall2018
6854,SW Naito Parkway & Harrison,1926,N,NS,0,46,46,2,Fall2018
6855,SW Naito Parkway & Harrison,1927,S,NS,55,2,57,4,Fall2018
6856,SW Naito Parkway & Hooker,1929,S,AT,27,20,47,1,Fall2018
6857,SW Naito Parkway & Hooker,1930,N,AT,22,88,110,2,Fall2018
459,3700 Block NW Front,1931,W,AT,3,14,17,0,Fall2018
4628,SE Fuller & Sunnyside Dr,1934,N,NS,2,4,6,2,Fall2018
72,11900 Block SE Fuller (La Salle),1935,N,OP,6,1,7,0,Fall2018
73,11900 Block SE Fuller (La Salle),1936,S,AT,6,3,9,0,Fall2018
4626,SE Fuller & Southgate,1939,N,NS,3,2,5,0,Fall2018
4627,SE Fuller & Southgate,1940,S,FS,5,3,8,2,Fall2018
6471,SW Gaines & 11th ,1945,W,NS,38,40,78,1,Fall2018
6472,SW Gaines & 6th ,1947,W,OP,27,55,82,14,Fall2018
6473,SW Gaines & 9th ,1949,W,OP,40,81,121,0,Fall2018
6505,SW Garden Home & Multnomah,1951,W,NS,3,8,11,0,Fall2018
6474,SW Garden Home & 40th,1954,E,NS,3,1,4,0,Fall2018
6475,SW Garden Home & 42nd,1955,W,OP,2,4,6,0,Fall2018
6476,SW Garden Home & 42nd,1956,E,FS,5,1,6,0,Fall2018
6477,SW Garden Home & 45th,1957,W,NS,3,10,13,1,Fall2018
6478,SW Garden Home & 45th,1958,E,NS,15,4,19,0,Fall2018
6479,SW Garden Home & 47th,1959,E,FS,4,1,5,0,Fall2018
6480,SW Garden Home & 47th,1960,W,NS,1,6,7,0,Fall2018
6481,SW Garden Home & 50th,1961,W,OP,1,9,10,0,Fall2018
6482,SW Garden Home & 50th,1962,E,NS,11,0,11,0,Fall2018
6483,SW Garden Home & 52nd,1963,W,OP,1,4,5,0,Fall2018
6484,SW Garden Home & 52nd,1964,E,NS,5,0,5,0,Fall2018
6485,SW Garden Home & 54th,1965,W,NS,0,1,1,0,Fall2018
6486,SW Garden Home & 54th,1966,E,NS,3,1,4,0,Fall2018
6487,SW Garden Home & 56th,1967,W,FS,0,3,3,0,Fall2018
6488,SW Garden Home & 56th,1968,E,NS,2,0,2,0,Fall2018
6489,SW Garden Home & 57th,1969,W,NS,0,8,8,0,Fall2018
6490,SW Garden Home & 57th,1970,E,OP,8,0,8,0,Fall2018
6491,SW Garden Home & 61st,1971,W,NS,1,9,10,0,Fall2018
6492,SW Garden Home & 61st,1972,E,FS,6,1,7,0,Fall2018
6493,SW Garden Home & 62nd Pl,1973,W,NS,1,9,10,0,Fall2018
6494,SW Garden Home & 62nd Pl,1974,E,OP,11,1,12,0,Fall2018
6495,SW Garden Home & 64th,1975,W,NS,0,2,2,0,Fall2018
6496,SW Garden Home & 64th,1976,E,OP,2,0,2,0,Fall2018
6497,SW Garden Home & 66th,1977,W,OP,0,2,2,0,Fall2018
6498,SW Garden Home & 66th,1978,E,FS,3,0,3,0,Fall2018
6499,SW Garden Home & 67th,1979,W,OP,1,2,3,0,Fall2018
6500,SW Garden Home & 67th,1980,E,NS,2,1,3,0,Fall2018
6501,SW Garden Home & 69th/Multnomah,1981,E,FS,10,2,12,4,Fall2018
6502,SW Garden Home & 71st,1982,W,FS,18,53,71,2,Fall2018
6503,SW Garden Home & 71st,1983,E,NS,35,13,48,2,Fall2018
4631,SE Gladstone & 26th,1990,W,NS,14,2,16,0,Fall2018
4632,SE Gladstone & 28th,1991,E,NS,7,20,27,0,Fall2018
1061,Glen Echo & SE Mildred,1993,E,OP,1,4,5,3,Fall2018
1060,Glen Echo & Mildred,1994,W,FS,1,2,3,3,Fall2018
3399,NW Glisan & Broadway,1997,W,FS,85,49,134,44,Fall2018
2607,NE Glisan & Floral,2000,W,FS,16,2,18,0,Fall2018
2608,NE Glisan & Laddington,2001,E,NS,1,10,11,0,Fall2018
2609,NE Glisan & Laddington,2002,W,NS,8,2,10,2,Fall2018
2610,NE Glisan & Laurelhurst,2003,E,NS,2,14,16,1,Fall2018
110,12900 Block NE Glisan (Menlo Park ES),2005,E,AT,1,3,4,2,Fall2018
510,4700 Block NE Glisan,2009,W,OP,87,50,137,96,Fall2018
2515,NE Glisan & 122nd,2010,E,FS,7,4,11,2,Fall2018
3392,NW Glisan & 10th,2011,W,NS,31,65,96,16,Fall2018
2503,NE Glisan & 102nd,2015,E,FS,5,1,6,3,Fall2018
2504,NE Glisan & 102nd,2016,W,NS,1,4,5,1,Fall2018
2505,NE Glisan & 104th,2017,W,NS,0,1,1,0,Fall2018
2506,NE Glisan & 105th,2018,E,NS,0,0,0,0,Fall2018
2507,NE Glisan & 108th,2020,E,OP,2,1,3,0,Fall2018
2508,NE Glisan & 108th,2021,W,NS,1,0,1,0,Fall2018
2509,NE Glisan & 113th,2024,E,NS,1,1,2,0,Fall2018
2510,NE Glisan & 113th,2025,W,NS,1,0,1,0,Fall2018
2511,NE Glisan & 117th,2028,E,NS,0,1,1,1,Fall2018
2512,NE Glisan & 117th,2029,W,NS,2,0,2,0,Fall2018
3393,NW Glisan & 12th,2030,W,NS,16,59,75,8,Fall2018
2513,NE Glisan & 120th,2032,E,OP,1,4,5,1,Fall2018
2516,NE Glisan & 122nd,2034,W,NS,4,7,11,3,Fall2018
2517,NE Glisan & 126th,2036,E,FS,0,0,0,0,Fall2018
2519,NE Glisan & 128th,2037,W,FS,2,1,3,1,Fall2018
2520,NE Glisan & 133rd,2040,E,NS,0,2,2,0,Fall2018
2521,NE Glisan & 133rd,2041,W,OP,2,0,2,0,Fall2018
2522,NE Glisan & 136th,2042,E,NS,0,2,2,0,Fall2018
2523,NE Glisan & 136th,2043,W,OP,5,0,5,0,Fall2018
2524,NE Glisan & 139th,2044,E,NS,1,3,4,0,Fall2018
3394,NW Glisan & 14th,2046,W,NS,13,53,66,3,Fall2018
2525,NE Glisan & 141st,2047,W,OP,3,1,4,0,Fall2018
2526,NE Glisan & 141st,2048,E,FS,0,3,3,0,Fall2018
2527,NE Glisan & 143rd,2049,E,NS,0,0,0,0,Fall2018
2528,NE Glisan & 143rd,2050,W,OP,0,0,0,0,Fall2018
2529,NE Glisan & 146th,2051,E,NS,0,1,1,0,Fall2018
2530,NE Glisan & 148th,2053,E,FS,0,1,1,2,Fall2018
2531,NE Glisan & 148th,2054,W,FS,2,0,2,0,Fall2018
2532,NE Glisan & 152nd,2057,W,NS,1,0,1,0,Fall2018
2534,NE Glisan & 155th,2058,E,OP,1,3,4,0,Fall2018
2535,NE Glisan & 155th,2059,W,NS,4,1,5,0,Fall2018
2536,NE Glisan & 157th,2060,E,NS,1,2,3,0,Fall2018
2537,NE Glisan & 157th,2061,W,FS,4,1,5,2,Fall2018
3395,NW Glisan & 16th,2062,W,NS,1,16,17,4,Fall2018
2544,NE Glisan & 160th,2063,E,FS,0,3,3,1,Fall2018
2545,NE Glisan & 160th,2064,W,NS,2,0,2,0,Fall2018
2546,NE Glisan & 162nd,2065,E,FS,3,10,13,7,Fall2018
2547,NE Glisan & 162nd,2066,W,FS,9,2,11,5,Fall2018
2548,NE Glisan & 165th,2067,E,NS,1,5,6,0,Fall2018
2549,NE Glisan & 165th,2068,W,NS,3,1,4,0,Fall2018
2550,NE Glisan & 167th Pl,2069,E,NS,0,0,0,0,Fall2018
2551,NE Glisan & 167th Pl,2070,W,NS,0,0,0,0,Fall2018
2552,NE Glisan & 172nd,2073,W,FS,2,0,2,0,Fall2018
2553,NE Glisan & 172nd,2074,E,FS,1,2,3,0,Fall2018
2554,NE Glisan & 176th,2075,W,NS,3,0,3,1,Fall2018
2555,NE Glisan & 176th,2076,E,FS,0,2,2,1,Fall2018
2556,NE Glisan & 181st,2081,W,FS,7,3,10,2,Fall2018
3396,NW Glisan & 19th,2086,W,NS,11,78,89,43,Fall2018
3397,NW Glisan & 21st,2099,W,NS,17,150,167,28,Fall2018
2559,NE Glisan & 28th,2105,E,FS,33,64,97,7,Fall2018
2561,NE Glisan & 30th,2106,E,FS,8,17,25,3,Fall2018
2562,NE Glisan & 30th,2107,W,NS,25,9,34,9,Fall2018
2563,NE Glisan & 32nd,2108,E,NS,5,11,16,2,Fall2018
2564,NE Glisan & 32nd,2109,W,NS,11,4,15,1,Fall2018
2605,NE Glisan & Cesar Chavez Blvd,2110,E,FS,33,31,64,20,Fall2018
2606,NE Glisan & Cesar Chavez Blvd,2111,W,FS,31,49,80,28,Fall2018
2565,NE Glisan & 43rd,2114,E,NS,2,14,16,2,Fall2018
2566,NE Glisan & 43rd,2115,W,NS,15,2,17,0,Fall2018
2567,NE Glisan & 45th,2117,W,NS,35,12,47,27,Fall2018
2569,NE Glisan & 49th,2119,E,FS,66,94,160,114,Fall2018
2570,NE Glisan & 52nd,2121,W,NS,59,35,94,44,Fall2018
2571,NE Glisan & 53rd,2122,E,NS,21,48,69,21,Fall2018
2572,NE Glisan & 55th,2123,W,NS,15,11,26,11,Fall2018
2573,NE Glisan & 56th,2124,E,FS,10,14,24,11,Fall2018
2574,NE Glisan & 57th,2126,W,NS,13,6,19,6,Fall2018
2575,NE Glisan & 60th,2127,E,NS,29,49,78,45,Fall2018
2576,NE Glisan & 60th,2128,W,NS,44,29,73,47,Fall2018
2577,NE Glisan & 62nd,2129,W,NS,12,1,13,1,Fall2018
2578,NE Glisan & 62nd,2130,E,NS,2,6,8,1,Fall2018
2579,NE Glisan & 65th,2131,E,NS,4,29,33,9,Fall2018
2580,NE Glisan & 65th,2132,W,NS,39,8,47,31,Fall2018
2581,NE Glisan & 67th,2133,W,NS,33,27,60,21,Fall2018
2582,NE Glisan & 67th,2134,E,NS,27,47,74,35,Fall2018
2583,NE Glisan & 71st,2137,W,NS,36,13,49,3,Fall2018
2584,NE Glisan & 71st,2138,E,NS,10,29,39,2,Fall2018
2585,NE Glisan & 73rd,2139,E,FS,7,28,35,7,Fall2018
2587,NE Glisan & 78th,2143,W,NS,31,11,42,4,Fall2018
2588,NE Glisan & 78th,2144,E,NS,9,30,39,7,Fall2018
2589,NE Glisan & 80th,2145,W,NS,22,5,27,2,Fall2018
2590,NE Glisan & 80th,2146,E,NS,4,17,21,6,Fall2018
2597,NE Glisan & 82nd,2147,E,FS,29,82,111,45,Fall2018
2598,NE Glisan & 82nd,2148,W,NS,76,30,106,59,Fall2018
2599,NE Glisan & 85th,2149,W,OP,6,3,9,0,Fall2018
2600,NE Glisan & 86th,2151,E,NS,4,9,13,0,Fall2018
2601,NE Glisan & 90th,2153,W,NS,19,11,30,3,Fall2018
2602,NE Glisan & 92nd,2155,E,NS,11,22,33,11,Fall2018
2603,NE Glisan & 92nd,2156,W,NS,18,14,32,5,Fall2018
2604,NE Glisan & 94th,2158,E,NS,3,8,11,2,Fall2018
1386,N Going & Port Center Way,2161,W,FS,5,44,49,0,Fall2018
2611,NE Grand & Broadway,2165,N,FS,95,25,120,44,Fall2018
4634,SE Grand & E Burnside,2167,N,NS,229,88,317,64,Fall2018
2613,NE Grand & Hoyt,2169,N,OP,24,27,51,18,Fall2018
4635,SE Grand & Main,2170,N,NS,206,47,253,22,Fall2018
4636,SE Grand & Mill,2171,N,NS,0,4,4,0,Fall2018
2612,NE Grand & Holladay,2175,N,FS,307,136,443,69,Fall2018
2615,NE Grand & Weidler,2178,N,NS,127,58,185,59,Fall2018
1388,N Greeley & Ainsworth,2182,N,NS,2,23,25,2,Fall2018
1389,N Greeley & Ainsworth,2183,S,NS,26,4,30,4,Fall2018
1390,N Greeley & Bryant,2185,N,NS,1,20,21,1,Fall2018
1391,N Greeley & Bryant,2186,S,NS,29,2,31,2,Fall2018
1392,N Greeley & Dekum,2190,N,NS,1,10,11,0,Fall2018
1393,N Greeley & Dekum,2191,S,NS,13,1,14,0,Fall2018
1395,N Greeley & Going Overpass,2195,N,AT,5,12,17,0,Fall2018
1394,N Greeley & Going,2196,S,NS,4,3,7,0,Fall2018
1396,N Greeley & Holman,2197,N,NS,2,11,13,0,Fall2018
1397,N Greeley & Holman,2198,S,NS,19,1,20,1,Fall2018
1398,N Greeley & Jessup,2205,S,NS,17,1,18,0,Fall2018
1399,N Greeley & Jessup,2206,N,NS,2,13,15,0,Fall2018
1400,N Greeley & Killingsworth,2208,N,NS,9,43,52,3,Fall2018
1401,N Greeley & Killingsworth,2209,S,NS,50,13,63,4,Fall2018
1402,N Greeley & Lombard St,2212,N,NS,1,36,37,2,Fall2018
1403,N Greeley & Lombard St,2213,S,FS,38,4,42,5,Fall2018
1404,N Greeley & Rosa Parks Way,2221,N,FS,3,18,21,3,Fall2018
1405,N Greeley & Rosa Parks Way,2222,S,NS,27,3,30,7,Fall2018
1406,N Greeley & Sumner,2226,N,NS,20,37,57,2,Fall2018
1407,N Greeley & Sumner,2227,S,OP,44,24,68,2,Fall2018
6520,SW Greenburg & Cascade,2230,E,OP,39,32,71,10,Fall2018
6521,SW Greenburg & Cascade,2231,S,FS,31,41,72,9,Fall2018
6522,SW Greenburg & Center,2232,N,FS,56,29,85,5,Fall2018
6523,SW Greenburg & Center,2233,S,NS,20,42,62,3,Fall2018
6527,SW Greenburg & North Dakota,2234,N,FS,30,28,58,14,Fall2018
6528,SW Greenburg & North Dakota,2235,S,OP,33,27,60,10,Fall2018
6508,SW Greenburg & 92nd ,2237,E,FS,7,10,17,6,Fall2018
6507,SW Greenburg & 90th ,2238,W,FS,6,5,11,5,Fall2018
6509,SW Greenburg & 92nd ,2239,W,FS,10,9,19,4,Fall2018
6526,SW Greenburg & Lincoln,2240,S,NS,9,4,13,2,Fall2018
6510,SW Greenburg & 95th ,2242,W,NS,6,8,14,1,Fall2018
6511,SW Greenburg & 95th ,2243,E,FS,7,8,15,0,Fall2018
6512,SW Greenburg & 98th ,2245,W,OP,9,14,23,0,Fall2018
6519,SW Greenburg & 98th,2246,E,FS,14,10,24,0,Fall2018
286,200 Block Greenridge,2247,W,OP,0,8,8,0,Fall2018
287,200 Block Greenridge,2248,E,AT,8,1,9,0,Fall2018
1065,Greenridge & Greenridge Ct,2249,N,OP,0,0,0,0,Fall2018
1066,Greenridge & Greenridge Ct,2250,S,FS,0,0,0,0,Fall2018
1067,Greenridge & SW Monroe Pkwy,2251,N,NS,0,0,0,0,Fall2018
6531,SW Greenway & Council Crest,2252,N,FS,1,0,1,0,Fall2018
1072,Gresham Transit Center,2253,E,AT,1132,891,2023,369,Fall2018
6532,SW Haines & Lesser,2257,E,NS,3,4,7,1,Fall2018
550,5500 Block SW Hall,2260,N,AT,23,15,38,41,Fall2018
592,6200 Block SW Hall,2261,N,AT,16,12,28,0,Fall2018
651,7800 Block SW Hall,2262,N,AT,25,10,35,0,Fall2018
652,7800 Block SW Hall,2263,S,AT,12,25,37,1,Fall2018
726,9800 Block SW Hall,2264,N,AT,4,1,5,0,Fall2018
6543,SW Hall & Allen,2266,S,FS,118,63,181,38,Fall2018
6544,SW Hall & Allen,2267,N,NS,59,104,163,42,Fall2018
457,3600 Block SW Hall,2268,E,AT,14,17,31,7,Fall2018
6550,SW Hall & Broadway,2271,N,FS,3,87,90,10,Fall2018
6552,SW Hall & Cascade,2272,E,NS,15,25,40,3,Fall2018
6553,SW Hall & Cedar Hills,2273,W,NS,12,23,35,8,Fall2018
6554,SW Hall & Colony,2274,W,NS,8,5,13,3,Fall2018
6555,SW Hall & Creekside,2275,W,OP,39,18,57,12,Fall2018
6556,SW Hall & Creekside,2276,E,FS,9,24,33,2,Fall2018
6557,SW Hall & Cresmoor,2277,W,NS,5,5,10,4,Fall2018
6558,SW Hall & Denney,2278,N,FS,23,14,37,0,Fall2018
6559,SW Hall & Denney,2279,S,FS,13,27,40,1,Fall2018
6561,SW Hall & Green Lane,2280,S,NS,6,8,14,0,Fall2018
6562,SW Hall & Greenburg,2282,E,FS,5,2,7,0,Fall2018
6564,SW Hall & Greenway,2283,E,FS,30,65,95,16,Fall2018
6565,SW Hall & Greenway,2284,W,FS,56,22,78,10,Fall2018
6572,SW Hall & Hart,2285,N,FS,20,12,32,8,Fall2018
6573,SW Hall & Hart,2286,S,FS,11,26,37,6,Fall2018
6574,SW Hall & Hemlock,2287,N,FS,2,1,3,3,Fall2018
6581,SW Hall & Nimbus,2290,E,FS,18,48,66,10,Fall2018
6587,SW Hall & Ridgecrest,2291,W,FS,15,11,26,1,Fall2018
6588,SW Hall & Ridgecrest,2292,E,OP,12,30,42,5,Fall2018
6591,SW Hall & Scholls Ferry,2295,W,NS,83,27,110,18,Fall2018
6592,SW Hall & Scholls Ferry,2296,E,FS,16,58,74,13,Fall2018
6594,SW Hall & Sussex,2297,N,NS,14,12,26,0,Fall2018
6597,SW Hall & Washington,2298,W,FS,1,0,1,0,Fall2018
6598,SW Hall & Washington,2299,E,FS,2,2,4,4,Fall2018
6533,SW Hall & 13th,2300,N,OP,16,6,22,1,Fall2018
6534,SW Hall & 13th,2301,S,NS,14,29,43,15,Fall2018
6536,SW Hall & 2nd,2302,N,FS,16,46,62,15,Fall2018
6535,SW Hall & 22nd,2303,S,NS,14,20,34,2,Fall2018
6537,SW Hall & 5th,2305,N,NS,25,38,63,32,Fall2018
6539,SW Hall & 88th,2307,W,FS,1,0,1,0,Fall2018
6540,SW Hall & 88th,2308,E,OP,0,1,1,0,Fall2018
6541,SW Hall & 91st,2311,W,FS,0,1,1,0,Fall2018
6542,SW Hall & 91st,2312,E,OP,0,1,1,0,Fall2018
1409,N Halleck & Delaware,2315,N,OP,12,13,25,3,Fall2018
1410,N Halleck & Delaware,2316,E,NS,11,9,20,1,Fall2018
1411,N Halleck & Peninsular,2317,W,NS,7,15,22,2,Fall2018
2642,NE Halsey & 148th,2320,E,FS,4,18,22,4,Fall2018
2662,NE Halsey & 176th,2322,E,NS,1,7,8,3,Fall2018
2671,NE Halsey & 196th,2326,W,FS,18,3,21,1,Fall2018
2722,NE Halsey & Market Dr,2327,E,NS,4,23,27,20,Fall2018
333,23300 Block NE Halsey,2330,E,AT,9,17,26,7,Fall2018
334,23300 Block NE Halsey,2331,W,AT,17,10,27,7,Fall2018
337,23900 Block NE Halsey,2333,W,AT,3,2,5,0,Fall2018
303,2100 Block SW Halsey (Edgefield Manor),2339,E,AT,1,10,11,1,Fall2018
304,2100 Block SW Halsey (Edgefield Manor),2340,W,OP,7,2,9,1,Fall2018
2720,NE Halsey & Fairview/223rd,2341,E,FS,23,70,93,12,Fall2018
2721,NE Halsey & Fairview/223rd,2342,W,FS,35,6,41,5,Fall2018
2618,NE Halsey & 100th,2343,W,FS,32,65,97,26,Fall2018
6601,SW Halsey & Halsey Loop,2345,E,FS,1,15,16,0,Fall2018
6602,SW Halsey & Halsey Loop,2346,W,FS,15,1,16,0,Fall2018
2663,NE Halsey & 176th,2349,W,OP,8,1,9,1,Fall2018
90,12400 Block NE Halsey,2352,W,OP,28,48,76,25,Fall2018
2724,NE Halsey & Wasco,2353,E,NS,2,11,13,2,Fall2018
1772,NE 102nd & Halsey,2354,N,NS,2,2,4,2,Fall2018
23,10500 Block NE Halsey,2356,E,AT,32,23,55,16,Fall2018
2620,NE Halsey & 108th,2357,E,OP,14,17,31,39,Fall2018
2621,NE Halsey & 111th,2358,E,OP,22,47,69,39,Fall2018
2622,NE Halsey & 114th,2360,E,NS,10,19,29,5,Fall2018
2623,NE Halsey & 114th,2361,W,NS,16,6,22,3,Fall2018
2624,NE Halsey & 119th,2364,E,OP,3,15,18,6,Fall2018
2625,NE Halsey & 119th,2365,W,NS,10,4,14,3,Fall2018
2626,NE Halsey & 122nd,2366,E,FS,101,122,223,100,Fall2018
2627,NE Halsey & 122nd,2367,W,FS,93,51,144,58,Fall2018
2628,NE Halsey & 126th,2368,E,NS,3,12,15,2,Fall2018
2629,NE Halsey & 126th,2369,W,NS,7,3,10,1,Fall2018
2630,NE Halsey & 128th,2370,E,NS,1,8,9,5,Fall2018
2631,NE Halsey & 129th Pl,2373,W,NS,7,1,8,0,Fall2018
2632,NE Halsey & 131st Pl,2374,E,NS,6,33,39,6,Fall2018
2633,NE Halsey & 132nd,2375,W,NS,33,6,39,4,Fall2018
2634,NE Halsey & 136th Pl,2378,E,NS,1,10,11,2,Fall2018
2635,NE Halsey & 136th Pl,2379,W,OP,9,2,11,3,Fall2018
2636,NE Halsey & 140th,2380,E,OP,0,5,5,1,Fall2018
2637,NE Halsey & 141st,2381,W,FS,5,0,5,0,Fall2018
2638,NE Halsey & 143rd,2382,W,FS,6,1,7,0,Fall2018
2639,NE Halsey & 143rd,2383,E,OP,1,6,7,0,Fall2018
2640,NE Halsey & 146th,2384,W,FS,2,1,3,0,Fall2018
2641,NE Halsey & 146th,2385,E,OP,0,1,1,0,Fall2018
2643,NE Halsey & 148th,2386,W,NS,12,4,16,2,Fall2018
2650,NE Halsey & 155th,2389,E,NS,2,14,16,2,Fall2018
2651,NE Halsey & 155th,2390,W,NS,14,2,16,0,Fall2018
2652,NE Halsey & 157th,2391,E,NS,1,4,5,0,Fall2018
2653,NE Halsey & 157th,2392,W,NS,5,1,6,0,Fall2018
2655,NE Halsey & 160th,2393,E,FS,4,14,18,2,Fall2018
2656,NE Halsey & 162nd,2395,W,NS,70,21,91,6,Fall2018
2657,NE Halsey & 162nd,2396,E,NS,21,57,78,7,Fall2018
2658,NE Halsey & 168th Pl,2397,E,NS,4,20,24,1,Fall2018
2659,NE Halsey & 169th,2398,W,NS,22,3,25,0,Fall2018
2660,NE Halsey & 172nd,2399,W,OP,42,10,52,3,Fall2018
2661,NE Halsey & 172nd,2400,E,FS,11,40,51,3,Fall2018
2664,NE Halsey & 181st,2401,E,NS,44,73,117,24,Fall2018
2666,NE Halsey & 186th,2405,E,NS,12,16,28,14,Fall2018
2667,NE Halsey & 186th,2406,W,OP,11,7,18,10,Fall2018
2668,NE Halsey & 192nd,2407,W,FS,19,6,25,1,Fall2018
2669,NE Halsey & 192nd,2408,E,NS,5,21,26,2,Fall2018
2670,NE Halsey & 195th,2409,E,FS,3,14,17,2,Fall2018
2672,NE Halsey & 201st,2410,E,FS,14,34,48,3,Fall2018
2673,NE Halsey & 201st,2411,W,FS,36,18,54,6,Fall2018
2718,NE Halsey & Fairview Parkway,2414,W,NS,10,2,12,3,Fall2018
2719,NE Halsey & Fairview Parkway,2415,E,FS,2,8,10,2,Fall2018
2675,NE Halsey & 227th,2416,E,OP,15,51,66,13,Fall2018
2676,NE Halsey & 230th Ct,2418,E,NS,11,34,45,3,Fall2018
2677,NE Halsey & 230th Ct,2419,W,OP,45,12,57,8,Fall2018
2678,NE Halsey & 238th,2420,W,FS,68,54,122,24,Fall2018
2679,NE Halsey & 238th,2421,E,FS,20,36,56,10,Fall2018
2680,NE Halsey & 244th,2422,E,NS,3,22,25,13,Fall2018
2681,NE Halsey & 244th,2423,W,FS,19,3,22,9,Fall2018
2682,NE Halsey & 49th,2425,W,NS,3,4,7,0,Fall2018
2683,NE Halsey & 50th,2426,E,OP,6,8,14,1,Fall2018
2684,NE Halsey & 53rd,2428,W,NS,11,6,17,0,Fall2018
2685,NE Halsey & 53rd,2429,E,NS,4,17,21,1,Fall2018
2686,NE Halsey & 55th,2430,E,OP,3,11,14,1,Fall2018
2687,NE Halsey & 55th,2431,W,NS,8,2,10,0,Fall2018
2688,NE Halsey & 57th,2432,W,NS,27,24,51,8,Fall2018
2689,NE Halsey & 58th,2434,E,NS,29,35,64,20,Fall2018
2723,NE Halsey & Village St,2436,E,FS,5,18,23,5,Fall2018
2711,NE Halsey & 7th St,2437,W,FS,40,8,48,22,Fall2018
2690,NE Halsey & 60th,2438,W,FS,17,18,35,9,Fall2018
2691,NE Halsey & 60th,2439,E,FS,30,19,49,9,Fall2018
2692,NE Halsey & 63rd,2440,E,NS,15,13,28,12,Fall2018
2693,NE Halsey & 63rd,2441,W,NS,14,11,25,5,Fall2018
2694,NE Halsey & 66th,2442,E,OP,42,46,88,23,Fall2018
2695,NE Halsey & 66th,2443,W,NS,54,40,94,25,Fall2018
2696,NE Halsey & 69th,2445,W,OP,16,14,30,2,Fall2018
2703,NE Halsey & 69th,2446,E,AT,17,15,32,2,Fall2018
2704,NE Halsey & 72nd,2448,E,OP,6,8,14,2,Fall2018
2705,NE Halsey & 74th,2450,E,NS,10,19,29,1,Fall2018
2706,NE Halsey & 74th,2451,W,OP,17,9,26,1,Fall2018
2707,NE Halsey & 76th,2452,E,NS,2,6,8,2,Fall2018
2708,NE Halsey & 76th,2453,W,NS,6,2,8,0,Fall2018
2709,NE Halsey & 78th,2454,E,NS,1,3,4,1,Fall2018
2710,NE Halsey & 79th,2455,W,OP,3,2,5,0,Fall2018
2712,NE Halsey & 86th,2456,E,OP,6,7,13,0,Fall2018
2713,NE Halsey & 86th,2457,W,NS,3,3,6,0,Fall2018
2714,NE Halsey & 88th,2458,E,FS,3,3,6,5,Fall2018
2715,NE Halsey & 90th,2459,W,FS,3,2,5,3,Fall2018
2716,NE Halsey & 92nd,2460,E,NS,6,11,17,3,Fall2018
6625,SW Hamilton & 55th Pl,2461,W,FS,0,0,0,0,Fall2018
556,5700 Block SW Hamilton,2462,E,AT,1,0,1,0,Fall2018
6636,SW Hamilton & Semler Way,2463,W,NS,0,2,2,0,Fall2018
593,6200 Block SW Hamilton,2464,E,AT,4,0,4,0,Fall2018
6634,SW Hamilton & Scholls Ferry,2465,E,FS,0,0,0,0,Fall2018
6630,SW Hamilton & Dosch,2466,E,NS,0,0,0,0,Fall2018
6631,SW Hamilton & Dosch,2467,W,NS,20,11,31,0,Fall2018
6632,SW Hamilton & Hamilton Ct,2468,E,FS,1,0,1,0,Fall2018
6633,SW Hamilton & Hamilton Ct,2469,W,OP,0,1,1,0,Fall2018
6635,SW Hamilton & Scholls Ferry,2470,W,NS,0,0,0,0,Fall2018
6637,SW Hamilton & Shattuck,2471,W,NS,0,1,1,0,Fall2018
6638,SW Hamilton & Shattuck,2472,E,NS,5,0,5,0,Fall2018
6603,SW Hamilton & 34th,2473,W,FS,0,1,1,0,Fall2018
6604,SW Hamilton & 34th,2474,E,NS,0,0,0,0,Fall2018
6605,SW Hamilton & 36th Pl,2475,W,FS,0,0,0,0,Fall2018
6606,SW Hamilton & 36th Pl,2476,E,OP,0,0,0,0,Fall2018
6607,SW Hamilton & 39th Dr,2477,E,FS,0,0,0,0,Fall2018
6608,SW Hamilton & 39th Dr,2478,W,OP,0,0,0,0,Fall2018
6609,SW Hamilton & 41st,2479,W,NS,0,1,1,0,Fall2018
6610,SW Hamilton & 42nd Pl,2480,E,NS,1,0,1,0,Fall2018
6611,SW Hamilton & 45th,2481,W,OP,0,2,2,0,Fall2018
6612,SW Hamilton & 45th,2482,E,NS,1,0,1,0,Fall2018
6614,SW Hamilton & 47th Dr,2483,W,FS,0,2,2,4,Fall2018
6613,SW Hamilton & 47th,2484,E,FS,2,0,2,0,Fall2018
6616,SW Hamilton & 53rd,2486,E,FS,3,0,3,0,Fall2018
6617,SW Hamilton & 54th Pl,2487,W,FS,0,1,1,0,Fall2018
6627,SW Hamilton & 58th,2490,E,OP,0,0,0,0,Fall2018
6629,SW Hamilton & 60th Pl,2492,E,NS,1,0,1,0,Fall2018
611,6900 Block SW Hampton,2494,E,AT,11,47,58,3,Fall2018
6639,SW Hampton & 72nd,2496,E,FS,1,13,14,2,Fall2018
4643,SE Harmony & Linwood,2498,E,FS,13,3,16,0,Fall2018
92,12400 Block SE Harold,2505,E,AT,1,1,2,0,Fall2018
93,12400 Block SE Harold,2506,W,AT,1,0,1,0,Fall2018
112,12900 Block SE Harold,2507,W,AT,7,0,7,0,Fall2018
4670,SE Harold & 133rd,2510,W,OP,4,0,4,0,Fall2018
4694,SE Harold & 92nd,2512,E,FS,15,18,33,4,Fall2018
4644,SE Harold & 101st,2517,E,FS,1,16,17,0,Fall2018
4646,SE Harold & 103rd,2518,E,NS,1,7,8,1,Fall2018
4648,SE Harold & 105th,2520,E,OP,1,7,8,0,Fall2018
4649,SE Harold & 109th,2522,E,FS,1,3,4,0,Fall2018
4650,SE Harold & 109th,2523,W,NS,3,1,4,0,Fall2018
4651,SE Harold & 111th,2524,E,OP,1,3,4,0,Fall2018
4652,SE Harold & 111th,2525,W,NS,2,1,3,0,Fall2018
4653,SE Harold & 113th,2526,E,OP,0,2,2,0,Fall2018
4654,SE Harold & 113th,2527,W,NS,2,0,2,0,Fall2018
4655,SE Harold & 115th,2528,E,NS,1,6,7,0,Fall2018
4656,SE Harold & 115th,2529,W,NS,9,0,9,0,Fall2018
4657,SE Harold & 118th,2530,E,OP,0,5,5,0,Fall2018
4664,SE Harold & 118th,2531,W,NS,5,0,5,0,Fall2018
4665,SE Harold & 122nd,2534,E,NS,15,22,37,3,Fall2018
4666,SE Harold & 122nd,2535,W,FS,22,14,36,1,Fall2018
4667,SE Harold & 128th,2537,E,NS,1,8,9,4,Fall2018
4668,SE Harold & 128th,2538,W,NS,9,1,10,0,Fall2018
4672,SE Harold & 136th,2539,E,NS,4,19,23,0,Fall2018
4673,SE Harold & 136th,2540,W,FS,24,3,27,1,Fall2018
4674,SE Harold & 52nd,2541,W,NS,45,21,66,1,Fall2018
4675,SE Harold & 54th,2542,E,NS,9,13,22,2,Fall2018
4676,SE Harold & 57th,2544,E,NS,2,14,16,0,Fall2018
4677,SE Harold & 57th,2545,W,FS,17,2,19,0,Fall2018
4678,SE Harold & 60th,2546,E,NS,2,20,22,0,Fall2018
4679,SE Harold & 60th,2547,W,NS,27,2,29,0,Fall2018
4680,SE Harold & 62nd,2548,E,NS,3,14,17,0,Fall2018
4681,SE Harold & 62nd,2549,W,NS,17,2,19,0,Fall2018
4683,SE Harold & 65th,2550,E,NS,2,17,19,0,Fall2018
4684,SE Harold & 67th,2551,E,NS,4,20,24,0,Fall2018
4686,SE Harold & 69th,2552,E,NS,3,9,12,0,Fall2018
4687,SE Harold & 69th,2553,W,FS,12,2,14,0,Fall2018
4688,SE Harold & 72nd,2554,W,NS,39,13,52,6,Fall2018
4689,SE Harold & 72nd,2555,E,FS,16,37,53,6,Fall2018
4690,SE Harold & 74th,2557,E,NS,2,8,10,0,Fall2018
4691,SE Harold & 74th,2558,W,NS,10,2,12,0,Fall2018
4692,SE Harold & 77th,2560,W,NS,13,1,14,0,Fall2018
4693,SE Harold & 79th,2561,E,OP,3,16,19,2,Fall2018
4098,SE 79th & Harold,2562,S,NS,13,4,17,1,Fall2018
4695,SE Harold & 92nd,2563,W,NS,15,23,38,1,Fall2018
4696,SE Harold & 97th,2564,E,NS,4,14,18,0,Fall2018
4697,SE Harold & 97th,2565,W,NS,17,4,21,0,Fall2018
289,200 Block SW Harrison,2566,E,AT,171,32,203,11,Fall2018
290,200 Block SW Harrison,2567,W,OP,31,303,334,20,Fall2018
4710,SE Harrison & Hwy 224,2568,E,NS,31,19,50,10,Fall2018
4699,SE Harrison & 24th ,2569,E,OP,33,10,43,12,Fall2018
4700,SE Harrison & 24th ,2570,W,NS,4,22,26,11,Fall2018
361,2700 Block SE Harrison,2571,W,OP,11,27,38,0,Fall2018
4701,SE Harrison & 28th ,2572,E,NS,26,7,33,0,Fall2018
4702,SE Harrison & 29th ,2573,W,NS,9,23,32,13,Fall2018
4703,SE Harrison & 31st ,2574,W,NS,52,83,135,32,Fall2018
4704,SE Harrison & 32nd ,2575,E,FS,59,42,101,24,Fall2018
4705,SE Harrison & 34th ,2577,W,NS,8,14,22,2,Fall2018
4706,SE Harrison & 37th ,2578,E,NS,7,9,16,1,Fall2018
4707,SE Harrison & 37th ,2579,W,NS,5,6,11,3,Fall2018
6644,SW Harrison & 4th,2580,E,NS,327,74,401,30,Fall2018
4708,SE Harrison & 40th ,2582,E,NS,2,9,11,2,Fall2018
4709,SE Harrison & 40th ,2583,W,NS,10,3,13,0,Fall2018
3678,Rose Quarter Transit Center,2592,W,AT,670,1135,1805,257,Fall2018
4743,SE Hawthorne & 6th,2594,E,NS,301,210,511,38,Fall2018
4747,SE Hawthorne & Maple ,2595,E,FS,26,26,52,1,Fall2018
4748,SE Hawthorne & Poplar ,2596,E,NS,13,33,46,3,Fall2018
4744,SE Hawthorne & 9th,2597,E,NS,33,33,66,9,Fall2018
4717,SE Hawthorne & 12th,2599,E,NS,183,183,366,23,Fall2018
4718,SE Hawthorne & 14th,2602,W,FS,22,29,51,3,Fall2018
4719,SE Hawthorne & 16th,2603,E,FS,38,56,94,41,Fall2018
4720,SE Hawthorne & 16th,2604,W,NS,70,40,110,48,Fall2018
4721,SE Hawthorne & 19th,2606,W,FS,65,26,91,8,Fall2018
4722,SE Hawthorne & 20th,2607,E,FS,29,46,75,10,Fall2018
4724,SE Hawthorne & 23rd,2608,E,NS,29,39,68,3,Fall2018
4723,SE Hawthorne & 22nd,2609,W,NS,73,42,115,14,Fall2018
4725,SE Hawthorne & 25th,2611,W,FS,45,18,63,9,Fall2018
4726,SE Hawthorne & 25th,2612,E,FS,15,34,49,5,Fall2018
4727,SE Hawthorne & 27th,2613,W,NS,87,61,148,11,Fall2018
4728,SE Hawthorne & 28th,2614,E,OP,56,131,187,19,Fall2018
4729,SE Hawthorne & 30th,2615,E,NS,23,58,81,2,Fall2018
4730,SE Hawthorne & 30th,2616,W,NS,72,27,99,2,Fall2018
4732,SE Hawthorne & 32nd Pl,2617,E,FS,12,47,59,2,Fall2018
4731,SE Hawthorne & 32nd,2619,W,NS,44,16,60,2,Fall2018
4733,SE Hawthorne & 34th,2620,E,FS,31,67,98,9,Fall2018
4735,SE Hawthorne & 37th,2623,E,FS,43,114,157,32,Fall2018
4736,SE Hawthorne & 37th,2624,W,NS,97,41,138,19,Fall2018
4745,SE Hawthorne & Cesar Chavez Blvd,2625,E,NS,152,213,365,81,Fall2018
4746,SE Hawthorne & Cesar Chavez Blvd,2626,W,FS,211,142,353,107,Fall2018
4737,SE Hawthorne & 41st,2628,E,NS,45,71,116,10,Fall2018
4738,SE Hawthorne & 41st,2629,W,NS,55,33,88,6,Fall2018
4739,SE Hawthorne & 44th,2630,E,NS,18,51,69,3,Fall2018
4740,SE Hawthorne & 44th,2632,W,FS,62,22,84,2,Fall2018
4741,SE Hawthorne & 47th,2633,E,FS,34,73,107,10,Fall2018
4742,SE Hawthorne & 47th,2635,W,OP,65,28,93,5,Fall2018
1080,Hawthorne Bridge,2641,E,AT,78,100,178,7,Fall2018
1081,Hawthorne Bridge,2642,W,AT,75,87,162,8,Fall2018
1082,Hawthorne Bridge Ramp & SE M L King,2643,E,FS,33,218,251,25,Fall2018
1415,N Hayden Meadows Dr & Whitaker,2648,E,FS,21,19,40,19,Fall2018
6661,SW Heiney & Binford Lake,2650,S,NS,7,2,9,0,Fall2018
3690,S High & 1st,2662,N,NS,1,2,3,0,Fall2018
3691,S High & 1st,2663,S,FS,3,1,4,0,Fall2018
1083,High & 3rd,2664,N,NS,2,5,7,0,Fall2018
1084,High & 3rd,2665,S,NS,3,2,5,1,Fall2018
1085,High & 5th,2666,N,NS,3,6,9,1,Fall2018
6666,SW Highland & Linneman,2667,E,FS,0,0,0,0,Fall2018
6667,SW Highland & Linneman,2668,W,OP,0,0,0,0,Fall2018
6662,SW Highland & 11th St,2669,N,FS,18,5,23,5,Fall2018
6663,SW Highland & 11th St,2670,S,FS,3,0,3,1,Fall2018
6664,SW Highland & 14th Dr,2671,E,NS,1,1,2,1,Fall2018
1088,Hillsboro Transit Center,2672,E,AT,137,63,200,25,Fall2018
1093,Holcomb & Apperson,2674,E,OP,0,4,4,0,Fall2018
1094,Holcomb & Apperson,2675,W,NS,7,0,7,0,Fall2018
3694,S Holcomb & Hunter Ave,2679,W,NS,2,0,2,0,Fall2018
3696,S Holcomb & Swan Ave,2681,E,NS,0,1,1,0,Fall2018
3697,S Holcomb & Swan Ave,2682,W,NS,3,0,3,0,Fall2018
4759,SE Holgate & 117th ,2683,W,NS,17,1,18,0,Fall2018
4763,SE Holgate & 125th ,2684,E,FS,0,1,1,0,Fall2018
4772,SE Holgate & 134th Dr,2685,E,NS,105,123,228,49,Fall2018
4749,SE Holgate & 100th ,2686,E,FS,3,19,22,1,Fall2018
4750,SE Holgate & 101st ,2687,W,FS,20,3,23,0,Fall2018
4751,SE Holgate & 103rd ,2690,W,NS,75,11,86,16,Fall2018
4752,SE Holgate & 104th ,2691,E,NS,9,68,77,31,Fall2018
4753,SE Holgate & 107th ,2692,E,OP,1,8,9,1,Fall2018
4754,SE Holgate & 108th Pl ,2695,W,OP,11,2,13,0,Fall2018
4755,SE Holgate & 112th ,2696,E,NS,7,47,54,18,Fall2018
4756,SE Holgate & 112th ,2697,W,NS,51,12,63,15,Fall2018
4757,SE Holgate & 115th ,2699,E,FS,1,28,29,2,Fall2018
4758,SE Holgate & 115th ,2700,W,NS,22,2,24,0,Fall2018
4760,SE Holgate & 118th ,2701,E,NS,0,24,24,7,Fall2018
4761,SE Holgate & 122nd ,2703,E,FS,20,150,170,66,Fall2018
4762,SE Holgate & 122nd ,2705,W,FS,98,10,108,46,Fall2018
4770,SE Holgate & 128th,2706,E,NS,1,16,17,8,Fall2018
4771,SE Holgate & 130th,2707,E,FS,1,12,13,40,Fall2018
4773,SE Holgate & 136th,2708,E,NS,21,1,22,2,Fall2018
4774,SE Holgate & 26th,2712,E,NS,15,26,41,4,Fall2018
4775,SE Holgate & 26th,2713,W,NS,22,14,36,2,Fall2018
4776,SE Holgate & 28th,2714,E,FS,45,84,129,3,Fall2018
4777,SE Holgate & 28th,2715,W,NS,95,50,145,3,Fall2018
4778,SE Holgate & 32nd,2718,E,OP,47,47,94,76,Fall2018
4779,SE Holgate & 32nd,2719,W,NS,42,44,86,93,Fall2018
4780,SE Holgate & 34th,2720,E,NS,7,32,39,0,Fall2018
4781,SE Holgate & 34th,2721,W,OP,35,9,44,0,Fall2018
4782,SE Holgate & 36th,2722,E,NS,6,30,36,1,Fall2018
4783,SE Holgate & 36th,2723,W,NS,47,7,54,1,Fall2018
4827, SE Holgate & Cesar Chavez Blvd,2726,E,OP,62,146,208,66,Fall2018
4828, SE Holgate & Cesar Chavez Blvd,2727,W,NS,127,64,191,65,Fall2018
4784,SE Holgate & 41st,2728,E,NS,7,40,47,5,Fall2018
4785,SE Holgate & 41st,2729,W,OP,46,8,54,14,Fall2018
4786,SE Holgate & 45th,2732,E,NS,3,28,31,6,Fall2018
4787,SE Holgate & 45th,2733,W,NS,20,3,23,0,Fall2018
4788,SE Holgate & 47th,2734,E,NS,3,13,16,0,Fall2018
4789,SE Holgate & 47th,2735,W,NS,14,4,18,0,Fall2018
4790,SE Holgate & 49th,2736,E,NS,3,18,21,0,Fall2018
4791,SE Holgate & 49th,2737,W,NS,21,2,23,1,Fall2018
4792,SE Holgate & 52nd,2738,E,FS,41,64,105,17,Fall2018
4793,SE Holgate & 52nd,2739,W,FS,67,35,102,15,Fall2018
4794,SE Holgate & 56th,2740,E,NS,2,7,9,0,Fall2018
4795,SE Holgate & 56th,2741,W,NS,10,2,12,0,Fall2018
4796,SE Holgate & 58th,2742,E,NS,6,24,30,0,Fall2018
4797,SE Holgate & 58th,2743,W,NS,29,6,35,2,Fall2018
4798,SE Holgate & 62nd,2746,E,NS,36,64,100,10,Fall2018
4799,SE Holgate & 62nd,2747,W,OP,53,23,76,8,Fall2018
4800,SE Holgate & 64th,2748,W,NS,34,39,73,17,Fall2018
4801,SE Holgate & 65th,2749,E,NS,22,27,49,10,Fall2018
4802,SE Holgate & 67th,2750,E,FS,10,20,30,3,Fall2018
4803,SE Holgate & 67th,2751,W,NS,25,15,40,7,Fall2018
4804,SE Holgate & 70th,2752,E,NS,6,14,20,2,Fall2018
4805,SE Holgate & 70th,2753,W,NS,14,5,19,2,Fall2018
4806,SE Holgate & 72nd,2754,E,NS,5,19,24,3,Fall2018
4807,SE Holgate & 72nd,2755,W,NS,25,7,32,3,Fall2018
4808,SE Holgate & 74th,2756,W,NS,15,4,19,1,Fall2018
4809,SE Holgate & 75th,2757,E,NS,3,18,21,2,Fall2018
4810,SE Holgate & 77th,2758,E,FS,2,11,13,0,Fall2018
4811,SE Holgate & 77th,2759,W,OP,14,2,16,1,Fall2018
4812,SE Holgate & 79th,2760,E,NS,11,47,58,34,Fall2018
4813,SE Holgate & 79th,2761,W,NS,38,13,51,11,Fall2018
4815,SE Holgate & 83rd,2762,E,NS,167,222,389,184,Fall2018
4814,SE Holgate & 82nd,2763,W,FS,159,105,264,88,Fall2018
4823,SE Holgate & 88th ,2767,E,FS,7,35,42,3,Fall2018
4824,SE Holgate & 88th ,2768,W,NS,35,9,44,2,Fall2018
2731,NE Hood & 9th,2798,S,OP,0,13,13,2,Fall2018
6679,SW Huber & Capitol Hwy,2804,E,FS,4,2,6,0,Fall2018
6671,SW Huber & 35th,2806,E,NS,3,1,4,0,Fall2018
6678,SW Huber & 40th,2809,W,FS,1,1,2,0,Fall2018
642,7500 Block SW Hunziker,2810,W,AT,3,2,5,0,Fall2018
664,8000 Block SW Hunziker,2811,W,AT,4,0,4,0,Fall2018
665,8000 Block SW Hunziker,2812,E,OP,0,3,3,0,Fall2018
6683,SW Hunziker & Hall,2815,E,FS,2,2,4,0,Fall2018
6684,SW Hunziker & Knoll,2816,W,NS,2,1,3,0,Fall2018
6681,SW Hunziker & 72nd,2817,W,FS,32,6,38,0,Fall2018
6682,SW Hunziker & 72nd,2818,E,NS,6,45,51,15,Fall2018
406,29800 Block SE Hwy 211,2819,W,AT,0,0,0,0,Fall2018
4837,SE Hwy 211 & Hwy 224,2824,E,FS,0,1,1,0,Fall2018
1234,Molalla & Char Diaz Dr,2827,S,FS,1,5,6,0,Fall2018
1245,Molalla & Lazy Creek Ln,2828,N,OP,22,2,24,3,Fall2018
1251,Molalla & Sebastian Way,2830,E,NS,1,21,22,3,Fall2018
1236,Molalla & Clairmont,2837,N,FS,87,8,95,16,Fall2018
1237,Molalla & Clairmont,2838,S,FS,5,94,99,21,Fall2018
1238,Molalla & Gaffney Ln,2841,N,NS,51,8,59,71,Fall2018
1239,Molalla & Gaffney Ln,2842,S,FS,9,48,57,25,Fall2018
1253,Molalla & Warner-Milne,2866,S,FS,1,18,19,8,Fall2018
33,10800 Block SE Highway 212,2868,E,AT,1,14,15,0,Fall2018
4865,SE Hwy 224 & Eckert Ln224 & Eckert Ln,2870,S,NS,0,2,2,0,Fall2018
181,15700 Block SE Hwy 224,2872,S,AT,0,8,8,2,Fall2018
182,15700 Block SE Hwy 224,2873,N,OP,8,0,8,0,Fall2018
4888,SE Hwy 224 & Springwater Rd,2874,W,OP,4,1,5,0,Fall2018
195,16200 Block SE Hwy 224,2875,E,AT,1,5,6,0,Fall2018
4856,SE Hwy 224 & Amisigger Rd224 & Amisigger Rd,2876,W,NS,0,0,0,0,Fall2018
4857,SE Hwy 224 & Amisigger Rd224 & Amisigger Rd,2877,E,OP,0,1,1,0,Fall2018
4860,SE Hwy 224 & Bartlemay224 & Bartlemay,2878,W,FS,0,0,0,0,Fall2018
4861,SE Hwy 224 & Barton Church224 & Barton Church,2879,E,AT,1,0,1,0,Fall2018
4862,SE Hwy 224 & Barton Church224 & Barton Church,2880,W,OP,0,2,2,0,Fall2018
4858,SE Hwy 224 & Bakers Ferry Rd224 & Bakers Ferry Rd,2881,E,FS,2,5,7,0,Fall2018
4859,SE Hwy 224 & Bakers Ferry Rd224 & Bakers Ferry Rd,2882,W,OP,5,1,6,0,Fall2018
199,16400 Block SE Hwy 224,2883,E,OP,0,0,0,0,Fall2018
200,16400 Block SE Hwy 224,2884,W,AT,0,0,0,0,Fall2018
190,16000 Block SE Hwy 224,2885,S,FS,0,1,1,0,Fall2018
191,16000 Block SE Hwy 224,2886,N,NS,1,0,1,0,Fall2018
4844,SE Hwy 212 & Evelyn,2888,E,NS,2,20,22,1,Fall2018
4838,SE Hwy 212 &102nd,2889,W,FS,9,1,10,0,Fall2018
4841,SE Hwy 212 &130th,2890,W,NS,15,1,16,0,Fall2018
1102,Hwy 212 & Fred Meyer Dc Entr,2891,E,FS,2,15,17,0,Fall2018
60,11400 Block SE Hwy 212,2892,W,AT,11,2,13,0,Fall2018
4879,SE Hwy 224 & Hwy 212,2895,S,FS,0,1,1,0,Fall2018
4880,SE Hwy 224 & Hwy 212,2896,N,NS,0,0,0,0,Fall2018
4881,SE Hwy 224 & Marna,2898,W,FS,0,0,0,0,Fall2018
31,10700 Block SE Hwy 212,2899,W,AT,14,1,15,1,Fall2018
4885,SE Hwy 224 & Odell,2900,E,NS,0,0,0,0,Fall2018
4839,SE Hwy 212 &122nd,2904,E,FS,2,25,27,0,Fall2018
4840,SE Hwy 212 &122nd,2905,W,FS,15,2,17,0,Fall2018
4842,SE Hwy 212 &130th,2906,E,NS,1,17,18,0,Fall2018
4845,SE Hwy 224 &135th,2907,E,FS,3,15,18,0,Fall2018
4847,SE Hwy 224 &142nd,2908,E,NS,1,9,10,0,Fall2018
4848,SE Hwy 224 &142nd,2909,W,NS,9,1,10,0,Fall2018
4849,SE Hwy 224 &152nd,2910,E,OP,0,1,1,0,Fall2018
4850,SE Hwy 224 &152nd,2911,W,NS,2,0,2,0,Fall2018
4851,SE Hwy 224 &197th,2912,E,FS,0,0,0,0,Fall2018
4852,SE Hwy 224 &197th,2913,W,OP,0,0,0,0,Fall2018
4855,SE Hwy 224 &82nd Dr,2914,E,NS,37,18,55,1,Fall2018
4843,SE Hwy 212 &82nd Dr,2915,W,NS,8,31,39,1,Fall2018
1416,N Interstate & Albina,2945,S,NS,11,20,31,3,Fall2018
1418,N Interstate & Graham,2962,N,FS,2,3,5,0,Fall2018
1419,N Interstate & Graham,2964,S,OP,2,1,3,1,Fall2018
1432,N Ivanhoe & Baltimore,3008,N,NS,40,7,47,5,Fall2018
1434,N Ivanhoe & Charleston,3009,E,NS,3,48,51,7,Fall2018
1116,Jackson & 12th,3020,S,NS,1,5,6,0,Fall2018
1117,Jackson & 12th,3021,N,NS,2,5,7,1,Fall2018
1118,Jackson & 15th,3024,S,NS,1,1,2,0,Fall2018
1119,Jackson & 15th,3025,N,NS,1,1,2,0,Fall2018
1122,Jean Rd & Bryant,3030,E,NS,1,0,1,0,Fall2018
1123,Jean Rd & Bryant,3031,W,FS,0,2,2,0,Fall2018
1128,Jean Rd & Schalit,3032,E,FS,1,0,1,0,Fall2018
6685,SW Jean Rd & Tualata,3033,W,OP,0,1,1,0,Fall2018
1129,Jean Rd & Schalit,3036,W,FS,0,1,1,0,Fall2018
6686,SW Jean Rd & Tualata,3038,E,FS,1,0,1,0,Fall2018
6693,SW Jefferson & Broadway,3039,W,NS,18,482,500,57,Fall2018
1130,Jefferson & Independence,3040,S,OP,1,9,10,0,Fall2018
1131,Jefferson & Independence,3041,N,NS,4,0,4,0,Fall2018
285,2 Jefferson Parkway,3043,E,FS,5,0,5,0,Fall2018
6694,SW Jefferson & McNary,3045,S,FS,1,9,10,0,Fall2018
6695,SW Jefferson Pkwy & McNary Pkwy,3046,N,NS,9,0,9,0,Fall2018
1132,Jefferson & Mt Jefferson,3048,N,FS,3,0,3,0,Fall2018
6687,SW Jefferson & 10th,3049,W,NS,203,350,553,123,Fall2018
6688,SW Jefferson & 13th,3051,W,NS,35,93,128,59,Fall2018
6689,SW Jefferson & 16th,3052,W,NS,46,91,137,3,Fall2018
6691,SW Jefferson & 20th,3054,W,NS,37,21,58,8,Fall2018
1133,Jenkins & Bardeen,3056,E,NS,3,4,7,0,Fall2018
6698,SW Jenkins & Ecole,3062,W,NS,9,11,20,0,Fall2018
6697,SW Jenkins & Briggs,3063,W,FS,4,7,11,0,Fall2018
6701,SW Jenkins & Karl Braun,3064,E,FS,9,3,12,26,Fall2018
6700,SW Jenkins & Hocken,3067,E,NS,14,11,25,2,Fall2018
6699,SW Jenkins & Ecole,3069,E,OP,11,4,15,0,Fall2018
1662,N Vancouver & Jessup,3070,N,NS,6,9,15,2,Fall2018
4911,SE Johnson Creek & 42nd,3076,W,FS,8,12,20,0,Fall2018
4914,SE Johnson Creek & Brookside,3077,N,FS,21,9,30,3,Fall2018
4915,SE Johnson Creek & Brookside,3078,S,OP,8,13,21,1,Fall2018
4916,SE Johnson Creek & Springwater Corridor,3079,N,NS,16,8,24,2,Fall2018
4917,SE Johnson Creek & Springwater Corridor,3080,S,FS,11,26,37,1,Fall2018
4907,SE Johnson Creek & 32nd,3081,W,NS,1,1,2,0,Fall2018
4909,SE Johnson Creek & 36th,3082,W,OP,4,2,6,13,Fall2018
4910,SE Johnson Creek & 36th,3083,E,NS,4,5,9,10,Fall2018
4912,SE Johnson Creek & 42nd,3086,E,FS,15,8,23,0,Fall2018
2735,NE Kane & 18th Ct,3091,N,OP,10,8,18,2,Fall2018
2744,NE Kane & Division,3092,N,FS,55,52,107,79,Fall2018
2745,NE Kane & Division,3093,S,NS,65,57,122,81,Fall2018
2747,NE Kane & SE Stark,3094,N,NS,5,5,10,3,Fall2018
2733,NE Kane & 15th,3097,N,FS,30,30,60,21,Fall2018
2736,NE Kane & 18th Ct,3099,S,NS,21,20,41,25,Fall2018
4921,SE Kane & 2nd,3100,N,OP,0,4,4,0,Fall2018
4922,SE Kane & 2nd,3101,S,FS,5,1,6,0,Fall2018
2741,NE Kane & 2nd Ct,3102,N,OP,3,3,6,2,Fall2018
2737,NE Kane & 23rd,3104,S,FS,25,25,50,21,Fall2018
2738,NE Kane & 23rd,3105,N,FS,32,33,65,25,Fall2018
2742,NE Kane & 8th,3106,S,FS,2,0,2,0,Fall2018
2743,NE Kane & 8th,3107,N,NS,0,2,2,1,Fall2018
6704,SW Kelly & Corbett,3116,N,NS,19,31,50,5,Fall2018
531,50 Block Kerr Parkway,3125,S,AT,1,6,7,0,Fall2018
532,50 Block Kerr Parkway,3126,N,OP,7,3,10,0,Fall2018
1137,Kerr & Boones Ferry Rd,3127,S,NS,2,9,11,1,Fall2018
1139,Kerr & Independence,3129,N,FS,0,0,0,0,Fall2018
1141,Kerr & Jefferson Pkwy,3132,N,FS,9,5,14,0,Fall2018
1142,Kerr & McNary,3133,N,FS,4,2,6,0,Fall2018
1143,Kerr & Tanglewood,3134,E,FS,2,5,7,0,Fall2018
1144,Kerr & Tanglewood,3135,W,FS,4,3,7,0,Fall2018
1145,Kerr & The Grotto,3137,S,FS,5,5,10,0,Fall2018
1146,Kerr & The Grotto,3138,N,OP,7,5,12,1,Fall2018
1147,Kerr & Touchstone,3141,E,NS,8,17,25,4,Fall2018
504,4500 Block NE Killingsworth,3144,E,AT,18,22,40,0,Fall2018
555,5700 Block NE Killingsworth,3145,E,AT,8,9,17,0,Fall2018
2772,NE Killingsworth & 60th,3146,E,NS,89,58,147,17,Fall2018
596,6300 Block NE Killingsworth,3147,W,AT,33,36,69,1,Fall2018
2774,NE Killingsworth & 64th,3148,E,FS,46,33,79,1,Fall2018
648,7700 Block NE Killingsworth,3149,W,AT,1,2,3,0,Fall2018
1438,N Killingsworth & Albina,3153,E,NS,252,47,299,35,Fall2018
1439,N Killingsworth & Albina,3154,W,NS,54,243,297,36,Fall2018
1440,N Killingsworth & Commercial,3156,E,NS,111,20,131,10,Fall2018
1441,N Killingsworth & Commercial,3157,W,FS,27,219,246,27,Fall2018
1442,N Killingsworth & Concord,3158,E,NS,14,1,15,1,Fall2018
1443,N Killingsworth & Concord,3159,W,NS,3,13,16,1,Fall2018
1444,N Killingsworth & Delaware,3160,E,NS,18,2,20,2,Fall2018
1445,N Killingsworth & Delaware,3161,W,NS,1,23,24,3,Fall2018
1446,N Killingsworth & Denver,3162,E,NS,21,4,25,4,Fall2018
1447,N Killingsworth & Denver,3163,W,NS,2,20,22,1,Fall2018
2783,NE Killingsworth & Garfield ,3165,E,NS,14,39,53,14,Fall2018
1408,N Greeley & Willamette,3167,S,NS,3,36,39,2,Fall2018
1450,N Killingsworth & Interstate,3169,E,FS,248,55,303,39,Fall2018
1451,N Killingsworth & Interstate,3170,W,NS,46,214,260,51,Fall2018
1452,N Killingsworth & Kerby,3171,E,NS,139,37,176,12,Fall2018
1453,N Killingsworth & Michigan,3173,E,NS,33,8,41,0,Fall2018
1454,N Killingsworth & Michigan,3174,W,NS,8,30,38,1,Fall2018
1448,N Killingsworth & Gay Ave,3179,E,NS,14,2,16,1,Fall2018
1455,N Killingsworth & Omaha,3180,W,NS,2,19,21,2,Fall2018
1456,N Killingsworth & Vancouver,3183,E,NS,97,38,135,23,Fall2018
1457,N Killingsworth & Vancouver,3184,W,NS,64,145,209,45,Fall2018
666,8100 Block NE Killingsworth,3185,E,AT,54,17,71,4,Fall2018
644,7600 Block NE Killingsworth,3186,E,AT,4,1,5,0,Fall2018
2749,NE Killingsworth & 31st,3189,W,NS,12,28,40,1,Fall2018
2756,NE Killingsworth & 33rd,3191,E,FS,113,87,200,25,Fall2018
2757,NE Killingsworth & 33rd,3192,W,FS,73,88,161,21,Fall2018
2758,NE Killingsworth & 35th,3193,E,NS,5,4,9,1,Fall2018
2759,NE Killingsworth & 35th,3194,W,NS,6,16,22,6,Fall2018
2760,NE Killingsworth & 36th,3195,E,NS,13,12,25,19,Fall2018
2761,NE Killingsworth & 36th,3196,W,NS,12,13,25,26,Fall2018
2779,NE Killingsworth & Cesar Chavez Blvd,3197,W,NS,7,6,13,1,Fall2018
2780,NE Killingsworth & Cesar Chavez Blvd,3198,E,NS,7,6,13,2,Fall2018
2762,NE Killingsworth & 42nd,3199,E,FS,155,119,274,27,Fall2018
2763,NE Killingsworth & 42nd,3200,W,NS,124,163,287,24,Fall2018
2764,NE Killingsworth & 46th Pl,3201,W,OP,21,14,35,0,Fall2018
2765,NE Killingsworth & 49th,3202,E,FS,32,30,62,5,Fall2018
2766,NE Killingsworth & 49th,3203,W,OP,17,20,37,1,Fall2018
2767,NE Killingsworth & 52nd,3204,E,FS,44,41,85,14,Fall2018
2768,NE Killingsworth & 52nd,3205,W,OP,58,57,115,19,Fall2018
2769,NE Killingsworth & 54th,3207,W,OP,26,31,57,10,Fall2018
2770,NE Killingsworth & 55th,3208,E,NS,35,29,64,2,Fall2018
2771,NE Killingsworth & 57th,3209,W,OP,13,11,24,0,Fall2018
2773,NE Killingsworth & 60th,3210,W,NS,59,87,146,3,Fall2018
2775,NE Killingsworth & 72nd,3211,E,FS,90,43,133,64,Fall2018
2776,NE Killingsworth & 72nd,3212,W,NS,41,84,125,47,Fall2018
2777,NE Killingsworth & 75th,3215,W,NS,1,7,8,1,Fall2018
2778,NE Killingsworth & 82nd,3216,W,FS,17,50,67,3,Fall2018
1460,N Kilpatrick & Brandon,3218,W,NS,5,8,13,6,Fall2018
1461,N Kilpatrick & Brandon,3219,E,NS,7,11,18,3,Fall2018
1462,N Kilpatrick & Denver,3221,W,FS,69,43,112,30,Fall2018
1463,N Kilpatrick & Denver,3222,E,NS,49,67,116,32,Fall2018
622,7100 Block SE King,3224,E,AT,7,8,15,0,Fall2018
655,7900 Block SE King,3226,E,AT,5,21,26,4,Fall2018
4944,SE King & Fuller,3228,W,OP,191,27,218,32,Fall2018
4941,SE King & Bell,3229,W,NS,113,24,137,7,Fall2018
4942,SE King & Bell,3230,E,OP,9,59,68,4,Fall2018
4945,SE King & Hollywood,3231,E,OP,10,7,17,1,Fall2018
4946,SE King & Hollywood,3232,W,FS,7,10,17,0,Fall2018
4947,SE King & Home,3233,E,FS,8,10,18,0,Fall2018
4949,SE King & Linwood,3234,E,FS,40,41,81,16,Fall2018
4950,SE King & Linwood,3235,W,NS,45,36,81,13,Fall2018
6706,SW King & Salmon,3236,N,NS,4,1,5,0,Fall2018
4951,SE King & Stanley,3237,W,NS,17,12,29,1,Fall2018
4952,SE King & Stanley,3238,E,NS,12,19,31,0,Fall2018
4933,SE King & 47th,3242,E,NS,6,6,12,2,Fall2018
4934,SE King & 47th,3243,W,OP,6,3,9,1,Fall2018
4935,SE King & 52nd,3245,E,NS,2,3,5,0,Fall2018
4936,SE King & 52nd,3246,W,OP,4,3,7,1,Fall2018
4937,SE King & 66th,3249,W,NS,13,8,21,1,Fall2018
4938,SE King & 66th,3250,E,NS,8,12,20,0,Fall2018
4939,SE King & 74th,3251,E,NS,13,16,29,1,Fall2018
4940,SE King & 77th,3254,W,OP,12,3,15,5,Fall2018
6707,SW Kingston & Japanese Garden,3276,N,OP,11,11,22,2,Fall2018
6709,SW Knight & Kingston,3277,S,FS,0,0,0,0,Fall2018
6708,SW Kingston & Tichner,3279,N,NS,0,0,0,1,Fall2018
6710,SW Knights & Kingston,3291,N,NS,1,0,1,0,Fall2018
1151,Kruse Way & Carman,3293,E,NS,11,3,14,0,Fall2018
1152,Kruse Way & Carman,3294,W,NS,2,11,13,3,Fall2018
1154,Kruse Way & Kruse Oaks,3295,E,FS,6,5,11,2,Fall2018
1155,Kruse Way & Kruse Oaks,3296,W,FS,5,12,17,41,Fall2018
1153,Kruse Way & Daniel Way,3297,W,NS,2,4,6,0,Fall2018
1156,Kruse Way & Kruse Woods,3298,E,FS,12,7,19,19,Fall2018
1157,Kruse Way & Mercantile,3299,E,FS,4,2,6,0,Fall2018
1158,Kruse Way & Westlake Dr,3300,W,FS,5,10,15,14,Fall2018
4955,SE Ladd & Division,3301,N,FS,11,3,14,1,Fall2018
4956,SE Ladd & Division,3302,S,NS,13,17,30,4,Fall2018
4957,SE Ladd & Hawthorne,3303,N,NS,12,42,54,1,Fall2018
4958,SE Ladd & Ladd Circle,3304,S,NS,10,5,15,0,Fall2018
4959,SE Ladd & Ladd Circle,3305,N,NS,14,8,22,0,Fall2018
4960,SE Ladd & Lavender,3307,N,NS,4,1,5,0,Fall2018
4961,SE Ladd & Lavender,3308,S,NS,3,3,6,0,Fall2018
4963,SE Ladd & Palm St,3309,S,NS,6,8,14,0,Fall2018
4962,SE Ladd & Palm,3310,N,NS,9,6,15,0,Fall2018
4953,SE Ladd & 16th,3311,E,NS,12,5,17,0,Fall2018
4954,SE Ladd & 16th,3312,W,NS,4,13,17,0,Fall2018
1464,N Lagoon & Anchor,3315,N,NS,20,61,81,1,Fall2018
1465,N Lagoon & Ballast,3316,N,OP,0,2,2,0,Fall2018
1466,N Lagoon & Commerce,3317,N,NS,0,1,1,0,Fall2018
1351,N Dolphin & Channel,3318,S,NS,1,8,9,0,Fall2018
548,5500 Block N Lagoon (at Gate 18),3319,N,OP,0,1,1,0,Fall2018
4970,SE Lake & 33rd Pl,3321,W,OP,2,3,5,0,Fall2018
597,6300 Block SE Lake,3322,S,AT,1,0,1,0,Fall2018
591,6200 Block SE Lake,3323,N,AT,1,1,2,0,Fall2018
598,6400 Block SE Lake,3324,S,AT,1,1,2,0,Fall2018
4982,SE Lake & Boss,3325,E,FS,0,0,0,0,Fall2018
4983,SE Lake & Boss,3326,W,OP,0,0,0,0,Fall2018
4985,SE Lake & Harmony,3328,E,NS,1,0,1,0,Fall2018
4986,SE Lake & Harmony,3329,N,NS,0,1,1,0,Fall2018
4989,SE Lake & Lena/51st,3332,W,NS,1,0,1,0,Fall2018
4990,SE Lake & Mintone,3334,W,FS,0,0,0,0,Fall2018
4991,SE Lake & Oatfield,3335,E,FS,1,0,1,0,Fall2018
4992,SE Lake & Oatfield,3336,E,NS,3,2,5,0,Fall2018
605,6600 Block SE Lake,3337,N,AT,1,1,2,2,Fall2018
600,6500 Block SE Lake,3338,S,AT,1,1,2,1,Fall2018
4993,SE Lake & Rusk,3339,E,NS,2,1,3,0,Fall2018
4994,SE Lake & Rusk,3340,W,OP,2,1,3,0,Fall2018
4996,SE Lake & Where Else Ln,3343,E,FS,0,2,2,0,Fall2018
4964,SE Lake & 23rd,3344,E,OP,7,0,7,0,Fall2018
4965,SE Lake & 23rd,3345,W,FS,3,4,7,1,Fall2018
4966,SE Lake & 28th,3347,W,OP,2,3,5,1,Fall2018
4967,SE Lake & 28th,3348,E,NS,3,1,4,0,Fall2018
4968,SE Lake & 31st Pl,3349,E,NS,2,2,4,7,Fall2018
4969,SE Lake & 31st Pl,3350,W,OP,3,2,5,0,Fall2018
4971,SE Lake & 34th,3352,W,NS,0,0,0,0,Fall2018
4972,SE Lake & 36th,3353,E,OP,1,0,1,0,Fall2018
4973,SE Lake & 36th,3354,W,FS,0,0,0,0,Fall2018
4975,SE Lake & 51st,3356,E,FS,1,1,2,0,Fall2018
1166,Lake Oswego Transit Center,3363,S,AT,99,3,102,40,Fall2018
500,4400 Block Lakeview,3364,W,AT,1,4,5,0,Fall2018
1420,N Interstate & Larrabee,3365,N,FS,9,1,10,0,Fall2018
6716,SW Laurelwood & Laurel,3367,N,OP,67,0,67,0,Fall2018
3427,NW Leahy & Alpenglow Way,3376,W,FS,0,0,0,0,Fall2018
3431,NW Leahy & Oak,3377,E,NS,0,0,0,0,Fall2018
3423,NW Leahy & 101st,3378,E,NS,0,0,0,0,Fall2018
3424,NW Leahy & 101st,3379,W,OP,0,0,0,0,Fall2018
3425,NW Leahy & 95th,3383,E,FS,0,0,0,0,Fall2018
3426,NW Leahy & 97th,3385,E,NS,2,0,2,0,Fall2018
81,12100 Block SW Lesser,3387,N,AT,0,0,0,0,Fall2018
80,12000 Block SW Lesser,3388,S,OP,0,0,0,0,Fall2018
6720,SW Lesser & Haines,3389,S,NS,2,3,5,14,Fall2018
6718,SW Lesser & 60th,3392,S,OP,5,2,7,0,Fall2018
6719,SW Lesser & 60th,3393,E,FS,2,4,6,0,Fall2018
414,300 Block SW Lincoln,3397,E,AT,184,52,236,10,Fall2018
6721,SW Lincoln & 1st,3398,W,FS,50,210,260,5,Fall2018
4997,SE Lincoln & 57th,3403,E,NS,6,3,9,2,Fall2018
4998,SE Lincoln & 57th,3404,W,OP,3,11,14,2,Fall2018
1178,Linn & A V Davis,3407,S,NS,11,25,36,13,Fall2018
1179,Linn & Charman,3408,S,FS,4,3,7,4,Fall2018
1180,Linn & Charman,3409,N,OP,4,4,8,5,Fall2018
1181,Linn & Ethel,3410,N,NS,27,12,39,27,Fall2018
1182,Linn & Holmes,3411,S,NS,4,25,29,7,Fall2018
1183,Linn & Holmes,3412,N,NS,13,8,21,2,Fall2018
1184,Linn & Narain,3413,N,FS,5,3,8,1,Fall2018
1185,Linn & Oak,3414,S,NS,7,17,24,0,Fall2018
1186,Linn & Park,3415,S,FS,3,8,11,2,Fall2018
1187,Linn & Pearl,3416,N,FS,18,6,24,2,Fall2018
1188,Linn & Williams,3418,N,NS,34,4,38,8,Fall2018
4999,SE Linn & 13th,3419,W,NS,9,1,10,0,Fall2018
5000,SE Linn & 16th,3421,W,NS,4,3,7,2,Fall2018
1176,Linn & 4th,3422,S,NS,2,6,8,0,Fall2018
1177,Linn & 4th,3423,N,OP,3,4,7,3,Fall2018
5007,SE Linwood & Montgomery,3424,S,OP,0,1,1,0,Fall2018
5008,SE Linwood & Montgomery,3425,N,NS,0,0,0,0,Fall2018
64,11600 Block SE Linwood,3426,N,OP,2,1,3,0,Fall2018
65,11600 Block SE Linwood,3427,S,AT,2,3,5,0,Fall2018
88,12300 Block SE Linwood,3428,N,OP,4,3,7,1,Fall2018
89,12300 Block SE Linwood,3429,S,AT,7,5,12,0,Fall2018
5001,SE Linwood & Furnberg,3430,N,NS,1,0,1,0,Fall2018
5002,SE Linwood & Furnberg,3431,S,OP,0,1,1,0,Fall2018
74,11900 Block SE Linwood (Linwood Sch),3432,N,OP,2,2,4,0,Fall2018
75,11900 Block SE Linwood (Linwood Sch),3433,S,AT,2,1,3,0,Fall2018
5005,SE Linwood & Monroe,3434,N,FS,2,1,3,0,Fall2018
5006,SE Linwood & Monroe,3435,S,NS,1,1,2,0,Fall2018
6731,SW Locust & Hall,3438,W,NS,3,3,6,0,Fall2018
6732,SW Locust & Hall,3439,E,FS,5,1,6,0,Fall2018
6722,SW Locust & 80th,3440,E,NS,0,0,0,0,Fall2018
6723,SW Locust & 82nd,3441,W,FS,0,1,1,0,Fall2018
6724,SW Locust & 82nd,3442,E,NS,1,0,1,0,Fall2018
1508,N Lombard & Mississippi,3451,E,NS,21,18,39,4,Fall2018
1469,N Lombard & Albina,3452,W,NS,11,34,45,5,Fall2018
1470,N Lombard & Albina,3453,E,FS,43,21,64,4,Fall2018
6741,SW Lombard & Allen,3454,S,NS,26,78,104,25,Fall2018
6742,SW Lombard & Allen,3455,N,FS,98,30,128,11,Fall2018
1472,N Lombard & Buchanan,3462,W,FS,6,33,39,38,Fall2018
1473,N Lombard & Buchanan,3464,E,FS,39,7,46,50,Fall2018
1475,N Lombard & Burlington,3465,E,OP,272,103,375,147,Fall2018
1476,N Lombard & Burrage,3471,E,FS,43,12,55,16,Fall2018
1477,N Lombard & Burrage,3472,W,NS,6,26,32,12,Fall2018
1486,N Lombard & Charleston,3474,E,FS,157,55,212,37,Fall2018
1487,N Lombard & Chautauqua,3478,W,NS,11,15,26,7,Fall2018
1488,N Lombard & Chautauqua,3479,E,NS,12,12,24,5,Fall2018
1489,N Lombard & Clarendon,3480,W,NS,11,12,23,3,Fall2018
1490,N Lombard & Delaware,3483,W,NS,19,32,51,10,Fall2018
1491,N Lombard & Delaware,3484,E,NS,20,14,34,2,Fall2018
1492,N Lombard & Denver,3485,W,NS,115,87,202,80,Fall2018
1493,N Lombard & Denver,3486,E,NS,15,27,42,8,Fall2018
1494,N Lombard & Dwight,3487,W,NS,9,15,24,1,Fall2018
1495,N Lombard & Fenwick,3489,E,NS,46,53,99,42,Fall2018
1496,N Lombard & Fiske,3491,W,NS,21,52,73,12,Fall2018
1497,N Lombard & Gilbert,3494,W,FS,4,41,45,5,Fall2018
1498,N Lombard & Gilbert,3496,E,OP,96,15,111,21,Fall2018
1499,N Lombard & Hodge,3498,W,NS,27,28,55,18,Fall2018
1500,N Lombard & Hodge,3500,E,NS,17,22,39,17,Fall2018
1501,N Lombard & Huron,3501,E,NS,31,20,51,12,Fall2018
1502,N Lombard & Huron,3502,W,FS,17,24,41,19,Fall2018
1503,N Lombard & Ida,3503,E,NS,185,96,281,27,Fall2018
1504,N Lombard & Ida,3504,W,NS,84,227,311,76,Fall2018
1549,N Lombard Transit Center,3506,E,NS,458,759,1217,322,Fall2018
1550,N Lombard Transit Center,3507,W,FS,773,453,1226,291,Fall2018
1505,N Lombard & John,3509,W,NS,70,214,284,90,Fall2018
1506,N Lombard & Jordan,3511,E,NS,53,33,86,17,Fall2018
1507,N Lombard & McKenna,3518,W,NS,4,12,16,1,Fall2018
1509,N Lombard & Mississippi,3521,W,NS,35,25,60,8,Fall2018
1511,N Lombard & Oswego,3532,E,OP,27,5,32,17,Fall2018
1512,N Lombard & Oswego,3534,W,NS,5,30,35,18,Fall2018
1513,N Lombard & Peninsular,3535,W,NS,83,146,229,62,Fall2018
1514,N Lombard & Portsmouth,3537,E,FS,42,39,81,21,Fall2018
1515,N Lombard & Portsmouth,3538,W,NS,35,39,74,20,Fall2018
122,13200 Block N Lombard,3540,N,AT,1,0,1,0,Fall2018
123,13200 Block N Lombard,3541,S,OP,1,1,2,0,Fall2018
2788,NE Lombard & Rodney ,3546,W,NS,7,3,10,0,Fall2018
2789,NE Lombard & Rodney ,3547,E,FS,3,10,13,0,Fall2018
1520,N Lombard & Russet,3548,W,FS,3,12,15,1,Fall2018
1526,N Lombard & Tyler,3554,E,FS,58,19,77,47,Fall2018
1527,N Lombard & Tyler,3555,W,NS,21,54,75,64,Fall2018
2786,NE Lombard & M L King ,3557,W,FS,100,22,122,43,Fall2018
2787,NE Lombard & M L King ,3558,E,NS,14,80,94,23,Fall2018
1528,N Lombard & Van Houten,3559,E,NS,19,15,34,4,Fall2018
1529,N Lombard & Vancouver,3561,W,FS,41,26,67,6,Fall2018
1530,N Lombard & Vancouver,3562,E,NS,24,43,67,5,Fall2018
1537,N Lombard & Villard,3563,E,NS,62,56,118,38,Fall2018
1538,N Lombard & Wabash,3564,E,NS,26,18,44,5,Fall2018
1539,N Lombard & Wabash,3566,W,FS,20,34,54,12,Fall2018
1540,N Lombard & Wall,3569,W,NS,8,41,49,18,Fall2018
1541,N Lombard & Wall,3570,E,NS,59,14,73,20,Fall2018
1542,N Lombard & Wayland,3574,E,NS,4,3,7,1,Fall2018
1543,N Lombard & Westanna,3575,W,NS,22,51,73,29,Fall2018
1544,N Lombard & Westanna,3576,E,NS,37,22,59,27,Fall2018
1546,N Lombard & Woolsey,3578,E,NS,16,14,30,3,Fall2018
6733,SW Lombard & 12th,3580,N,NS,12,2,14,0,Fall2018
6734,SW Lombard & 12th,3581,S,OP,4,15,19,2,Fall2018
6735,SW Lombard & 2nd,3582,N,NS,7,15,22,11,Fall2018
6737,SW Lombard & 5th,3583,N,NS,11,14,25,5,Fall2018
6738,SW Lombard & 5th,3584,S,NS,10,15,25,4,Fall2018
6739,SW Lombard & 9th,3585,N,NS,14,3,17,21,Fall2018
6740,SW Lombard & 9th,3586,S,NS,5,16,21,17,Fall2018
1192,Longview & Holcomb,3588,S,NS,29,20,49,16,Fall2018
6755,SW Macadam & Boundary,3603,N,NS,125,12,137,21,Fall2018
6756,SW Macadam & Boundary,3604,S,NS,12,110,122,24,Fall2018
6757,SW Macadam & Gaines,3611,N,NS,22,11,33,2,Fall2018
6758,SW Macadam & Hamilton Ct,3612,S,OP,3,34,37,2,Fall2018
6759,SW Macadam & Hamilton Ct,3613,N,NS,24,2,26,1,Fall2018
6763,SW Macadam & Nebraska,3614,S,NS,3,42,45,2,Fall2018
6760,SW Macadam & Julia,3615,S,FS,2,25,27,0,Fall2018
6761,SW Macadam & Julia,3616,N,OP,40,2,42,1,Fall2018
6764,SW Macadam & Nebraska,3619,N,NS,43,3,46,2,Fall2018
6765,SW Macadam & Nevada,3620,S,NS,14,62,76,5,Fall2018
6766,SW Macadam & Nevada,3622,N,OP,62,12,74,3,Fall2018
6767,SW Macadam & Pendleton,3623,N,NS,87,4,91,2,Fall2018
6768,SW Macadam & Pendleton,3624,S,NS,3,70,73,1,Fall2018
5016,SE Madison & Grand,3633,W,NS,211,341,552,50,Fall2018
6772,SW Madison & 1st,3635,E,NS,824,63,887,51,Fall2018
5014,SE Madison & 11th,3637,W,NS,186,130,316,32,Fall2018
6773,SW Madison & 4th,3639,E,NS,898,80,978,107,Fall2018
5015,SE Madison & 7th,3641,W,NS,23,60,83,8,Fall2018
5022,SE Main & Beta,3652,E,NS,0,0,0,0,Fall2018
6776,SW Main & Burnham,3653,W,OP,25,18,43,4,Fall2018
6777,SW Main & Burnham,3654,E,NS,35,35,70,20,Fall2018
6787,SW Main & Scoffins,3655,E,NS,98,54,152,23,Fall2018
6784,SW Main & Commercial,3656,S,NS,126,94,220,16,Fall2018
5026,SE Main & Milport,3657,N,NS,7,13,20,1,Fall2018
5025,SE Main & Mailwell,3658,N,FS,3,3,6,0,Fall2018
5027,SE Main & Milport,3661,S,FS,7,5,12,0,Fall2018
5028,SE Main & Scott,3668,S,NS,0,1,1,0,Fall2018
6786,SW Main & Pacific Hwy,3669,N,NS,114,7,121,26,Fall2018
6978,SW Railroad & Washington,3670,N,OP,60,54,114,16,Fall2018
5035,SE Main & Scott,3672,N,OP,1,2,3,0,Fall2018
6788,SW Main & Scoffins,3673,W,NS,113,334,447,71,Fall2018
1553,N Main & NE 10th,3683,N,NS,1,17,18,2,Fall2018
991,E Main & NE 12th,3687,W,FS,0,11,11,2,Fall2018
999,E Main & SE 12th,3688,E,NS,10,1,11,2,Fall2018
1196,Main & 13th,3690,N,FS,1,0,1,0,Fall2018
1197,Main & 15th,3693,N,NS,1,0,1,0,Fall2018
1000,E Main & SE 18th,3711,W,OP,5,5,10,0,Fall2018
1007,E Main & SE 18th,3712,E,FS,5,6,11,0,Fall2018
1554,N Main & NE 2nd,3715,N,NS,8,52,60,10,Fall2018
1008,E Main & SE 24th,3716,W,NS,3,1,4,1,Fall2018
1009,E Main & SE 24th,3717,E,NS,3,5,8,0,Fall2018
1010,E Main & SE 26th,3718,W,OP,9,5,14,0,Fall2018
1011,E Main & SE 28th,3719,E,NS,8,7,15,1,Fall2018
5019,SE Main & 3rd,3720,S,NS,0,14,14,1,Fall2018
480,400 Block SE Main (Estacada City Hall),3724,S,AT,69,54,123,3,Fall2018
1555,N Main & NE 5th,3725,N,NS,2,9,11,4,Fall2018
1198,Main & 8th St,3727,W,NS,9,14,23,3,Fall2018
6789,SW Martinazzi & Boones Ferry,3778,N,NS,27,3,30,4,Fall2018
6793,SW Martinazzi & Seneca,3779,S,NS,5,33,38,2,Fall2018
134,13700 Block SE McLoughlin,3780,N,AT,4,6,10,1,Fall2018
5049,SE McLoughlin & Boardman,3781,N,FS,37,16,53,5,Fall2018
5051,SE McLoughlin & Chestnut,3782,N,NS,7,6,13,1,Fall2018
5053,SE McLoughlin & Concord,3783,N,FS,75,59,134,42,Fall2018
5055,SE McLoughlin & Courtney,3784,N,FS,48,37,85,45,Fall2018
5059,SE McLoughlin & Holly Farm Mall,3789,N,AT,19,14,33,7,Fall2018
5060,SE McLoughlin & Hull Ave,3790,N,FS,23,8,31,1,Fall2018
5062,SE McLoughlin & Jennings,3791,N,FS,55,24,79,4,Fall2018
5065,SE McLoughlin & Maple,3792,N,NS,26,11,37,3,Fall2018
5069,SE McLoughlin & Naef,3794,N,FS,40,13,53,3,Fall2018
5071,SE McLoughlin & Oak Grove,3795,N,FS,163,133,296,123,Fall2018
5174,SE Ochoco & McLoughlin,3797,W,NS,6,11,17,0,Fall2018
5073,SE McLoughlin & Park Ave,3798,N,FS,47,315,362,68,Fall2018
5075,SE McLoughlin & Risley,3799,N,FS,19,14,33,12,Fall2018
5078,SE McLoughlin & Roethe,3800,N,FS,129,50,179,38,Fall2018
5080,SE McLoughlin & Silver Springs,3801,N,NS,9,12,21,3,Fall2018
5088,SE McLoughlin & Silverleaf,3802,N,OP,13,9,22,5,Fall2018
5090,SE McLoughlin & Vineyard,3807,N,FS,44,33,77,19,Fall2018
86,12200 Block SE McLoughlin,3810,N,AT,8,9,17,14,Fall2018
570,600 Block McVey,3811,E,OP,1,0,1,0,Fall2018
571,600 Block McVey,3812,W,AT,0,0,0,0,Fall2018
1209,McVey & Cornell,3813,W,NS,0,2,2,0,Fall2018
1210,McVey & Cornell,3814,E,FS,2,0,2,0,Fall2018
1212,McVey & Maple,3815,E,NS,2,0,2,0,Fall2018
1211,McVey & Lakefront,3816,W,NS,0,1,1,0,Fall2018
1219,McVey & Oak,3817,W,FS,0,0,0,0,Fall2018
1220,McVey & Oak,3818,E,FS,1,0,1,0,Fall2018
5048,SE McKinley & Jefferson,3825,N,OP,1,4,5,2,Fall2018
135,13700 Block SE McLoughlin,3827,S,OP,8,9,17,2,Fall2018
5050,SE McLoughlin & Boardman,3829,S,FS,16,32,48,6,Fall2018
5052,SE McLoughlin & Chestnut,3830,S,FS,3,12,15,1,Fall2018
1201,McLoughlin & Clackamette Dr,3831,S,NS,35,62,97,27,Fall2018
192,16000 Block SE McLoughlin,3832,S,AT,10,31,41,5,Fall2018
5054,SE McLoughlin & Concord,3833,S,FS,50,73,123,27,Fall2018
5056,SE McLoughlin & Courtney,3834,S,NS,34,50,84,47,Fall2018
5061,SE McLoughlin & Hull Ave,3838,S,FS,7,20,27,2,Fall2018
5063,SE McLoughlin & Jennings,3839,S,FS,22,55,77,4,Fall2018
5066,SE McLoughlin & Maple,3840,S,NS,12,34,46,10,Fall2018
5067,SE McLoughlin & Meldrum,3841,S,NS,6,14,20,3,Fall2018
1203,McLoughlin & Oregon City Shopping Center,3842,N,AT,70,46,116,29,Fall2018
5072,SE McLoughlin & Oak Grove,3843,S,FS,114,161,275,83,Fall2018
4625,SE Frontage Rd & Ochoco St,3846,S,FS,13,6,19,0,Fall2018
5074,SE McLoughlin & Park Ave,3848,S,NS,361,44,405,54,Fall2018
5076,SE McLoughlin & Risley,3849,S,FS,12,21,33,5,Fall2018
5077,SE McLoughlin & River Rd,3850,S,FS,13,13,26,10,Fall2018
5079,SE McLoughlin & Roethe,3851,S,FS,52,122,174,48,Fall2018
5081,SE McLoughlin & Silver Springs,3852,S,OP,22,16,38,2,Fall2018
5089,SE McLoughlin & Silverleaf,3853,S,NS,21,16,37,8,Fall2018
677,8500 Block SE McLoughlin,3854,S,AT,2,1,3,8,Fall2018
5091,SE McLoughlin & Vineyard,3857,S,FS,26,31,57,14,Fall2018
5064,SE McLoughlin & Lakewood,3860,S,OP,1,4,5,0,Fall2018
1206,McNary & Churchill Downs,3862,E,FS,3,1,4,0,Fall2018
1207,McNary & Condolea,3863,W,FS,1,3,4,0,Fall2018
1208,McNary & Condolea,3864,E,OP,4,0,4,0,Fall2018
1223,Meridian Park Hospital Rd & SW 65th,3867,N,NS,3,0,3,0,Fall2018
1222,Meridian Park Hospital Main Stop,3868,N,AT,58,67,125,25,Fall2018
130,13500 Block SW Millikan,3892,E,OP,8,8,16,1,Fall2018
5093,SE Milwaukie & Center,3908,N,FS,40,20,60,80,Fall2018
5094,SE Milwaukie & Center,3909,S,NS,21,44,65,80,Fall2018
5095,SE Milwaukie & Claybourne,3911,S,NS,18,44,62,22,Fall2018
5096,SE Milwaukie & Claybourne,3912,N,NS,35,16,51,30,Fall2018
5098,SE Milwaukie & Haig,3916,S,NS,14,15,29,4,Fall2018
5099,SE Milwaukie & Haig,3917,N,NS,21,18,39,3,Fall2018
5100,SE Milwaukie & Insley,3921,S,OP,6,22,28,8,Fall2018
5101,SE Milwaukie & Insley,3922,N,FS,28,5,33,5,Fall2018
5102,SE Milwaukie & Long,3928,S,FS,8,17,25,2,Fall2018
5103,SE Milwaukie & Long,3929,N,OP,16,6,22,1,Fall2018
5104,SE Milwaukie & Mall,3931,S,NS,12,24,36,59,Fall2018
5105,SE Milwaukie & Mall,3932,N,NS,23,12,35,40,Fall2018
5106,SE Milwaukie & Mitchell,3933,N,FS,36,15,51,58,Fall2018
5107,SE Milwaukie & Mitchell,3935,S,OP,12,38,50,70,Fall2018
5108,SE Milwaukie & Ramona,3938,S,NS,4,29,33,1,Fall2018
5109,SE Milwaukie & Ramona,3940,N,OP,36,5,41,1,Fall2018
5110,SE Milwaukie & Tolman,3946,S,NS,10,52,62,15,Fall2018
5111,SE Milwaukie & Tolman,3947,N,NS,35,11,46,12,Fall2018
1569,N Mississippi & Beech,3955,N,NS,16,47,63,6,Fall2018
1570,N Mississippi & Failing,3957,S,FS,125,59,184,22,Fall2018
1571,N Mississippi & Failing,3958,N,NS,35,77,112,22,Fall2018
1572,N Mississippi & Mason,3966,N,FS,24,53,77,23,Fall2018
1573,N Mississippi & Mason,3967,S,NS,39,25,64,19,Fall2018
1574,N Mississippi & Skidmore,3976,N,FS,13,28,41,4,Fall2018
1575,N Mississippi & Skidmore,3977,S,NS,31,17,48,7,Fall2018
1233,Molalla & Beverly,3981,S,FS,0,2,2,1,Fall2018
1242,Molalla & Hilda,3983,N,NS,4,4,8,1,Fall2018
1243,Molalla & Hillcrest,3984,N,NS,2,0,2,1,Fall2018
1244,Molalla & Holmes,3985,S,FS,3,5,8,0,Fall2018
1249,Molalla & Pearl,3989,S,NS,3,19,22,3,Fall2018
1250,Molalla & Pearl,3990,N,NS,18,3,21,2,Fall2018
1252,Molalla & Warner,3992,S,NS,2,2,4,2,Fall2018
1255,Molalla & Willamette,3993,S,FS,3,2,5,0,Fall2018
1256,Molalla & Willamette,3994,N,NS,3,4,7,4,Fall2018
1257,Monroe & Boones Ferry Rd,3995,W,FS,2,5,7,0,Fall2018
1258,Monroe & Boones Ferry Rd,3996,E,NS,4,1,5,0,Fall2018
6796,SW Monroe & Greenridge,3997,E,NS,1,0,1,0,Fall2018
2852,NE Morris & 111th,4011,W,NS,2,0,2,0,Fall2018
2853,NE Morris & 117th,4012,E,NS,1,2,3,0,Fall2018
5120,SE Morrison & Grand,4013,W,NS,130,128,258,56,Fall2018
5114,SE Morrison & 12th,4014,W,FS,154,116,270,79,Fall2018
5115,SE Morrison & 14th,4016,W,NS,73,27,100,6,Fall2018
5116,SE Morrison & 16th,4019,W,NS,68,14,82,5,Fall2018
5117,SE Morrison & 18th,4022,W,NS,32,9,41,16,Fall2018
5118,SE Morrison & 20th,4023,W,NS,128,32,160,14,Fall2018
5119,SE Morrison & 9th,4026,W,NS,54,26,80,7,Fall2018
1259,Morrison Bridge,4028,E,AT,5,21,26,0,Fall2018
1260,Morrison Bridge,4029,W,AT,12,8,20,0,Fall2018
7,10000 Block SE Mt Scott,4032,E,AT,0,4,4,5,Fall2018
728,9900 Block SE Mt Scott,4033,W,AT,3,0,3,0,Fall2018
5121,SE Mt Scott & 103rd,4035,W,NS,3,3,6,7,Fall2018
5122,SE Mt Scott & 105th,4036,E,OP,2,14,16,10,Fall2018
5123,SE Mt Scott & 105th,4037,W,FS,4,1,5,0,Fall2018
5125,SE Mt Scott & Aspen Summit,4039,E,FS,0,3,3,0,Fall2018
5124,SE Mt Scott & 98th,4040,W,NS,2,0,2,6,Fall2018
2872,NE Multnomah & Grand,4042,E,FS,77,126,203,34,Fall2018
2873,NE Multnomah & Grand,4043,W,NS,64,81,145,31,Fall2018
2854,NE Multnomah & 11th,4044,W,OP,105,56,161,32,Fall2018
2862,NE Multnomah & 13th ,4045,W,OP,90,249,339,44,Fall2018
2863,NE Multnomah & 13th ,4047,E,FS,150,43,193,25,Fall2018
2864,NE Multnomah & 16th ,4048,E,NS,4,14,18,11,Fall2018
2865,NE Multnomah & 16th ,4049,W,NS,12,5,17,8,Fall2018
2866,NE Multnomah & 19th ,4050,E,OP,1,6,7,0,Fall2018
6806,SW Multnomah & 45th,4052,W,FS,3,2,5,0,Fall2018
2870,NE Multnomah & 9th ,4055,E,NS,22,56,78,13,Fall2018
458,3600 Block SW Murray,4057,S,AT,12,7,19,2,Fall2018
477,3900 Block SW Murray,4060,N,AT,2,2,4,3,Fall2018
544,5300 Block SW Murray,4062,S,AT,12,14,26,5,Fall2018
6814,SW Murray & Bonnie Brae,4064,S,NS,2,7,9,0,Fall2018
6815,SW Murray & Bonnie Brae,4065,N,NS,14,4,18,0,Fall2018
6818,SW Murray & Butner,4066,N,FS,10,12,22,0,Fall2018
6819,SW Murray & Butner,4067,S,FS,13,12,25,1,Fall2018
6821,SW Murray & Farmington,4068,S,FS,57,23,80,7,Fall2018
6822,SW Murray & Farmington,4069,N,FS,28,41,69,5,Fall2018
6828,SW Murray & Linda,4077,N,OP,8,11,19,3,Fall2018
6829,SW Murray & Linda,4078,S,NS,9,4,13,0,Fall2018
3448,NW Murray & Milburn,4080,S,NS,7,8,15,0,Fall2018
3449,NW Murray & Science Park Dr,4085,N,FS,10,52,62,6,Fall2018
3450,NW Murray & Science Park Dr,4086,S,NS,53,18,71,3,Fall2018
6848,SW Murray & Tualatin Valley Hwy,4087,N,NS,18,39,57,2,Fall2018
6849,SW Murray & Tualatin Valley Hwy,4088,S,FS,41,11,52,1,Fall2018
6850,SW Murray & Walker,4090,N,FS,20,22,42,5,Fall2018
6851,SW Murray & Walker,4091,S,NS,31,19,50,6,Fall2018
6808,SW Murray & 6th,4095,N,NS,16,12,28,7,Fall2018
6859,SW Nebraska & Corbett,4102,W,NS,2,0,2,0,Fall2018
6860,SW Nebraska & Virginia,4103,E,NS,2,3,5,1,Fall2018
6861,SW Nevada Ct & 54th,4104,W,OP,2,2,4,0,Fall2018
3454,NW Nicolai & 27th,4105,E,NS,4,3,7,0,Fall2018
6865,SW Oak & Armco Ave,4116,E,NS,51,18,69,8,Fall2018
6862,SW Oak & 17th,4119,E,FS,74,49,123,27,Fall2018
5126,SE Oak & 7th,4123,E,NS,76,45,121,27,Fall2018
5127,SE Oak & 9th,4125,E,NS,26,51,77,15,Fall2018
152,14100 Block SE Oatfield,4136,S,AT,1,1,2,0,Fall2018
5155,SE Oatfield & Oak Grove,4137,N,OP,4,10,14,0,Fall2018
215,16800 Block SE Oatfield,4138,S,OP,0,0,0,0,Fall2018
216,16800 Block SE Oatfield,4139,N,AT,0,0,0,0,Fall2018
3580,Oatfield & Stone Oaks Ct,4140,S,OP,1,3,4,0,Fall2018
5128,SE Oatfield & Alchar Dr,4141,W,FS,0,0,0,0,Fall2018
5129,SE Oatfield & Aldercrest,4142,E,NS,1,1,2,0,Fall2018
5130,SE Oatfield & Allan,4143,N,NS,2,1,3,0,Fall2018
5131,SE Oatfield & Allan,4144,S,OP,0,1,1,0,Fall2018
3581,Oatfield & Stone Oaks Ct,4145,N,NS,3,0,3,0,Fall2018
5132,SE Oatfield & Clayson,4146,S,NS,2,3,5,0,Fall2018
5133,SE Oatfield & Clayson,4147,N,OP,4,2,6,0,Fall2018
3569,Oatfield & Collins Crest,4148,S,NS,2,4,6,0,Fall2018
5134,SE Oatfield & Concord,4149,S,NS,4,7,11,0,Fall2018
5141,SE Oatfield & Concord,4150,N,FS,4,5,9,1,Fall2018
5142,SE Oatfield & Courtney,4151,S,NS,1,1,2,0,Fall2018
3570,Oatfield & E Exeter,4154,S,NS,3,9,12,0,Fall2018
3575,Oatfield & Glen Echo,4159,E,NS,5,5,10,0,Fall2018
5143,SE Oatfield & Guilford,4160,S,OP,1,1,2,0,Fall2018
5144,SE Oatfield & Guilford,4161,N,FS,1,1,2,0,Fall2018
3572,Oatfield & E Hereford,4164,S,FS,2,7,9,0,Fall2018
5145,SE Oatfield & Hill,4165,S,OP,1,3,4,4,Fall2018
5146,SE Oatfield & Hill,4166,N,FS,1,1,2,0,Fall2018
5147,SE Oatfield & Jennings,4169,N,NS,2,1,3,0,Fall2018
5148,SE Oatfield & Jennings,4170,S,NS,1,2,3,0,Fall2018
3574,Oatfield & E Kenmore,4171,S,FS,2,4,6,0,Fall2018
5149,SE Oatfield & Loeffelman Rd,4172,S,OP,1,3,4,0,Fall2018
5150,SE Oatfield & Loeffelman Rd,4173,N,FS,2,1,3,0,Fall2018
5151,SE Oatfield & McNary,4174,N,FS,3,1,4,0,Fall2018
5152,SE Oatfield & McNary,4175,S,OP,1,3,4,0,Fall2018
5153,SE Oatfield & Naef,4176,S,OP,0,1,1,0,Fall2018
5154,SE Oatfield & Naef,4177,N,NS,1,0,1,0,Fall2018
5156,SE Oatfield & Oak Grove,4178,S,NS,11,6,17,2,Fall2018
5157,SE Oatfield & Oakland,4179,S,OP,0,2,2,0,Fall2018
5158,SE Oatfield & Oakland,4180,N,FS,3,0,3,0,Fall2018
3576,Oatfield & Oakridge,4181,E,OP,1,5,6,1,Fall2018
3577,Oatfield & Oakridge,4182,W,NS,4,2,6,0,Fall2018
5159,SE Oatfield & Oatfield Ct,4183,S,OP,0,0,0,0,Fall2018
5160,SE Oatfield & Oatfield Ct,4184,N,FS,0,0,0,0,Fall2018
5161,SE Oatfield & Park,4185,S,FS,5,2,7,0,Fall2018
5162,SE Oatfield & Park,4186,N,NS,1,28,29,1,Fall2018
3578,Oatfield & Park Way,4187,W,NS,6,4,10,0,Fall2018
5163,SE Oatfield & Pinehurst,4188,N,FS,1,0,1,0,Fall2018
5164,SE Oatfield & Raymond,4189,S,FS,0,1,1,0,Fall2018
5165,SE Oatfield & Raymond,4190,N,OP,1,0,1,0,Fall2018
3579,Oatfield & Ridgegate,4191,N,NS,5,3,8,0,Fall2018
5166,SE Oatfield & Risley,4192,S,FS,1,2,3,0,Fall2018
5167,SE Oatfield & Risley,4193,N,NS,1,1,2,0,Fall2018
5168,SE Oatfield & Roethe,4194,S,NS,2,12,14,0,Fall2018
5169,SE Oatfield & Roethe,4195,N,FS,4,4,8,1,Fall2018
5170,SE Oatfield & Silver Springs,4198,S,OP,0,1,1,2,Fall2018
5171,SE Oatfield & Silver Springs,4199,N,FS,2,1,3,4,Fall2018
5172,SE Oatfield & Thiessen,4200,N,NS,4,1,5,0,Fall2018
5173,SE Oatfield & Thiessen,4201,S,OP,1,4,5,1,Fall2018
3568,Oatfield & 82nd Dr,4204,E,NS,2,2,4,0,Fall2018
6871,SW Oleson & Alden,4205,S,NS,2,8,10,3,Fall2018
6872,SW Oleson & Garden Home,4206,N,NS,30,17,47,1,Fall2018
6873,SW Oleson & Garden Home,4207,S,FS,10,6,16,0,Fall2018
6874,SW Oleson & Hall,4208,E,FS,8,2,10,3,Fall2018
6875,SW Oleson & Hall,4209,S,NS,2,10,12,0,Fall2018
6876,SW Oleson & Obrien,4210,S,NS,0,1,1,0,Fall2018
6878,SW Oleson & Rustling Leaves Pl,4214,E,FS,4,3,7,0,Fall2018
6879,SW Oleson & Rustling Leaves Pl,4215,W,OP,1,3,4,0,Fall2018
6867,SW Oleson & 80th,4216,N,NS,11,3,14,2,Fall2018
6880,SW Oleson & Skyhar Dr,4217,S,NS,2,6,8,0,Fall2018
6868,SW Oleson & 89th,4218,W,NS,0,2,2,0,Fall2018
6869,SW Oleson & 91st,4219,E,NS,7,2,9,0,Fall2018
6870,SW Oleson & 91st,4220,W,OP,1,5,6,0,Fall2018
5183,SE Orient Dr & Welch Rd,4230,S,FS,0,0,0,0,Fall2018
5177,SE Orient Dr & 14th,4231,S,FS,1,2,3,0,Fall2018
5184,SE Orient Dr & Welch Rd,4243,N,FS,0,0,0,0,Fall2018
61,11500 Block SW Pacific Hwy,4248,E,AT,7,9,16,2,Fall2018
6896,SW Pacific Hwy & 72nd,4249,W,FS,38,39,77,28,Fall2018
69,11700 Block SW Pacific Hwy,4252,E,OP,3,8,11,0,Fall2018
70,11700 Block SW Pacific Hwy,4253,W,AT,5,3,8,0,Fall2018
129,13400 Block SW Pacific Hwy,4254,W,AT,6,22,28,11,Fall2018
6918,SW Pacific Hwy & McDonald/Gaarde,4255,E,FS,92,13,105,32,Fall2018
203,16400 Block SW Pacific Hwy,4257,S,AT,2,5,7,0,Fall2018
6911,SW Pacific Hwy & Fischer ,4258,S,FS,10,67,77,8,Fall2018
229,17000 Block SW Pacific Hwy,4259,N,AT,12,3,15,1,Fall2018
6882,SW Pacific Hwy & 124th,4260,W,OP,7,59,66,10,Fall2018
3612,Pacific Ave & A St,4264,W,NS,1,77,78,16,Fall2018
6900,SW Pacific Hwy & Beef Bend ,4266,N,OP,21,2,23,0,Fall2018
6901,SW Pacific Hwy & Beef Bend ,4267,S,FS,1,20,21,1,Fall2018
6902,SW Pacific Hwy & Bull Mtn ,4270,N,NS,34,5,39,2,Fall2018
6903,SW Pacific Hwy & Bull Mtn ,4271,S,FS,3,41,44,2,Fall2018
470,3900 Block Pacific Ave,4272,E,AT,33,9,42,23,Fall2018
6904,SW Pacific Hwy & Canterbury,4273,S,NS,6,43,49,4,Fall2018
6905,SW Pacific Hwy & Canterbury,4274,N,FS,42,9,51,5,Fall2018
3613,Pacific Ave & Cedar,4275,W,NS,2,96,98,19,Fall2018
6906,SW Pacific Hwy & Cipole ,4276,E,NS,7,0,7,2,Fall2018
6907,SW Pacific Hwy & Cipole ,4277,W,FS,0,7,7,4,Fall2018
3614,Pacific Ave & College Way,4278,W,NS,1,94,95,16,Fall2018
3619,Pacific Ave & Mountain View Ln,4279,W,NS,7,33,40,4,Fall2018
3615,Pacific Ave & Elm,4280,W,NS,2,42,44,44,Fall2018
6897,SW Pacific Hwy & 72nd,4284,E,FS,41,32,73,20,Fall2018
6912,SW Pacific Hwy & Gaarde/McDonald,4286,W,NS,13,81,94,30,Fall2018
4,10000 Block NE Pacific St,4287,E,AT,147,4,151,66,Fall2018
5,10000 Block NE Pacific St,4288,W,OP,5,170,175,97,Fall2018
466,3800 Block Pacific Ave,4289,W,AT,17,41,58,18,Fall2018
6914,SW Pacific Hwy & Hall ,4290,E,FS,52,4,56,8,Fall2018
3616,Pacific Ave & Hawthorne,4291,W,NS,4,54,58,7,Fall2018
6915,SW Pacific Hwy & Hazelbrook,4293,N,NS,45,5,50,12,Fall2018
3617,Pacific Ave & Maple,4294,E,NS,71,12,83,22,Fall2018
3618,Pacific Ave & Maple,4295,W,OP,6,63,69,15,Fall2018
3621,Pacific Ave & Oak,4298,E,NS,42,6,48,13,Fall2018
3622,Pacific Ave & Oak,4299,W,FS,10,49,59,23,Fall2018
6919,SW Pacific Hwy & Pacific Dr ,4300,W,NS,1,6,7,1,Fall2018
6890,SW Pacific Hwy & 130th,4301,E,FS,8,2,10,0,Fall2018
6920,SW Pacific Hwy & Park ,4304,E,NS,7,3,10,1,Fall2018
6899,SW Pacific Hwy & 78th,4305,W,NS,40,43,83,16,Fall2018
3623,Pacific Ave & Quince,4306,E,FS,50,12,62,9,Fall2018
3624,Pacific Ave & Quince,4307,W,FS,8,38,46,14,Fall2018
6921,SW Pacific Hwy & Royal Villa Dr,4308,N,NS,63,6,69,7,Fall2018
398,2900 Block Pacific Ave,4309,W,AT,35,139,174,48,Fall2018
6924,SW Pacific Hwy & School ,4310,W,FS,7,29,36,2,Fall2018
3620,Pacific Ave & Mountain View Ln,4311,E,NS,26,11,37,4,Fall2018
6883,SW Pacific Hwy & 124th,4316,E,FS,27,4,31,2,Fall2018
6925,SW Pacific Hwy & Walnut ,4317,E,NS,40,16,56,4,Fall2018
6926,SW Pacific Hwy & Walnut ,4318,W,NS,31,42,73,6,Fall2018
6927,SW Pacific Hwy & Warner ,4319,W,NS,2,49,51,8,Fall2018
6928,SW Pacific Hwy & Watkins ,4320,W,FS,3,13,16,1,Fall2018
6929,SW Pacific Hwy & Watkins ,4321,E,OP,10,3,13,1,Fall2018
1283,N Adair & Yew,4322,W,NS,26,131,157,7,Fall2018
3625,Pacific Ave & Yew,4323,E,OP,112,24,136,5,Fall2018
6892,SW Pacific Hwy & 65th,4326,W,FS,24,56,80,14,Fall2018
6893,SW Pacific Hwy & 68th,4327,E,FS,26,17,43,7,Fall2018
6894,SW Pacific Hwy & 69th,4328,W,NS,10,26,36,3,Fall2018
6895,SW Pacific Hwy & 71st,4329,W,FS,8,24,32,3,Fall2018
6933,SW Palatine Hill & Palatine Hill/Palater,4334,W,NS,1,0,1,0,Fall2018
6934,SW Palatine Hill & Riverside ,4336,S,FS,0,33,33,2,Fall2018
6946,SW Park Pl & St Clair,4340,W,NS,2,8,10,0,Fall2018
6936,SW Park Pl & Douglas ,4341,E,NS,2,0,2,0,Fall2018
6943,SW Park Pl & Green,4343,W,FS,1,1,2,0,Fall2018
6944,SW Park Pl & King,4345,E,NS,0,0,0,0,Fall2018
6945,SW Park Pl & Lewis & Clark,4346,W,NS,0,1,1,0,Fall2018
7003,SW Rose Garden Way & Wright,4351,W,FS,1,0,1,0,Fall2018
18,10200 Block SW Park Way,4366,E,OP,0,2,2,0,Fall2018
6950,SW Park Way & Cedar Hills,4369,W,FS,1,0,1,0,Fall2018
6951,SW Park Way & Cedar Hills,4370,E,NS,0,5,5,0,Fall2018
6952,SW Park Way & Dellwood,4371,W,NS,0,0,0,0,Fall2018
6953,SW Park Way & Dellwood,4372,E,NS,0,0,0,0,Fall2018
6954,SW Park Way & Devonshire,4374,E,OP,1,0,1,0,Fall2018
6955,SW Park Way & Hicrest,4376,E,NS,1,0,1,0,Fall2018
6956,SW Park Way & Hilldale,4377,W,NS,1,0,1,0,Fall2018
6957,SW Park Way & Huntington,4378,W,NS,2,0,2,0,Fall2018
6958,SW Park Way & Huntington,4379,E,NS,0,1,1,0,Fall2018
6959,SW Park Way & Parkwood,4380,W,NS,0,0,0,0,Fall2018
6960,SW Park Way & Parkwood,4381,E,NS,0,0,0,0,Fall2018
6961,SW Park Way & Tremont,4382,W,NS,0,0,0,0,Fall2018
6962,SW Park Way & Walker,4383,W,NS,1,0,1,0,Fall2018
6963,SW Park Way & Walker,4384,E,FS,0,1,1,0,Fall2018
6964,SW Park Way & Wynwood,4385,W,NS,0,0,0,0,Fall2018
6965,SW Park Way & Wynwood,4386,E,NS,0,0,0,0,Fall2018
132,13500 Block SW Park Way,4387,W,AT,0,0,0,0,Fall2018
6966,SW Patrick & Council Crest,4410,W,NS,0,1,1,0,Fall2018
444,3400 Block SW Patton,4413,W,AT,0,0,0,0,Fall2018
6967,SW Patton & Greenway,4415,E,FS,12,0,12,0,Fall2018
6968,SW Patton & Homar,4416,E,OP,3,0,3,0,Fall2018
6970,SW Patton & Montgomery,4417,W,FS,0,4,4,0,Fall2018
6971,SW Patton & Old Orchard,4419,W,OP,0,1,1,0,Fall2018
6972,SW Patton & Old Orchard,4420,E,NS,0,0,0,0,Fall2018
6973,SW Patton & Patton Ct,4422,E,OP,2,0,2,0,Fall2018
6974,SW Patton & Patton Ln,4423,W,OP,0,2,2,0,Fall2018
6975,SW Patton & Patton Ln,4424,E,FS,4,0,4,0,Fall2018
3597,PCC Drive & Springville,4426,S,NS,17,1,18,0,Fall2018
3604,PCC Lower Drive (G St) & H St,4427,E,NS,0,6,6,0,Fall2018
3606,PCC Rock Creek Main Stop,4429,S,AT,587,562,1149,62,Fall2018
3607,PCC Sylvania Main Stop,4431,S,AT,560,559,1119,113,Fall2018
1576,N Peninsular & Farragut,4432,N,FS,0,26,26,0,Fall2018
1577,N Peninsular & Farragut,4433,S,NS,34,2,36,0,Fall2018
1578,N Peninsular & Halleck,4434,N,NS,1,9,10,0,Fall2018
1579,N Peninsular & Halleck,4435,S,NS,19,11,30,2,Fall2018
1580,N Peninsular & Russet,4437,S,FS,46,9,55,4,Fall2018
1581,N Peninsular & Watts,4438,N,FS,1,15,16,0,Fall2018
1582,N Peninsular & Watts,4439,S,NS,23,0,23,0,Fall2018
1583,N Philadelphia & Ivanhoe,4440,E,NS,0,87,87,6,Fall2018
1590,N Philadelphia & Syracuse,4441,W,NS,53,2,55,6,Fall2018
6976,SW Pine & 2nd,4451,S,NS,0,14,14,1,Fall2018
6977,SW Pine & 2nd,4452,N,NS,7,0,7,1,Fall2018
1609,N Rosa Parks Way & Albina,4455,E,NS,19,11,30,13,Fall2018
3658,Portland Ave & W Arlington,4456,S,NS,3,5,8,1,Fall2018
1611,N Rosa Parks Way & Boston,4457,E,NS,8,5,13,3,Fall2018
1612,N Rosa Parks Way & Congress,4458,W,FS,3,15,18,1,Fall2018
1613,N Rosa Parks Way & Congress,4459,E,OP,17,3,20,2,Fall2018
1614,N Rosa Parks Way & Curtis,4461,E,NS,6,3,9,0,Fall2018
3659,Portland Ave & W Dartmouth,4462,S,NS,1,5,6,0,Fall2018
3649,Portland Ave & E Dartmouth,4463,N,NS,24,4,28,5,Fall2018
1615,N Rosa Parks Way & Delaware,4464,W,NS,6,12,18,1,Fall2018
1616,N Rosa Parks Way & Denver,4465,W,NS,5,12,17,2,Fall2018
1617,N Rosa Parks Way & Denver,4466,E,NS,9,4,13,4,Fall2018
3660,Portland Ave & W Fairfield,4467,S,NS,0,1,1,1,Fall2018
3650,Portland Ave & E Fairfield,4468,N,NS,1,0,1,0,Fall2018
1618,N Rosa Parks Way & Greeley,4470,E,FS,7,7,14,6,Fall2018
1619,N Rosa Parks Way & Greeley,4471,W,NS,8,12,20,7,Fall2018
3657,Portland Ave & E Hereford,4472,N,NS,3,0,3,4,Fall2018
1620,N Rosa Parks Way & Interstate,4473,W,NS,62,28,90,17,Fall2018
1621,N Rosa Parks Way & Interstate,4474,E,FS,24,54,78,16,Fall2018
3661,Portland Ave & W Ipswich,4475,S,NS,1,1,2,3,Fall2018
1623,N Rosa Parks Way & Vancouver,4485,W,FS,14,26,40,1,Fall2018
1624,N Rosa Parks Way & Vancouver,4486,E,NS,23,9,32,1,Fall2018
1591,N Portsmouth & Amherst,4491,S,NS,0,7,7,0,Fall2018
1592,N Portsmouth & Depauw,4492,N,FS,14,0,14,0,Fall2018
1593,N Portsmouth & Lombard St,4494,S,NS,2,33,35,16,Fall2018
1594,N Portsmouth & Lombard St,4495,N,NS,44,5,49,14,Fall2018
1595,N Portsmouth & Oberlin,4496,S,NS,1,11,12,0,Fall2018
1596,N Portsmouth & Princeton,4497,N,NS,13,0,13,0,Fall2018
1597,N Portsmouth & Syracuse,4498,S,NS,0,8,8,0,Fall2018
1599,N Portsmouth & Willis,4501,N,NS,47,1,48,1,Fall2018
1600,N Portsmouth & Yale,4502,N,NS,11,0,11,1,Fall2018
34,10800 Block SE Powell,4503,W,AT,20,7,27,3,Fall2018
35,10800 Block SE Powell,4504,E,AT,6,27,33,5,Fall2018
5225,SE Powell & 151st,4506,W,FS,37,8,45,0,Fall2018
401,2900 Block W Powell,4507,E,AT,15,19,34,1,Fall2018
402,2900 Block W Powell,4508,W,OP,19,11,30,2,Fall2018
7539,W Powell & NW Bella Vista,4513,E,OP,1,2,3,0,Fall2018
7551,W Powell & SW Birdsdale,4515,E,NS,10,13,23,0,Fall2018
7540,W Powell & NW Birdsdale,4516,W,FS,13,11,24,1,Fall2018
1031,E Powell & SE Burnside,4518,W,FS,14,4,18,10,Fall2018
1032,E Powell & SE Cleveland,4520,E,NS,3,2,5,2,Fall2018
1023,E Powell & NE Cleveland,4521,W,FS,4,3,7,1,Fall2018
7552,W Powell & SW Duniway,4522,E,OP,107,129,236,31,Fall2018
7553,W Powell & SW Duniway,4523,W,FS,22,60,82,32,Fall2018
1026,E Powell & NE Hogan,4528,W,NS,4,1,5,2,Fall2018
1033,E Powell & SE Hogan,4529,E,NS,2,4,6,1,Fall2018
1027,E Powell & NE Liberty,4531,E,OP,1,4,5,4,Fall2018
5307,SE Powell & Meadowland Center,4534,E,AT,16,45,61,14,Fall2018
5308,SE Powell & Milwaukie,4537,E,NS,72,54,126,32,Fall2018
5309,SE Powell & Milwaukie,4538,W,FS,178,329,507,69,Fall2018
5310,SE Powell & Milwaukie,4539,N,NS,73,63,136,12,Fall2018
5312,SE Powell & Powell Garage Dr,4542,E,NS,54,37,91,9,Fall2018
5313,SE Powell & Powell Garage Dr,4543,W,FS,27,95,122,5,Fall2018
1034,E Powell & SE Rene,4545,E,FS,13,31,44,10,Fall2018
1035,E Powell & SE Rene,4546,W,OP,22,5,27,1,Fall2018
7556,W Powell & SW Towle,4552,E,FS,9,15,24,4,Fall2018
7543,W Powell & NW Towle,4553,W,FS,12,13,25,4,Fall2018
7560,W Powell & Village Drive,4554,W,FS,36,16,52,5,Fall2018
7557,W Powell & SW Wallula,4555,E,FS,3,11,14,3,Fall2018
7544,W Powell & NW Wallula,4556,W,NS,5,4,9,2,Fall2018
7558,W Powell & SW Walters,4557,E,FS,3,12,15,3,Fall2018
7559,W Powell & SW Walters,4558,W,FS,6,3,9,4,Fall2018
8,10000 Block SE Powell,4561,W,AT,4,5,9,0,Fall2018
5186,SE Powell & 102nd,4562,E,FS,8,13,21,1,Fall2018
5187,SE Powell & 102nd,4563,W,NS,4,2,6,0,Fall2018
5194,SE Powell & 104th,4564,E,FS,9,18,27,3,Fall2018
5195,SE Powell & 104th,4565,W,OP,19,11,30,0,Fall2018
5196,SE Powell & 112th,4566,W,FS,80,33,113,13,Fall2018
5197,SE Powell & 112th,4567,E,FS,32,75,107,10,Fall2018
5198,SE Powell & 116th,4568,E,OP,3,12,15,0,Fall2018
5199,SE Powell & 116th,4569,W,NS,13,3,16,1,Fall2018
5200,SE Powell & 119th,4570,W,NS,32,3,35,2,Fall2018
5201,SE Powell & 119th,4571,E,NS,5,59,64,4,Fall2018
5202,SE Powell & 122nd,4572,W,FS,174,70,244,56,Fall2018
5203,SE Powell & 122nd,4573,E,FS,166,194,360,72,Fall2018
5204,SE Powell & 124th,4575,W,FS,22,89,111,25,Fall2018
5206,SE Powell & 127th Pl,4576,W,FS,34,11,45,3,Fall2018
5207,SE Powell & 129th,4578,W,NS,45,9,54,6,Fall2018
5209,SE Powell & 130th,4580,E,NS,9,50,59,5,Fall2018
5210,SE Powell & 132nd,4581,W,OP,59,11,70,3,Fall2018
5211,SE Powell & 132nd,4582,E,FS,10,51,61,17,Fall2018
5212,SE Powell & 134th,4583,W,NS,127,23,150,30,Fall2018
5213,SE Powell & 134th,4584,E,OP,7,23,30,6,Fall2018
5214,SE Powell & 136th,4585,E,NS,23,102,125,19,Fall2018
5215,SE Powell & 136th,4586,W,NS,21,23,44,11,Fall2018
5216,SE Powell & 138th,4587,W,NS,15,7,22,4,Fall2018
5217,SE Powell & 138th,4588,E,OP,10,22,32,3,Fall2018
5218,SE Powell & 140th,4591,W,NS,23,6,29,2,Fall2018
5219,SE Powell & 141st,4592,E,NS,5,17,22,1,Fall2018
5220,SE Powell & 143rd,4593,E,NS,6,15,21,2,Fall2018
5221,SE Powell & 145th,4595,W,NS,24,9,33,4,Fall2018
5222,SE Powell & 145th,4596,E,FS,6,21,27,3,Fall2018
5223,SE Powell & 148th,4597,W,FS,52,21,73,10,Fall2018
5224,SE Powell & 148th,4598,E,FS,24,63,87,11,Fall2018
5226,SE Powell & 151st,4599,E,FS,7,21,28,5,Fall2018
5227,SE Powell & 154th,4600,E,FS,6,15,21,6,Fall2018
5229,SE Powell & 157th,4602,E,OP,5,14,19,22,Fall2018
5230,SE Powell & 157th,4603,W,NS,14,7,21,2,Fall2018
5231,SE Powell & 160th,4606,E,FS,7,21,28,1,Fall2018
5232,SE Powell & 160th,4607,W,NS,27,9,36,5,Fall2018
5234,SE Powell & 164th,4609,W,NS,37,11,48,4,Fall2018
5311,SE Powell & Naegeli,4610,E,FS,5,21,26,4,Fall2018
5235,SE Powell & 166th,4611,W,NS,16,4,20,2,Fall2018
5236,SE Powell & 168th,4612,E,OP,8,46,54,1,Fall2018
5237,SE Powell & 168th,4613,W,FS,37,7,44,4,Fall2018
5238,SE Powell & 170th,4614,W,NS,49,16,65,7,Fall2018
5239,SE Powell & 174th,4615,E,FS,24,73,97,40,Fall2018
5240,SE Powell & 174th,4616,W,NS,83,28,111,45,Fall2018
7550,W Powell & SW 181st,4617,W,OP,112,60,172,42,Fall2018
7555,W Powell & SW Highland,4618,E,FS,112,147,259,62,Fall2018
7548,W Powell & Powell Loop,4620,E,FS,6,9,15,2,Fall2018
7549,W Powell & Powell Loop,4621,W,FS,12,7,19,1,Fall2018
5247,SE Powell & 21st,4622,E,FS,79,94,173,16,Fall2018
5248,SE Powell & 21st,4623,W,NS,98,47,145,21,Fall2018
5249,SE Powell & 24th,4625,E,OP,51,25,76,2,Fall2018
5250,SE Powell & 24th,4626,W,FS,80,29,109,5,Fall2018
5251,SE Powell & 26th,4627,E,NS,85,144,229,6,Fall2018
5252,SE Powell & 28th,4631,W,NS,212,249,461,19,Fall2018
5317,SE Powell Valley & 282nd,4633,E,NS,1,1,2,0,Fall2018
1029,E Powell & SE 3rd,4638,N,FS,0,0,0,0,Fall2018
1030,E Powell & SE 3rd,4639,S,OP,0,2,2,0,Fall2018
5254,SE Powell & 33rd,4643,W,FS,67,34,101,15,Fall2018
5255,SE Powell & 33rd,4644,E,NS,21,73,94,10,Fall2018
5256,SE Powell & 34th,4646,W,OP,56,33,89,11,Fall2018
5257,SE Powell & 34th,4647,E,FS,63,67,130,19,Fall2018
5259,SE Powell & 36th Pl,4648,E,FS,11,37,48,3,Fall2018
5258,SE Powell & 36th,4649,W,FS,40,13,53,5,Fall2018
5305,SE Powell & Cesar Chavez Blvd,4651,E,FS,182,279,461,94,Fall2018
5306,SE Powell & Cesar Chavez Blvd,4653,W,FS,259,155,414,71,Fall2018
5260,SE Powell & 40th,4654,W,NS,7,23,30,6,Fall2018
5261,SE Powell & 42nd,4656,E,NS,21,39,60,6,Fall2018
5262,SE Powell & 43rd,4657,W,NS,40,19,59,4,Fall2018
5263,SE Powell & 47th,4662,E,OP,18,38,56,3,Fall2018
5264,SE Powell & 47th,4663,W,FS,17,9,26,2,Fall2018
5265,SE Powell & 49th,4664,W,NS,74,37,111,20,Fall2018
5266,SE Powell & 50th/Foster,4666,E,FS,60,148,208,23,Fall2018
5267,SE Powell & 52nd,4667,E,FS,117,111,228,21,Fall2018
5268,SE Powell & 52nd,4668,W,FS,141,89,230,15,Fall2018
5271,SE Powell & 58th,4674,W,NS,44,21,65,5,Fall2018
5272,SE Powell & 60th,4675,E,FS,12,29,41,4,Fall2018
5273,SE Powell & 62nd,4676,W,FS,22,11,33,5,Fall2018
5275,SE Powell & 65th,4679,E,FS,13,62,75,18,Fall2018
5277,SE Powell & 67th,4680,E,FS,14,26,40,3,Fall2018
5278,SE Powell & 67th,4681,W,FS,46,19,65,3,Fall2018
5279,SE Powell & 69th,4682,E,FS,12,33,45,7,Fall2018
5280,SE Powell & 69th,4683,W,FS,37,13,50,3,Fall2018
5281,SE Powell & 71st,4684,W,NS,72,22,94,4,Fall2018
5282,SE Powell & 72nd,4686,E,NS,20,65,85,21,Fall2018
5285,SE Powell & 79th,4691,E,OP,15,114,129,31,Fall2018
5286,SE Powell & 79th,4692,W,FS,91,12,103,23,Fall2018
5287,SE Powell & 82nd,4693,E,FS,308,275,583,108,Fall2018
5288,SE Powell & 82nd,4695,W,FS,233,198,431,92,Fall2018
5289,SE Powell & 84th,4698,W,FS,16,78,94,9,Fall2018
5290,SE Powell & 86th,4699,E,FS,47,85,132,14,Fall2018
5291,SE Powell & 87th,4700,W,FS,79,45,124,11,Fall2018
5303,SE Powell & 9th,4701,E,NS,2,25,27,2,Fall2018
5304,SE Powell & 9th,4702,W,FS,18,4,22,1,Fall2018
5292,SE Powell & 90th Pl,4704,E,OP,8,27,35,3,Fall2018
5293,SE Powell & 90th Pl,4706,W,FS,17,8,25,1,Fall2018
5300,SE Powell & 92nd,4707,E,FS,235,92,327,38,Fall2018
5301,SE Powell & 92nd,4709,W,FS,101,96,197,31,Fall2018
384,2800 Block SE Powell Valley,4713,E,AT,4,12,16,4,Fall2018
385,2800 Block SE Powell Valley,4714,W,AT,7,4,11,4,Fall2018
5323,SE Powell Valley & Hale,4715,E,OP,2,6,8,1,Fall2018
5319,SE Powell Valley & Dogwood,4718,E,FS,1,0,1,0,Fall2018
5320,SE Powell Valley & Dogwood,4719,W,NS,1,1,2,0,Fall2018
5325,SE Powell Valley & Robin,4720,W,OP,7,1,8,1,Fall2018
2875,NE Prescott & 102nd,4724,E,NS,33,12,45,7,Fall2018
29,10600 Block NE Prescott,4725,E,AT,7,7,14,1,Fall2018
30,10700 Block NE Prescott,4726,W,OP,10,6,16,0,Fall2018
2876,NE Prescott & 102nd,4730,W,FS,18,41,59,7,Fall2018
2877,NE Prescott & 105th,4731,E,NS,37,15,52,1,Fall2018
2878,NE Prescott & 105th,4732,W,NS,15,35,50,1,Fall2018
2879,NE Prescott & 110th,4733,E,NS,9,5,14,0,Fall2018
2880,NE Prescott & 110th,4734,W,OP,5,5,10,3,Fall2018
2881,NE Prescott & 112th,4735,E,NS,11,7,18,1,Fall2018
2882,NE Prescott & 112th,4736,W,NS,6,12,18,2,Fall2018
2883,NE Prescott & 115th,4737,E,FS,11,6,17,2,Fall2018
2884,NE Prescott & 115th,4738,W,NS,9,12,21,7,Fall2018
2885,NE Prescott & 118th,4739,E,OP,5,4,9,0,Fall2018
2886,NE Prescott & 118th,4740,W,NS,6,11,17,2,Fall2018
2887,NE Prescott & 121st Pl,4741,E,NS,22,9,31,0,Fall2018
2888,NE Prescott & 64th,4744,E,NS,4,13,17,1,Fall2018
2889,NE Prescott & 64th,4745,W,NS,17,7,24,0,Fall2018
2890,NE Prescott & 68th,4748,E,NS,14,21,35,19,Fall2018
2891,NE Prescott & 68th,4749,W,FS,20,13,33,13,Fall2018
2892,NE Prescott & 72nd,4752,E,NS,10,19,29,6,Fall2018
2893,NE Prescott & 72nd,4753,W,NS,23,7,30,12,Fall2018
2894,NE Prescott & 77th,4756,E,NS,2,11,13,0,Fall2018
2895,NE Prescott & 77th,4757,W,NS,20,4,24,0,Fall2018
2896,NE Prescott & 82nd,4760,E,NS,18,54,72,9,Fall2018
2897,NE Prescott & 82nd,4761,W,FS,42,15,57,11,Fall2018
2899,NE Prescott & 85th,4762,E,NS,1,3,4,0,Fall2018
2898,NE Prescott & 84th,4763,W,FS,4,4,8,0,Fall2018
2901,NE Prescott & 88th,4764,E,NS,2,7,9,15,Fall2018
2903,NE Prescott & 92nd,4766,E,FS,22,2,24,1,Fall2018
2904,NE Prescott & 92nd,4767,W,NS,1,23,24,2,Fall2018
2906,NE Prescott & 97th,4769,E,OP,7,1,8,1,Fall2018
2907,NE Prescott & 99th,4770,E,NS,4,3,7,2,Fall2018
96,12600 Block NE Prescott Dr,4772,E,OP,1,7,8,1,Fall2018
2908,NE Prescott Dr & 125th Pl,4773,W,NS,11,0,11,1,Fall2018
2915,NE Prescott Dr & 129th Pl,4774,E,NS,3,10,13,0,Fall2018
2916,NE Prescott Dr & 129th Pl,4775,W,OP,8,0,8,0,Fall2018
2917,NE Prescott Dr & 131st Pl,4776,E,NS,2,12,14,4,Fall2018
2918,NE Prescott Dr & 131st Pl,4777,W,NS,14,0,14,5,Fall2018
2919,NE Prescott Dr & 132nd Pl,4778,W,OP,22,0,22,1,Fall2018
2920,NE Prescott Dr & 133rd,4779,E,NS,1,14,15,5,Fall2018
3669,Railroad & 7th,4784,N,NS,3,10,13,0,Fall2018
3524,NW Thurman & 22nd,4788,W,NS,0,11,11,1,Fall2018
6979,SW Ravensview & Terrace,4799,E,NS,3,0,3,0,Fall2018
6980,SW Redondo & Santa Monica,4801,S,OP,0,2,2,0,Fall2018
2921,NE Regents & 26th,4811,E,NS,1,5,6,0,Fall2018
2922,NE Regents & Ridgewood Dr,4812,W,NS,5,1,6,0,Fall2018
5326,SE Rex & 28th,4813,W,NS,6,1,7,0,Fall2018
5327,SE Rex & 32nd,4816,E,NS,2,16,18,0,Fall2018
1603,N Richmond & Syracuse,4817,N,NS,15,44,59,12,Fall2018
1604,N Richmond & Syracuse,4818,S,NS,184,183,367,93,Fall2018
94,12500 Block SE River Rd,4819,N,AT,8,2,10,0,Fall2018
95,12500 Block SE River Rd,4820,S,AT,1,5,6,0,Fall2018
97,12600 Block SE River Rd,4821,S,OP,1,6,7,0,Fall2018
149,14000 Block SE River Rd,4822,N,AT,1,0,1,0,Fall2018
159,14100 Block SE River Rd,4823,S,AT,0,1,1,0,Fall2018
233,17300 Block SE River Rd,4824,S,AT,0,2,2,0,Fall2018
5328,SE River Rd & Anspach,4831,N,NS,1,0,1,0,Fall2018
5329,SE River Rd & Anspach,4832,S,OP,1,1,2,0,Fall2018
5330,SE River Rd & Boardman,4833,N,NS,2,0,2,0,Fall2018
5331,SE River Rd & Boardman,4834,S,FS,0,3,3,0,Fall2018
5332,SE River Rd & Britton,4835,N,OP,3,0,3,0,Fall2018
5333,SE River Rd & Britton,4836,S,NS,0,3,3,0,Fall2018
5334,SE River Rd & Concord,4837,N,NS,1,0,1,0,Fall2018
5335,SE River Rd & Concord,4838,S,OP,0,2,2,0,Fall2018
5336,SE River Rd & Cooke,4839,S,FS,0,1,1,0,Fall2018
5338,SE River Rd & Courtney,4840,N,NS,2,3,5,0,Fall2018
5339,SE River Rd & Courtney,4841,S,NS,5,2,7,0,Fall2018
5354,SE River Rd & Laurelwood,4844,N,OP,2,0,2,0,Fall2018
5340,SE River Rd & Evergreen,4846,N,NS,6,2,8,1,Fall2018
5341,SE River Rd & Evergreen,4847,S,OP,2,8,10,0,Fall2018
5342,SE River Rd & Hull Ave,4849,N,NS,1,0,1,0,Fall2018
5343,SE River Rd & Hull Ave,4850,S,FS,0,0,0,0,Fall2018
5344,SE River Rd & Jennings,4851,N,NS,2,1,3,0,Fall2018
5345,SE River Rd & Jennings,4852,S,NS,0,1,1,0,Fall2018
5346,SE River Rd & Juniper Dr,4853,N,OP,1,1,2,0,Fall2018
5353,SE River Rd & Juniper Dr,4854,S,NS,1,1,2,0,Fall2018
5355,SE River Rd & Maple,4857,N,NS,2,2,4,0,Fall2018
5356,SE River Rd & Maple,4858,S,FS,2,2,4,0,Fall2018
5357,SE River Rd & Meldrum,4860,N,NS,2,0,2,0,Fall2018
5358,SE River Rd & Meldrum,4861,S,NS,0,2,2,0,Fall2018
5359,SE River Rd & Mulberry,4862,N,OP,1,0,1,3,Fall2018
5360,SE River Rd & Mulberry,4863,S,FS,1,1,2,2,Fall2018
5361,SE River Rd & Naef,4864,N,FS,2,0,2,0,Fall2018
5362,SE River Rd & Oak Grove,4865,N,NS,18,7,25,9,Fall2018
5363,SE River Rd & Oak Grove,4866,S,FS,8,14,22,9,Fall2018
5364,SE River Rd & Parkview Circle,4867,N,NS,4,1,5,0,Fall2018
5365,SE River Rd & River Dr,4870,N,OP,2,1,3,0,Fall2018
5366,SE River Rd & River Dr,4871,S,NS,0,1,1,0,Fall2018
5367,SE River Rd & River Forest,4874,S,FS,3,3,6,0,Fall2018
5368,SE River Rd & River Glen Ct,4875,N,OP,0,0,0,0,Fall2018
5369,SE River Rd & River Glen Ct,4876,S,FS,0,0,0,0,Fall2018
5337,SE River Rd & Cooke,4878,N,OP,1,0,1,0,Fall2018
5370,SE River Rd & Roethe,4879,N,NS,1,0,1,0,Fall2018
5371,SE River Rd & Roethe,4880,S,OP,0,1,1,0,Fall2018
5372,SE River Rd & Rogers,4881,N,NS,0,0,0,0,Fall2018
5373,SE River Rd & Rosebrier,4883,N,NS,1,1,2,0,Fall2018
5374,SE River Rd & Rosebrier,4884,S,OP,0,1,1,0,Fall2018
5375,SE River Rd & Swain,4888,N,FS,4,0,4,0,Fall2018
5376,SE River Rd & Swain,4889,S,OP,0,3,3,0,Fall2018
5377,SE River Rd & Torbank,4891,N,NS,5,2,7,0,Fall2018
5379,SE River Rd & Wren,4892,N,NS,3,2,5,1,Fall2018
6982,SW Riverside & Briarwood,4894,S,OP,0,3,3,0,Fall2018
6983,SW Riverside & Briarwood,4895,N,NS,4,0,4,0,Fall2018
6984,SW Riverside & Elk Rock,4896,N,FS,1,0,1,0,Fall2018
6985,SW Riverside & Greenwood,4897,N,OP,3,1,4,0,Fall2018
6981,SW Riverside & Breyman,4898,S,NS,1,3,4,0,Fall2018
6986,SW Riverside & Midvale,4899,S,FS,0,1,1,0,Fall2018
6987,SW Riverside & Military,4900,S,NS,0,3,3,0,Fall2018
6988,SW Riverside & Military,4901,N,NS,3,1,4,0,Fall2018
6989,SW Riverside & Palatine Hill,4902,S,FS,0,1,1,0,Fall2018
6996,SW Riverside & Palatine Hill,4904,N,OP,1,0,1,0,Fall2018
6997,SW Riverside & Radcliffe,4905,S,FS,0,2,2,0,Fall2018
6998,SW Riverside & Riverdale,4906,S,NS,1,3,4,0,Fall2018
6999,SW Riverside & Riverdale,4908,N,OP,4,1,5,0,Fall2018
7000,SW Riverside & Riverwood,4909,S,OP,0,0,0,0,Fall2018
7001,SW Riverside & Riverwood,4910,N,NS,0,0,0,0,Fall2018
1608,N Riverside Way & 33rd Dr,4912,E,NS,0,13,13,0,Fall2018
5380,SE Roots & 79th,4934,W,FS,0,0,0,0,Fall2018
5383,SE Roots & Hearthwood Dr,4935,E,NS,1,2,3,1,Fall2018
5384,SE Roots & Johnson,4937,W,NS,3,1,4,0,Fall2018
5385,SE Roots & Lark,4938,W,NS,2,2,4,1,Fall2018
5386,SE Roots & Rickshire,4939,E,OP,0,0,0,0,Fall2018
5387,SE Roots & Rickshire,4941,W,NS,0,0,0,0,Fall2018
5630,SE Webster & Roots,4943,N,FS,1,1,2,2,Fall2018
5381,SE Roots & 79th,4945,E,NS,0,0,0,0,Fall2018
5382,SE Roots & 81st,4946,E,FS,2,1,3,2,Fall2018
133,13600 Block NE Rose Parkway,4955,E,AT,1,2,3,0,Fall2018
2924,NE Rose Parkway & 141st,4958,E,NS,2,1,3,0,Fall2018
2925,NE Rose Parkway & 143rd,4960,E,OP,2,5,7,1,Fall2018
3680,Ross Island Bridge,4964,E,AT,19,15,34,6,Fall2018
2930,NE Sacramento & 142nd,4979,E,NS,1,1,2,0,Fall2018
2931,NE Sacramento & 142nd,4980,W,FS,0,0,0,0,Fall2018
2932,NE Sacramento & 146th Dr,4982,W,NS,2,0,2,0,Fall2018
2934,NE Sacramento & Brazee Ct,4984,W,NS,1,0,1,0,Fall2018
2926,NE Sacramento & 132nd,4987,W,NS,5,0,5,3,Fall2018
2927,NE Sacramento & 134th Pl,4988,E,NS,0,1,1,0,Fall2018
2928,NE Sacramento & 138th Pl,4990,E,NS,0,3,3,2,Fall2018
2929,NE Sacramento & 138th Pl,4991,W,NS,5,0,5,0,Fall2018
170,14600 Block NE Sacramento,4993,E,OP,5,3,8,0,Fall2018
2933,NE Sacramento & 148th,4994,E,NS,0,0,0,0,Fall2018
653,7800 Block SW Sagert,4999,E,AT,0,4,4,0,Fall2018
7014,SW Sagert & Wampanoag,5001,E,FS,0,12,12,1,Fall2018
7005,SW Sagert & 70th,5002,E,FS,0,24,24,0,Fall2018
7006,SW Sagert & 72nd,5003,E,FS,0,9,9,0,Fall2018
7008,SW Sagert & 86th,5004,E,NS,4,3,7,0,Fall2018
7020,SW Salmon & 19th,5006,E,FS,2,15,17,0,Fall2018
7024,SW Salmon & Park,5007,E,NS,106,92,198,31,Fall2018
7015,SW Salmon & 10th,5009,E,NS,96,52,148,43,Fall2018
7016,SW Salmon & 12th,5012,E,FS,68,75,143,70,Fall2018
7017,SW Salmon & 14th,5014,E,NS,57,83,140,11,Fall2018
7018,SW Salmon & 16th,5016,E,OP,2,71,73,0,Fall2018
7021,SW Salmon & 20th,5018,W,FS,4,4,8,0,Fall2018
7022,SW Salmon & 20th,5019,E,NS,2,2,4,0,Fall2018
7023,SW Salmon & 5th,5020,E,NS,491,488,979,143,Fall2018
3219,NW Barnes & Saltzman,5025,S,FS,43,12,55,3,Fall2018
7025,SW Sam Jackson Pk & Campus Dr,5027,E,NS,84,25,109,6,Fall2018
7026,SW Sam Jackson Pk & OHSU,5028,E,AT,566,328,894,89,Fall2018
7027,SW Sam Jackson Pk & US Veterans,5032,E,FS,433,519,952,65,Fall2018
2937,NE San Rafael & 125th,5033,E,FS,1,1,2,0,Fall2018
2938,NE San Rafael & 125th,5034,W,FS,1,1,2,0,Fall2018
2935,NE San Rafael & 122nd,5035,E,FS,6,4,10,6,Fall2018
2936,NE San Rafael & 122nd,5036,W,NS,2,8,10,2,Fall2018
2939,NE San Rafael & 128th,5037,E,OP,0,1,1,0,Fall2018
2940,NE San Rafael & 132nd,5039,E,NS,0,2,2,0,Fall2018
3053,NE Sandy & Flanders,5044,E,NS,38,66,104,18,Fall2018
3054,NE Sandy & Fremont ,5045,E,NS,18,24,42,19,Fall2018
3056,NE Sandy & Grotto ,5046,E,AT,6,15,21,5,Fall2018
3057,NE Sandy & Imperial ,5048,E,FS,6,17,23,30,Fall2018
3058,NE Sandy & Lawrence,5049,E,FS,5,21,26,5,Fall2018
3059,NE Sandy & Parkrose Transit Center,5050,W,AT,0,335,335,0,Fall2018
3060,NE Sandy & Prescott ,5051,E,FS,3,33,36,8,Fall2018
3061,NE Sandy & Prescott ,5052,W,FS,14,4,18,4,Fall2018
3062,NE Sandy & Sacramento,5054,E,FS,5,24,29,1,Fall2018
2970,NE Sandy & 14th,5058,W,NS,50,29,79,8,Fall2018
2981,NE Sandy & 16th,5060,W,NS,82,40,122,19,Fall2018
2987,NE Sandy & 18th,5061,E,NS,65,87,152,60,Fall2018
2988,NE Sandy & 18th,5062,W,FS,84,57,141,81,Fall2018
2993,NE Sandy & 20th,5063,W,NS,100,58,158,27,Fall2018
2996,NE Sandy & 24th,5066,E,FS,47,82,129,13,Fall2018
2997,NE Sandy & 24th,5067,W,NS,58,33,91,5,Fall2018
2998,NE Sandy & 26th,5068,W,FS,11,7,18,3,Fall2018
2999,NE Sandy & 28th,5069,W,NS,57,50,107,14,Fall2018
3000,NE Sandy & 28th,5070,E,NS,42,63,105,16,Fall2018
3001,NE Sandy & 31st,5076,E,FS,18,39,57,8,Fall2018
3002,NE Sandy & 31st,5077,W,FS,28,19,47,6,Fall2018
3003,NE Sandy & 33rd,5079,E,FS,39,68,107,30,Fall2018
3004,NE Sandy & 33rd,5080,W,NS,65,38,103,28,Fall2018
3005,NE Sandy & 35th,5081,W,FS,19,10,29,18,Fall2018
3007,NE Sandy & 42nd,5087,E,FS,163,216,379,97,Fall2018
3009,NE Sandy & 44th,5091,E,FS,33,25,58,19,Fall2018
3011,NE Sandy & 47th,5093,W,NS,50,13,63,9,Fall2018
3012,NE Sandy & 47th,5094,E,FS,20,45,65,9,Fall2018
3013,NE Sandy & 50th,5097,E,FS,8,28,36,6,Fall2018
3014,NE Sandy & 50th,5098,W,FS,31,8,39,4,Fall2018
3021,NE Sandy & 52nd,5100,W,FS,24,7,31,3,Fall2018
3022,NE Sandy & 54th,5102,E,OP,6,40,46,1,Fall2018
3023,NE Sandy & 54th,5103,W,NS,40,8,48,1,Fall2018
3024,NE Sandy & 57th,5104,E,NS,20,125,145,71,Fall2018
3025,NE Sandy & 57th,5105,W,NS,107,29,136,82,Fall2018
3026,NE Sandy & 59th,5107,W,NS,21,7,28,10,Fall2018
3027,NE Sandy & 60th,5110,E,FS,7,25,32,8,Fall2018
3028,NE Sandy & 62nd,5112,E,FS,9,41,50,5,Fall2018
3029,NE Sandy & 62nd,5113,W,NS,30,7,37,5,Fall2018
3030,NE Sandy & 64th,5114,W,NS,35,5,40,1,Fall2018
3031,NE Sandy & 65th,5115,E,NS,5,22,27,1,Fall2018
3032,NE Sandy & 67th,5118,E,NS,5,54,59,1,Fall2018
3033,NE Sandy & 67th,5119,W,NS,42,5,47,2,Fall2018
3034,NE Sandy & 69th,5122,W,OP,79,35,114,37,Fall2018
3035,NE Sandy & 70th,5123,E,FS,32,110,142,61,Fall2018
3055,NE Sandy & Fremont ,5125,W,FS,55,26,81,48,Fall2018
3036,NE Sandy & 74th,5127,W,NS,34,11,45,9,Fall2018
3038,NE Sandy & 77th,5132,E,NS,2,34,36,1,Fall2018
3039,NE Sandy & 77th,5133,W,NS,33,2,35,3,Fall2018
3040,NE Sandy & 79th,5135,E,FS,7,45,52,6,Fall2018
3041,NE Sandy & 79th,5136,W,FS,49,9,58,3,Fall2018
3042,NE Sandy & 82nd,5138,E,FS,82,140,222,71,Fall2018
3043,NE Sandy & 82nd,5139,W,NS,147,94,241,74,Fall2018
3044,NE Sandy & 86th,5140,W,FS,23,5,28,3,Fall2018
3046,NE Sandy & 88th,5144,W,FS,21,5,26,15,Fall2018
3047,NE Sandy & 91st,5145,W,NS,22,4,26,2,Fall2018
3048,NE Sandy & 92nd,5146,E,NS,1,10,11,3,Fall2018
352,2500 Block of NE Saratoga,5148,W,AT,101,95,196,28,Fall2018
3063,NE Saratoga & Dekum,5150,S,NS,10,1,11,1,Fall2018
530,4900 Block SW Scholls Ferry,5152,W,AT,2,17,19,1,Fall2018
538,5000 Block SW Scholls Ferry,5153,W,AT,16,37,53,3,Fall2018
561,5900 Block SW Scholls Ferry (Crosswalk),5155,S,OP,0,2,2,0,Fall2018
562,5900 Block SW Scholls Ferry (Crosswalk),5156,N,AT,2,1,3,0,Fall2018
607,6700 Block SW Scholls Ferry,5157,S,AT,14,32,46,1,Fall2018
608,6700 Block SW Scholls Ferry,5158,N,AT,12,9,21,1,Fall2018
650,7700 Block SW Scholls Ferry,5159,S,AT,3,9,12,13,Fall2018
680,8600 Block SW Scholls Ferry,5160,N,AT,21,5,26,3,Fall2018
681,8600 Block SW Scholls Ferry,5161,S,OP,3,33,36,2,Fall2018
7049,SW Scholls Ferry & Allen,5162,N,FS,31,12,43,1,Fall2018
7052,SW Scholls Ferry & Cascade,5164,S,FS,6,7,13,0,Fall2018
7053,SW Scholls Ferry & Conestoga,5165,E,OP,23,23,46,5,Fall2018
7054,SW Scholls Ferry & Conestoga,5166,W,FS,19,20,39,5,Fall2018
7055,SW Scholls Ferry & Crestwood,5167,S,FS,0,5,5,0,Fall2018
7056,SW Scholls Ferry & Crestwood,5168,N,OP,3,0,3,0,Fall2018
7057,SW Scholls Ferry & Crystal,5169,S,NS,1,4,5,0,Fall2018
7058,SW Scholls Ferry & Crystal,5170,N,OP,5,3,8,14,Fall2018
7067,SW Scholls Ferry & Merry,5171,S,OP,3,17,20,0,Fall2018
7061,SW Scholls Ferry & Dogwood Lane,5172,W,NS,0,0,0,0,Fall2018
7062,SW Scholls Ferry & Eagle,5173,N,FS,5,1,6,11,Fall2018
7063,SW Scholls Ferry & Heather,5175,N,FS,24,7,31,4,Fall2018
7064,SW Scholls Ferry & Heather,5176,S,FS,7,17,24,5,Fall2018
7065,SW Scholls Ferry & Marjorie,5180,S,NS,2,12,14,1,Fall2018
7066,SW Scholls Ferry & Marjorie,5181,N,OP,13,4,17,2,Fall2018
7068,SW Scholls Ferry & Merry,5182,N,NS,21,4,25,0,Fall2018
7050,SW Scholls Ferry & BH Hwy,5184,W,FS,19,56,75,9,Fall2018
7069,SW Scholls Ferry & Montclair,5185,E,NS,1,2,3,0,Fall2018
7083,SW Scholls Ferry & Stephen Lane,5186,E,NS,9,7,16,0,Fall2018
7072,SW Scholls Ferry & Nicol,5187,E,FS,13,9,22,0,Fall2018
7073,SW Scholls Ferry & Nicol,5188,W,OP,8,13,21,0,Fall2018
7074,SW Scholls Ferry & Nimbus,5189,W,FS,28,30,58,11,Fall2018
7075,SW Scholls Ferry & Nimbus,5190,E,FS,26,33,59,13,Fall2018
541,5200 Block SW Scholls Ferry,5192,W,AT,3,3,6,0,Fall2018
539,5100 Block SW Scholls Ferry,5193,E,AT,34,17,51,2,Fall2018
502,4400 Block SW Scholls Ferry,5194,N,OP,1,0,1,0,Fall2018
7079,SW Scholls Ferry & Seymour,5195,S,OP,0,0,0,0,Fall2018
7080,SW Scholls Ferry & Seymour,5196,N,FS,0,0,0,0,Fall2018
7081,SW Scholls Ferry & Springwood,5197,E,FS,16,8,24,0,Fall2018
610,6800 Block SW Scholls Ferry,5198,S,AT,0,0,0,0,Fall2018
503,4400 Block SW Scholls Ferry,5199,S,AT,0,0,0,0,Fall2018
7035,SW Scholls Ferry & 86th,5200,S,OP,0,2,2,0,Fall2018
7036,SW Scholls Ferry & 86th,5201,N,FS,1,0,1,0,Fall2018
7037,SW Scholls Ferry & 88th,5202,W,OP,0,1,1,0,Fall2018
7038,SW Scholls Ferry & 88th,5203,E,FS,1,0,1,0,Fall2018
7039,SW Scholls Ferry & 90th,5204,E,NS,14,1,15,0,Fall2018
7040,SW Scholls Ferry & 90th,5205,W,OP,2,13,15,0,Fall2018
7041,SW Scholls Ferry & 92nd,5206,E,FS,12,1,13,0,Fall2018
7042,SW Scholls Ferry & 92nd,5207,W,FS,3,30,33,0,Fall2018
7086,SW Shattuck & 60th,5221,N,NS,5,6,11,0,Fall2018
7087,SW Shattuck & 63rd,5222,E,FS,0,1,1,0,Fall2018
3082,NE Shaver & 135th,5223,E,OP,4,15,19,7,Fall2018
3064,NE Shaver & 102nd ,5225,W,NS,4,4,8,0,Fall2018
3065,NE Shaver & 105th ,5226,E,NS,1,8,9,2,Fall2018
3066,NE Shaver & 105th ,5227,W,NS,9,1,10,1,Fall2018
3067,NE Shaver & 109th ,5228,E,NS,1,11,12,6,Fall2018
3074,NE Shaver & 109th,5229,W,NS,10,1,11,9,Fall2018
3075,NE Shaver & 112th,5230,E,NS,1,5,6,2,Fall2018
3076,NE Shaver & 112th,5231,W,NS,5,1,6,1,Fall2018
3077,NE Shaver & 114th,5232,E,NS,0,6,6,0,Fall2018
3079,NE Shaver & 122nd,5234,E,NS,15,11,26,11,Fall2018
3080,NE Shaver & 122nd,5235,W,NS,13,12,25,19,Fall2018
3081,NE Shaver & 134th,5236,W,OP,0,0,0,0,Fall2018
3083,NE Shaver & 135th,5237,W,FS,6,0,6,0,Fall2018
3084,NE Shaver & 138th,5238,W,FS,10,1,11,2,Fall2018
7088,SW Sheridan & 4th,5239,E,FS,20,9,29,1,Fall2018
7089,SW Sherwood & Sherwood Middle School,5244,N,AT,2,0,2,2,Fall2018
311,21900 Block N Sherwood Blvd,5245,S,AT,0,3,3,6,Fall2018
1627,N Sherwood Blvd & NW Gleneagle,5246,S,NS,0,7,7,1,Fall2018
1625,N Sherwood & SW 10th,5247,N,OP,7,0,7,0,Fall2018
7090,SW Sherwood Blvd & NW 12th St,5248,S,NS,1,12,13,8,Fall2018
1626,N Sherwood & SW Century,5249,N,NS,9,1,10,0,Fall2018
3088,NE Skidmore & 122nd,5250,E,NS,67,20,87,7,Fall2018
3089,NE Skidmore & 29th,5253,E,NS,30,1,31,0,Fall2018
227,1700 Block South Shore,5285,W,AT,0,0,0,0,Fall2018
244,1800 Block South Shore (Park & Ride),5286,W,AT,0,1,1,0,Fall2018
245,1800 Block South Shore (Park & Ride),5287,E,OP,1,1,2,0,Fall2018
351,2500 Block South Shore,5288,W,AT,0,0,0,0,Fall2018
467,3800 Block South Shore,5289,W,AT,0,0,0,0,Fall2018
489,4100 Block South Shore,5290,W,AT,0,0,0,0,Fall2018
490,4100 Block South Shore,5291,S,OP,0,0,0,0,Fall2018
499,4300 Block South Shore,5292,N,AT,0,0,0,0,Fall2018
7426,South Shore & Blue Heron,5293,N,FS,0,0,0,0,Fall2018
7428,South Shore & Canyon,5294,E,FS,1,0,1,0,Fall2018
7429,South Shore & Cedar Ct,5295,W,FS,0,2,2,0,Fall2018
7433,South Shore & Fernwood,5296,W,OP,1,1,2,0,Fall2018
7430,South Shore & Cedar Rd,5297,W,OP,0,1,1,18,Fall2018
7432,South Shore & Edgecliff,5298,W,FS,0,0,0,0,Fall2018
7434,South Shore & Fernwood,5299,E,NS,0,1,1,0,Fall2018
7435,South Shore & Greenbrier,5300,W,FS,0,0,0,0,Fall2018
7436,South Shore & Greentree,5301,W,OP,1,2,3,0,Fall2018
7437,South Shore & Greentree,5302,E,NS,2,0,2,0,Fall2018
7438,South Shore & Kelok,5303,E,NS,1,0,1,0,Fall2018
7439,South Shore & Lakeridge,5304,E,FS,2,0,2,0,Fall2018
1170,Lakeview & South Shore,5305,E,NS,0,0,0,0,Fall2018
7440,South Shore & Maple,5306,W,FS,0,1,1,0,Fall2018
1221,McVey & Parrish,5307,E,NS,4,1,5,0,Fall2018
7441,South Shore & Patton,5309,W,NS,1,6,7,0,Fall2018
7427,South Shore & Canal Circle,5311,E,FS,0,0,0,0,Fall2018
5388,SE Sparrow & 22nd,5312,E,FS,0,0,0,0,Fall2018
7091,SW Spring & Vista,5313,W,NS,6,1,7,0,Fall2018
7092,SW Spring Garden & 11th,5314,E,NS,1,6,7,0,Fall2018
7093,SW Spring Garden & 14th,5315,E,NS,0,5,5,0,Fall2018
7094,SW Spring Garden & 14th,5316,W,NS,7,0,7,0,Fall2018
7095,SW Spring Garden & 17th,5317,E,NS,1,12,13,0,Fall2018
7102,SW Spring Garden & 17th,5318,W,NS,17,1,18,0,Fall2018
5798,SW 19th & Spring Garden,5319,N,FS,1,1,2,0,Fall2018
603,6600 Block NW St Helens,5328,S,AT,1,1,2,0,Fall2018
604,6600 Block NW St Helens,5329,N,OP,0,1,1,0,Fall2018
609,6800 Block NW St Helens,5330,N,OP,1,1,2,0,Fall2018
3511,NW St Helens & Milepost 8,5332,N,AT,0,0,0,0,Fall2018
3512,NW St Helens & Milepost 8,5333,S,FS,0,0,0,0,Fall2018
3491,NW St Helens & Bridge,5336,S,NS,3,0,3,0,Fall2018
3498,NW St Helens & Doane,5338,N,FS,0,2,2,0,Fall2018
3499,NW St Helens & Doane,5339,S,OP,2,0,2,0,Fall2018
58,11400 Block NW St Helens,5341,N,AT,1,2,3,0,Fall2018
59,11400 Block NW St Helens,5342,S,OP,1,0,1,0,Fall2018
3502,NW St Helens & Harbor,5344,S,NS,1,0,1,0,Fall2018
3505,NW St Helens & Hoge,5345,N,OP,0,2,2,0,Fall2018
3506,NW St Helens & Hoge,5346,S,FS,2,0,2,0,Fall2018
713,9400 Block NW St Helens,5350,N,AT,0,0,0,0,Fall2018
3500,NW St Helens & Front,5352,N,NS,1,6,7,0,Fall2018
3501,NW St Helens & Front,5353,S,OP,6,1,7,0,Fall2018
3482,NW St Helens & 105th,5354,N,FS,0,1,1,0,Fall2018
3483,NW St Helens & 105th,5355,S,FS,1,0,1,0,Fall2018
3484,NW St Helens & 107th,5356,N,NS,0,7,7,0,Fall2018
3485,NW St Helens & 107th,5357,S,OP,8,0,8,4,Fall2018
3486,NW St Helens & 109th,5358,N,NS,0,1,1,0,Fall2018
3487,NW St Helens & 111th,5359,N,OP,2,3,5,0,Fall2018
3489,NW St Helens & 56th,5361,N,OP,1,0,1,0,Fall2018
3490,NW St Helens & 56th,5362,S,NS,1,0,1,0,Fall2018
1630,N St Louis & New York,5373,E,NS,7,3,10,0,Fall2018
1631,N St Louis & Seneca,5374,W,NS,3,13,16,17,Fall2018
1632,N St Louis & Smith,5375,W,NS,2,13,15,1,Fall2018
1633,N St Louis & Smith,5376,E,NS,10,2,12,2,Fall2018
7447,St Vincent Hospital Dr & Barnes,5377,S,NS,10,6,16,4,Fall2018
7448,St Vincent Hospital East Pavilion,5378,W,AT,78,89,167,55,Fall2018
7449,St Vincent Hospital Main Stop,5379,W,AT,68,63,131,38,Fall2018
3090,NE Stanton & 117th,5384,W,NS,2,0,2,0,Fall2018
3091,NE Stanton & 121st,5385,W,NS,2,0,2,0,Fall2018
3092,NE Stanton & 122nd,5386,E,NS,0,4,4,0,Fall2018
5438,SE Stark & 182nd,5390,W,OP,60,65,125,20,Fall2018
305,21000 Block SE Stark,5391,W,AT,18,5,23,19,Fall2018
306,21000 Block SE Stark,5392,E,NS,5,18,23,13,Fall2018
5461,SE Stark & 215th,5393,W,OP,14,6,20,1,Fall2018
708,9200 Block SE Stark,5394,W,AT,40,13,53,5,Fall2018
5412,SE Stark & 139th,5395,W,FS,56,25,81,22,Fall2018
5480,SE Stark & NE Hale ,5397,E,NS,16,86,102,37,Fall2018
5486,SE Stark & SW McGinnis ,5398,W,FS,57,14,71,29,Fall2018
5481,SE Stark & NE Kelly ,5404,E,NS,3,5,8,3,Fall2018
5467,SE Stark & 238th,5407,W,NS,34,9,43,9,Fall2018
5476,SE Stark & Mt Hood Comm College Entrance,5408,E,FS,0,1,1,0,Fall2018
5485,SE Stark & SW Corbeth Lane,5409,W,NS,2,0,2,0,Fall2018
5475,SE Stark & Medical Center,5410,E,NS,29,39,68,26,Fall2018
5483,SE Stark & NE Rene ,5411,W,OP,24,10,34,5,Fall2018
5389,SE Stark & 105th,5414,W,FS,36,59,95,22,Fall2018
5390,SE Stark & 108th,5415,W,NS,27,46,73,14,Fall2018
5391,SE Stark & 111th,5416,E,NS,14,13,27,27,Fall2018
5392,SE Stark & 111th,5417,W,NS,13,8,21,26,Fall2018
5393,SE Stark & 113th,5418,E,FS,6,16,22,4,Fall2018
5394,SE Stark & 113th,5419,W,NS,15,6,21,4,Fall2018
5395,SE Stark & 117th,5421,E,NS,9,27,36,3,Fall2018
5396,SE Stark & 117th,5422,W,FS,31,10,41,9,Fall2018
5397,SE Stark & 119th,5423,E,NS,5,25,30,16,Fall2018
5398,SE Stark & 119th,5424,W,NS,19,10,29,4,Fall2018
5399,SE Stark & 122nd,5425,E,FS,161,128,289,73,Fall2018
5406,SE Stark & 122nd,5426,W,NS,133,180,313,70,Fall2018
5408,SE Stark & 130th,5431,E,FS,37,59,96,12,Fall2018
5410,SE Stark & 133rd,5432,E,OP,38,58,96,20,Fall2018
5411,SE Stark & 133rd,5433,W,FS,69,46,115,13,Fall2018
5413,SE Stark & 139th,5436,E,FS,26,61,87,18,Fall2018
5415,SE Stark & 143rd,5439,E,OP,15,49,64,6,Fall2018
5416,SE Stark & 146th,5442,W,FS,20,13,33,3,Fall2018
5417,SE Stark & 148th,5443,W,NS,57,37,94,19,Fall2018
5418,SE Stark & 148th,5444,E,FS,58,71,129,23,Fall2018
5419,SE Stark & 151st,5445,E,FS,6,17,23,1,Fall2018
5420,SE Stark & 151st,5446,W,NS,18,9,27,1,Fall2018
5421,SE Stark & 155th,5448,E,FS,7,29,36,16,Fall2018
5423,SE Stark & 160th,5452,E,FS,38,106,144,44,Fall2018
5424,SE Stark & 160th,5453,W,FS,73,32,105,26,Fall2018
5425,SE Stark & 162nd,5454,E,FS,74,78,152,78,Fall2018
5426,SE Stark & 162nd,5455,W,NS,110,68,178,57,Fall2018
5427,SE Stark & 165th,5457,W,FS,17,15,32,5,Fall2018
5428,SE Stark & 166th Pl,5458,E,NS,17,24,41,3,Fall2018
5429,SE Stark & 167th,5459,W,NS,14,7,21,3,Fall2018
5432,SE Stark & 174th,5461,E,NS,23,46,69,14,Fall2018
5433,SE Stark & 174th,5462,W,OP,42,25,67,18,Fall2018
5434,SE Stark & 176th Pl,5463,E,NS,7,13,20,1,Fall2018
5435,SE Stark & 176th Pl,5464,W,OP,9,6,15,2,Fall2018
5436,SE Stark & 179th,5465,E,NS,17,44,61,20,Fall2018
5437,SE Stark & 179th,5466,W,OP,81,32,113,40,Fall2018
5439,SE Stark & 182nd,5467,E,NS,78,94,172,53,Fall2018
5440,SE Stark & 185th,5468,E,FS,19,23,42,10,Fall2018
5441,SE Stark & 185th,5469,W,NS,11,18,29,4,Fall2018
5444,SE Stark & 192nd,5471,E,OP,18,25,43,20,Fall2018
5445,SE Stark & 192nd,5472,W,NS,19,19,38,13,Fall2018
5446,SE Stark & 196th,5475,E,OP,16,24,40,15,Fall2018
5447,SE Stark & 197th Dr,5476,W,NS,12,9,21,2,Fall2018
5448,SE Stark & 199th,5477,E,NS,10,14,24,6,Fall2018
5449,SE Stark & 202nd,5478,E,FS,20,29,49,30,Fall2018
5450,SE Stark & 202nd,5479,W,FS,33,16,49,22,Fall2018
5451,SE Stark & 205th,5480,E,FS,13,16,29,2,Fall2018
5452,SE Stark & 205th Pl,5481,W,FS,27,15,42,20,Fall2018
5459,SE Stark & 212th,5484,W,OP,10,5,15,3,Fall2018
5462,SE Stark & 217th,5487,E,NS,14,24,38,6,Fall2018
5463,SE Stark & 217th,5488,W,OP,26,14,40,6,Fall2018
5464,SE Stark & 220th,5489,E,OP,4,15,19,2,Fall2018
5465,SE Stark & 223rd,5491,E,FS,57,67,124,26,Fall2018
5466,SE Stark & 223rd,5492,W,FS,63,64,127,34,Fall2018
5478,SE Stark & NE Cleveland ,5493,W,FS,15,7,22,3,Fall2018
5479,SE Stark & NE Cleveland ,5494,E,NS,7,15,22,6,Fall2018
5477,SE Stark & NE 242nd ,5495,E,FS,43,88,131,52,Fall2018
5469,SE Stark & 80th,5498,W,NS,49,8,57,5,Fall2018
5470,SE Stark & 82nd,5499,W,FS,131,76,207,58,Fall2018
5472,SE Stark & 88th,5502,W,NS,14,2,16,1,Fall2018
5473,SE Stark & 90th,5503,W,NS,31,6,37,3,Fall2018
1634,N State & B Ave,5505,N,FS,22,1,23,2,Fall2018
1635,N State & B Ave,5506,S,NS,1,37,38,2,Fall2018
1636,N State & D Ave,5507,S,FS,1,10,11,0,Fall2018
1643,N State & E Ave,5508,N,OP,6,0,6,0,Fall2018
1644,N State & Foothills,5509,N,FS,38,7,45,2,Fall2018
1645,N State & Foothills,5510,S,OP,5,23,28,1,Fall2018
3698,S State & Middlecrest,5511,S,NS,7,26,33,3,Fall2018
3699,S State & North Shore,5512,N,OP,14,7,21,3,Fall2018
1646,N State & North Shore,5513,S,NS,7,9,16,2,Fall2018
3700,S State & Wilbur,5514,N,NS,25,9,34,4,Fall2018
5489,SE Steele & 30th ,5515,E,OP,9,15,24,0,Fall2018
5490,SE Steele & 30th ,5516,W,FS,14,6,20,0,Fall2018
5488,SE Steele & 28th ,5517,W,NS,19,9,28,1,Fall2018
5491,SE Steele & 32nd ,5518,W,NS,16,2,18,0,Fall2018
5492,SE Steele & 33rd ,5519,E,OP,5,19,24,0,Fall2018
5494,SE Steele & 35th ,5520,E,NS,1,9,10,0,Fall2018
5493,SE Steele & 34th ,5521,W,NS,12,3,15,0,Fall2018
5495,SE Steele & 36th Pl ,5522,E,OP,1,4,5,0,Fall2018
5496,SE Steele & 36th Pl ,5523,W,FS,10,1,11,0,Fall2018
5513,SE Steele & Cesar Chavez Blvd,5524,E,NS,16,54,70,0,Fall2018
5514,SE Steele & Cesar Chavez Blvd,5525,W,NS,33,19,52,0,Fall2018
5497,SE Steele & 41st ,5526,E,NS,2,20,22,1,Fall2018
5498,SE Steele & 41st ,5527,W,NS,19,2,21,1,Fall2018
5499,SE Steele & 44th ,5529,E,NS,2,19,21,2,Fall2018
5500,SE Steele & 44th ,5530,W,NS,16,1,17,2,Fall2018
5502,SE Steele & 47th ,5531,E,FS,4,30,34,0,Fall2018
5503,SE Steele & 50th ,5532,E,NS,3,18,21,0,Fall2018
5504,SE Steele & 50th ,5533,W,FS,14,1,15,1,Fall2018
5505,SE Steele & 52nd ,5534,E,NS,13,49,62,0,Fall2018
5512,SE Steele & 52nd ,5535,W,FS,28,3,31,0,Fall2018
5518,SE Strawberry & Stanhelma,5536,W,FS,1,3,4,0,Fall2018
5516,SE Strawberry & Cason ,5537,E,NS,4,1,5,0,Fall2018
5517,SE Strawberry & Fragrance,5538,W,NS,1,1,2,0,Fall2018
5519,SE Strawberry & Stanhelma,5539,E,FS,2,1,3,0,Fall2018
5520,SE Strawberry & Stratford,5540,W,NS,1,5,6,0,Fall2018
5521,SE Strawberry & Webster,5541,W,NS,3,4,7,1,Fall2018
5522,SE Strawberry & Wiles Ct,5542,E,NS,1,1,2,0,Fall2018
5515,SE Strawberry & 82nd Dr,5543,E,NS,5,5,10,1,Fall2018
177,1500 Block SW Sunset Blvd,5552,N,AT,0,0,0,0,Fall2018
7116,SW Sunset Blvd & Boundary,5553,N,NS,0,1,1,0,Fall2018
7117,SW Sunset Blvd & Boundary,5554,S,NS,0,0,0,0,Fall2018
7118,SW Sunset Blvd & Dosch,5556,W,NS,0,1,1,0,Fall2018
7119,SW Sunset Blvd & Dosch,5557,E,FS,1,1,2,0,Fall2018
7120,SW Sunset Blvd & Dosch Park Ln,5558,E,FS,1,0,1,0,Fall2018
7121,SW Sunset Blvd & Mitchell,5562,W,OP,0,1,1,0,Fall2018
7122,SW Sunset Blvd & Mitchell,5563,E,FS,1,0,1,0,Fall2018
7123,SW Sunset Blvd & Richardson,5564,N,NS,0,0,0,0,Fall2018
7124,SW Sunset Blvd & Richardson,5565,S,FS,0,0,0,0,Fall2018
7105,SW Sunset Blvd & 18th Dr,5566,S,FS,1,0,1,0,Fall2018
7106,SW Sunset Blvd & 18th Dr,5567,N,FS,0,1,1,0,Fall2018
7107,SW Sunset Blvd & 19th,5568,N,FS,0,1,1,0,Fall2018
7108,SW Sunset Blvd & 25th,5569,S,OP,1,0,1,0,Fall2018
7109,SW Sunset Blvd & 26th,5570,E,FS,2,0,2,0,Fall2018
7110,SW Sunset Blvd & 26th Dr,5571,W,OP,0,1,1,0,Fall2018
7111,SW Sunset Blvd & 27th,5572,W,FS,0,1,1,0,Fall2018
7112,SW Sunset Blvd & 27th,5573,E,OP,1,0,1,0,Fall2018
7113,SW Sunset Blvd & 29th,5574,W,NS,0,0,0,0,Fall2018
7114,SW Sunset Blvd & 31st Dr,5575,W,OP,0,0,0,0,Fall2018
7115,SW Sunset Blvd & 31st Dr,5576,E,FS,0,0,0,0,Fall2018
7281,SW Tualatin Valley Hwy & 214th,5586,W,NS,31,28,59,1,Fall2018
5591,SE Tualatin Valley Hwy & Sunset Esplnd,5588,W,AT,66,55,121,40,Fall2018
7286,SW Tualatin Valley Hwy & Market Centre ,5590,E,OP,50,34,84,12,Fall2018
7283,SW Tualatin Valley Hwy & Aloha Villa ,5592,W,AT,4,10,14,0,Fall2018
256,18882-19040 SW Tualatin Valley Hwy,5593,E,AT,9,12,21,0,Fall2018
257,18882-19040 SW Tualatin Valley Hwy,5594,W,OP,21,22,43,0,Fall2018
7262,SW Tualatin Valley Hwy & 141st,5595,W,NS,14,7,21,0,Fall2018
7284,SW Tualatin Valley Hwy & Hocken ,5597,E,NS,20,55,75,12,Fall2018
5588,SE Tualatin Valley Hwy & Minter Bridge,5598,E,NS,106,149,255,79,Fall2018
7289,SW Tualatin Valley Hwy & Murray ,5599,W,FS,105,37,142,10,Fall2018
7290,SW Tualatin Valley Hwy & Murray ,5600,E,NS,24,97,121,10,Fall2018
7287,SW Tualatin Valley Hwy & Market Centre ,5601,W,AT,32,69,101,21,Fall2018
5589,SE Tualatin Valley Hwy & River Rd,5602,E,FS,24,26,50,7,Fall2018
7291,SW Tualatin Valley Hwy & St Marys Home ,5603,E,OP,6,9,15,2,Fall2018
7292,SW Tualatin Valley Hwy & St Marys Home ,5604,W,AT,3,7,10,0,Fall2018
5572,SE Tualatin Valley Hwy & 24th,5606,E,FS,34,23,57,17,Fall2018
5575,SE Tualatin Valley Hwy & 40th,5609,E,OP,3,5,8,0,Fall2018
5592,SE Tualatin Valley Hwy & Sunset Esplnd,5611,E,OP,71,72,143,68,Fall2018
5573,SE Tualatin Valley Hwy & 24th,5612,W,FS,39,78,117,75,Fall2018
5581,SE Tualatin Valley Hwy & Brookwood,5614,E,FS,59,49,108,28,Fall2018
5569,SE Tualatin Valley Hwy & 11th,5615,N,FS,21,41,62,4,Fall2018
5571,SE Tualatin Valley Hwy & 13th,5616,W,NS,28,30,58,8,Fall2018
7263,SW Tualatin Valley Hwy & 142nd,5617,E,NS,5,16,21,0,Fall2018
7266,SW Tualatin Valley Hwy & 160th,5618,E,FS,54,29,83,5,Fall2018
7288,SW Tualatin Valley Hwy & Millikan Blvd ,5619,W,NS,33,58,91,5,Fall2018
7267,SW Tualatin Valley Hwy & 170th,5620,E,FS,107,61,168,8,Fall2018
7268,SW Tualatin Valley Hwy & 170th,5621,W,FS,70,117,187,6,Fall2018
7269,SW Tualatin Valley Hwy & 174th,5622,W,NS,6,16,22,0,Fall2018
7270,SW Tualatin Valley Hwy & 174th,5623,E,OP,16,9,25,0,Fall2018
7271,SW Tualatin Valley Hwy & 178th,5624,E,OP,71,41,112,25,Fall2018
7272,SW Tualatin Valley Hwy & 178th,5625,W,FS,38,65,103,24,Fall2018
7273,SW Tualatin Valley Hwy & 185th,5628,E,FS,112,177,289,29,Fall2018
7274,SW Tualatin Valley Hwy & 185th,5629,W,FS,188,117,305,26,Fall2018
7275,SW Tualatin Valley Hwy & 192nd,5633,W,FS,22,28,50,2,Fall2018
7276,SW Tualatin Valley Hwy & 192nd,5634,E,OP,12,14,26,0,Fall2018
7277,SW Tualatin Valley Hwy & 198th,5635,W,FS,84,70,154,17,Fall2018
7279,SW Tualatin Valley Hwy & 209th,5637,E,NS,30,32,62,2,Fall2018
7280,SW Tualatin Valley Hwy & 209th,5638,W,NS,22,20,42,1,Fall2018
5585,SE Tualatin Valley Hwy & Cypress,5639,W,FS,132,91,223,48,Fall2018
7282,SW Tualatin Valley Hwy & 214th,5642,E,OP,12,14,26,0,Fall2018
5584,SE Tualatin Valley Hwy & Cornelius Pass,5643,E,FS,29,32,61,4,Fall2018
5580,SE Tualatin Valley Hwy & 75th,5644,W,NS,32,33,65,5,Fall2018
5578,SE Tualatin Valley Hwy & 67th,5650,W,FS,26,74,100,33,Fall2018
5579,SE Tualatin Valley Hwy & 67th (229th),5651,E,NS,38,21,59,13,Fall2018
5590,SE Tualatin Valley Hwy & SW 234th,5652,E,NS,104,109,213,52,Fall2018
5583,SE Tualatin Valley Hwy & Century,5653,W,NS,101,98,199,38,Fall2018
5586,SE Tualatin Valley Hwy & Imlay,5654,W,NS,10,13,23,4,Fall2018
5587,SE Tualatin Valley Hwy & Imlay,5655,E,OP,8,7,15,0,Fall2018
5553,SE Tacoma & 13th,5664,E,FS,6,41,47,1,Fall2018
5554,SE Tacoma & 13th,5665,W,FS,38,6,44,0,Fall2018
5555,SE Tacoma & 17th,5668,E,FS,6,21,27,0,Fall2018
5556,SE Tacoma & 17th,5669,W,FS,23,5,28,1,Fall2018
5557,SE Tacoma & 7th,5675,W,NS,21,2,23,1,Fall2018
5558,SE Tacoma & 7th,5676,E,FS,2,24,26,1,Fall2018
7125,SW Talbot & Patton,5679,E,FS,1,2,3,0,Fall2018
7126,SW Talbot & Patton,5680,W,NS,5,0,5,0,Fall2018
7129,SW Talbot Terrace & Greenway,5681,E,NS,0,0,0,0,Fall2018
7127,SW Talbot & Talbot Terrace,5682,N,FS,2,0,2,0,Fall2018
7190,SW Taylors Ferry & Dolph ,5687,S,FS,1,1,2,0,Fall2018
7193,SW Taylors Ferry & Marigold ,5688,N,FS,0,0,0,0,Fall2018
7194,SW Taylors Ferry & Marigold ,5689,S,NS,0,0,0,0,Fall2018
147,1400 Block SW Taylors Ferry,5690,E,AT,2,0,2,0,Fall2018
324,2200 Block SW Taylors Ferry,5691,E,AT,2,0,2,0,Fall2018
325,2200 Block SW Taylors Ferry,5692,W,AT,0,0,0,0,Fall2018
623,7100 Block SW Taylors Ferry,5693,W,OP,0,0,0,0,Fall2018
624,7100 Block SW Taylors Ferry,5694,E,AT,1,0,1,0,Fall2018
7184,SW Taylors Ferry & 78th Pl,5695,E,FS,2,0,2,0,Fall2018
7185,SW Taylors Ferry & 78th Pl,5696,W,NS,0,1,1,0,Fall2018
7188,SW Taylors Ferry & Capitol Hwy,5697,W,NS,13,2,15,0,Fall2018
7191,SW Taylors Ferry & Dolph ,5699,N,OP,2,0,2,0,Fall2018
7192,SW Taylors Ferry & Fulton Park Blvd,5700,S,NS,0,0,0,0,Fall2018
7196,SW Taylors Ferry & Riverview,5703,E,OP,0,0,0,0,Fall2018
7197,SW Taylors Ferry & Riverview,5704,S,AT,0,0,0,0,Fall2018
7198,SW Taylors Ferry & Riverview (2nd),5705,W,AT,0,0,0,0,Fall2018
7201,SW Taylors Ferry & Terwilliger,5706,E,NS,13,10,23,0,Fall2018
7137,SW Taylors Ferry & 10th,5707,E,NS,3,3,6,0,Fall2018
7138,SW Taylors Ferry & 10th,5708,W,NS,1,2,3,0,Fall2018
7139,SW Taylors Ferry & 11th,5709,W,NS,11,2,13,0,Fall2018
7140,SW Taylors Ferry & 11th,5710,E,NS,2,0,2,0,Fall2018
7199,SW Taylors Ferry & Taylors Ferry Ct,5711,W,OP,0,1,1,0,Fall2018
7200,SW Taylors Ferry & Taylors Ferry Ct,5712,E,FS,1,0,1,0,Fall2018
7141,SW Taylors Ferry & 17th,5713,W,FS,0,1,1,0,Fall2018
7142,SW Taylors Ferry & 17th,5714,E,OP,1,0,1,0,Fall2018
7143,SW Taylors Ferry & 19th,5715,W,FS,0,0,0,0,Fall2018
7144,SW Taylors Ferry & 19th,5716,E,OP,0,0,0,0,Fall2018
7156,SW Taylors Ferry & 2nd,5717,E,OP,1,0,1,0,Fall2018
7157,SW Taylors Ferry & 2nd,5718,W,NS,0,1,1,0,Fall2018
7145,SW Taylors Ferry & 23rd Dr,5719,S,FS,0,2,2,0,Fall2018
7146,SW Taylors Ferry & 26th,5720,W,NS,1,2,3,0,Fall2018
7147,SW Taylors Ferry & 26th,5721,E,FS,1,1,2,0,Fall2018
7148,SW Taylors Ferry & 28th,5722,W,FS,0,1,1,0,Fall2018
7155,SW Taylors Ferry & 28th,5723,E,OP,0,0,0,0,Fall2018
7158,SW Taylors Ferry & 30th,5724,W,FS,0,0,0,0,Fall2018
7159,SW Taylors Ferry & 30th,5725,E,OP,0,0,0,0,Fall2018
7160,SW Taylors Ferry & 46th,5726,W,FS,0,0,0,0,Fall2018
7161,SW Taylors Ferry & 46th,5727,E,OP,0,0,0,0,Fall2018
7162,SW Taylors Ferry & 48th,5728,W,NS,0,1,1,0,Fall2018
7163,SW Taylors Ferry & 48th,5729,E,NS,0,0,0,0,Fall2018
7164,SW Taylors Ferry & 49th,5730,W,NS,0,1,1,0,Fall2018
7165,SW Taylors Ferry & 52nd,5732,W,FS,0,1,1,0,Fall2018
7166,SW Taylors Ferry & 52nd,5733,E,FS,0,0,0,0,Fall2018
7167,SW Taylors Ferry & 53rd,5734,W,FS,0,1,1,0,Fall2018
7168,SW Taylors Ferry & 53rd,5735,E,FS,1,0,1,0,Fall2018
7169,SW Taylors Ferry & 55th,5736,W,NS,0,2,2,0,Fall2018
7170,SW Taylors Ferry & 55th,5737,E,FS,2,1,3,0,Fall2018
7171,SW Taylors Ferry & 57th,5738,W,OP,0,1,1,0,Fall2018
7172,SW Taylors Ferry & 57th,5739,E,NS,0,0,0,0,Fall2018
7173,SW Taylors Ferry & 60th,5740,W,OP,0,2,2,0,Fall2018
7174,SW Taylors Ferry & 60th,5741,E,NS,3,0,3,0,Fall2018
7175,SW Taylors Ferry & 62nd,5742,E,FS,4,1,5,0,Fall2018
7176,SW Taylors Ferry & 62nd,5743,W,NS,0,6,6,0,Fall2018
7177,SW Taylors Ferry & 65th,5745,E,FS,0,0,0,0,Fall2018
7178,SW Taylors Ferry & 66th,5746,E,FS,0,0,0,0,Fall2018
7179,SW Taylors Ferry & 69th,5747,W,OP,1,2,3,0,Fall2018
7180,SW Taylors Ferry & 69th,5748,E,FS,2,2,4,0,Fall2018
7186,SW Taylors Ferry & 7th,5749,W,NS,16,16,32,1,Fall2018
7181,SW Taylors Ferry & 74th,5752,E,FS,2,1,3,0,Fall2018
7187,SW Taylors Ferry & 80th,5754,W,NS,0,1,1,0,Fall2018
7236,SW Terwilliger & Maplecrest ,5779,E,NS,3,10,13,0,Fall2018
7216,SW Terwilliger & Alice ,5780,S,FS,0,4,4,0,Fall2018
7217,SW Terwilliger & Alice ,5781,N,OP,4,0,4,0,Fall2018
7218,SW Terwilliger & Bancroft ,5782,S,AT,0,0,0,0,Fall2018
7219,SW Terwilliger & Bancroft Terrace,5783,W,FS,0,0,0,0,Fall2018
7220,SW Terwilliger & Burlingame Terr,5785,S,FS,0,1,1,0,Fall2018
7221,SW Terwilliger & Caldew ,5786,N,OP,7,0,7,0,Fall2018
7222,SW Terwilliger & Caldew ,5787,S,FS,0,7,7,0,Fall2018
7224,SW Terwilliger & Capitol Hwy,5788,N,NS,8,0,8,0,Fall2018
7225,SW Terwilliger & Capitol Hwy,5789,S,NS,1,2,3,0,Fall2018
7226,SW Terwilliger & Carson ,5790,N,NS,4,6,10,0,Fall2018
7229,SW Terwilliger & Chestnut ,5791,N,NS,10,0,10,0,Fall2018
7230,SW Terwilliger & Chestnut ,5792,S,FS,0,7,7,0,Fall2018
727,9800 Block SW Terwilliger,5794,S,AT,1,4,5,0,Fall2018
7231,SW Terwilliger & Hamilton ,5795,E,FS,1,0,1,0,Fall2018
7232,SW Terwilliger & Hamilton Terrace,5796,N,FS,1,0,1,0,Fall2018
7233,SW Terwilliger & L&C Law School,5797,W,OP,5,0,5,0,Fall2018
7234,SW Terwilliger & Lobelia ,5798,N,NS,2,0,2,0,Fall2018
7235,SW Terwilliger & Lobelia ,5799,S,NS,0,3,3,0,Fall2018
7237,SW Terwilliger & Nebraska ,5800,N,FS,0,0,0,0,Fall2018
7238,SW Terwilliger & Primrose ,5801,N,NS,11,0,11,0,Fall2018
7239,SW Terwilliger & Primrose ,5802,S,FS,0,11,11,0,Fall2018
7240,SW Terwilliger & Ralston Dr ,5803,N,NS,1,0,1,0,Fall2018
7241,SW Terwilliger & Sam Jackson,5804,S,FS,23,6,29,1,Fall2018
7243,SW Terwilliger & Taylors Ferry,5806,N,NS,4,1,5,0,Fall2018
7244,SW Terwilliger & Taylors Ferry,5807,S,FS,1,7,8,0,Fall2018
7214,SW Terwilliger & 6th,5808,S,NS,0,5,5,0,Fall2018
7245,SW Terwilliger & Troy ,5809,N,FS,4,0,4,0,Fall2018
7246,SW Terwilliger & Westwood ,5811,N,OP,0,0,0,0,Fall2018
7247,SW Terwilliger & Westwood ,5812,S,FS,0,0,0,0,Fall2018
7213,SW Terwilliger & 2nd,5813,W,FS,17,4,21,0,Fall2018
7215,SW Terwilliger & 6th,5814,N,OP,5,1,6,0,Fall2018
7227,SW Terwilliger & Carson ,5816,S,OP,1,3,4,0,Fall2018
3539,NW Thurman & Gordon,5824,W,NS,10,11,21,0,Fall2018
3528,NW Thurman & 26th,5831,W,NS,1,42,43,9,Fall2018
3529,NW Thurman & 26th,5832,E,FS,43,1,44,6,Fall2018
3530,NW Thurman & 27th,5835,W,FS,1,52,53,3,Fall2018
3531,NW Thurman & 27th,5836,E,FS,61,34,95,4,Fall2018
3532,NW Thurman & 28th,5837,W,FS,10,29,39,4,Fall2018
3533,NW Thurman & 29th,5839,W,OP,1,5,6,0,Fall2018
3534,NW Thurman & 29th,5840,E,NS,12,0,12,0,Fall2018
3535,NW Thurman & 32nd,5841,W,NS,2,9,11,0,Fall2018
3536,NW Thurman & 32nd,5842,E,NS,8,0,8,1,Fall2018
3537,NW Thurman & 34th,5843,W,OP,3,6,9,0,Fall2018
3538,NW Thurman & 34th,5844,E,NS,6,0,6,0,Fall2018
7460,Tigard Transit Center,5846,S,AT,484,379,863,105,Fall2018
7249,SW Towle & 10th Dr ,5851,N,FS,1,0,1,0,Fall2018
7248,SW Towle & 10th Ct ,5852,S,NS,0,1,1,0,Fall2018
7250,SW Towle & 14th ,5853,N,FS,1,0,1,0,Fall2018
7251,SW Towle & 14th ,5854,S,OP,0,0,0,0,Fall2018
7253,SW Towle & 19th Dr ,5855,S,OP,0,2,2,0,Fall2018
1649,N Trenton & Alaska,5862,W,FS,38,54,92,56,Fall2018
383,2800 Block S Troutdale,5864,N,OP,0,0,0,0,Fall2018
416,3000 Block S Troutdale,5865,S,AT,1,0,1,0,Fall2018
3710,S Troutdale & SE Beavercreek,5867,N,FS,0,1,1,0,Fall2018
3711,S Troutdale & SE Beavercreek,5868,S,FS,1,0,1,0,Fall2018
3712,S Troutdale & SE Chapman,5869,N,NS,1,2,3,0,Fall2018
3716,S Troutdale Rd & SW Chapman,5870,S,NS,3,0,3,0,Fall2018
3715,S Troutdale Rd & SE Stark,5871,N,FS,1,5,6,0,Fall2018
3713,S Troutdale & SE Stark,5872,S,NS,6,1,7,2,Fall2018
3701,S Troutdale & SE 19th,5874,N,FS,0,0,0,0,Fall2018
3702,S Troutdale & SE 19th,5875,S,OP,1,0,1,0,Fall2018
3703,S Troutdale & SE 21st,5876,N,FS,0,1,1,0,Fall2018
3714,S Troutdale & SW 21st,5877,S,FS,2,0,2,0,Fall2018
7254,SW Troy & 35th ,5878,W,FS,34,103,137,13,Fall2018
5593,SE Umatilla & 16th,5884,E,NS,1,10,11,1,Fall2018
2790,NE M L King & Ainsworth ,5886,N,NS,51,103,154,64,Fall2018
2791,NE M L King & Ainsworth ,5887,S,NS,83,34,117,40,Fall2018
2792,NE M L King & Alberta ,5889,S,FS,211,39,250,49,Fall2018
2793,NE M L King & Alberta ,5890,N,FS,138,382,520,89,Fall2018
5010,SE M L King & Ash,5892,S,NS,9,29,38,2,Fall2018
2794,NE M L King & Beech ,5893,S,NS,69,34,103,21,Fall2018
2795,NE M L King & Beech ,5894,N,NS,36,56,92,28,Fall2018
2796,NE M L King & Brazee ,5896,N,NS,26,72,98,11,Fall2018
2797,NE M L King & Broadway ,5897,S,NS,31,78,109,38,Fall2018
2798,NE M L King & Bryant ,5899,N,NS,68,77,145,35,Fall2018
2799,NE M L King & Bryant ,5900,S,NS,28,16,44,5,Fall2018
2809,NE M L King & E Burnside,5901,S,NS,67,203,270,75,Fall2018
2801,NE M L King & Dekum ,5903,N,NS,12,77,89,32,Fall2018
2802,NE M L King & Dekum ,5904,S,NS,83,18,101,19,Fall2018
2810,NE M L King & Failing,5906,N,FS,28,66,94,33,Fall2018
2811,NE M L King & Failing,5907,S,NS,80,29,109,12,Fall2018
2812,NE M L King & Fargo,5908,S,FS,53,23,76,27,Fall2018
2813,NE M L King & Fargo,5909,N,NS,16,36,52,19,Fall2018
2814,NE M L King & Fremont,5910,N,NS,32,100,132,36,Fall2018
2815,NE M L King & Fremont,5911,S,NS,77,42,119,33,Fall2018
2820,NE M L King & Hoyt,5912,S,NS,37,19,56,6,Fall2018
2816,NE M L King & Hancock,5914,S,NS,11,8,19,4,Fall2018
2817,NE M L King & Holladay,5917,S,NS,180,566,746,135,Fall2018
2818,NE M L King & Holland,5918,N,NS,16,34,50,4,Fall2018
2819,NE M L King & Holland,5919,S,NS,151,93,244,67,Fall2018
1194,M L King & Holman,5920,N,FS,3,13,16,1,Fall2018
2821,NE M L King & Jarrett,5923,S,NS,71,24,95,24,Fall2018
2822,NE M L King & Jarrett,5924,N,NS,15,51,66,17,Fall2018
2823,NE M L King & Killingsworth,5927,S,FS,359,308,667,143,Fall2018
2824,NE M L King & Killingsworth,5929,N,NS,82,160,242,74,Fall2018
2825,NE M L King & Knott,5930,N,NS,39,89,128,22,Fall2018
2826,NE M L King & Knott,5931,S,NS,93,42,135,28,Fall2018
2827,NE M L King & Lombard St,5932,N,NS,59,69,128,29,Fall2018
5011,SE M L King & Mill,5933,S,FS,1,0,1,0,Fall2018
2828,NE M L King & Mason,5934,S,FS,79,35,114,107,Fall2018
2829,NE M L King & Mason,5935,N,NS,35,68,103,82,Fall2018
2830,NE M L King & Morgan,5937,N,NS,8,19,27,3,Fall2018
2832,NE M L King & Morris,5938,S,FS,60,21,81,13,Fall2018
2833,NE M L King & Morris,5939,N,FS,29,77,106,17,Fall2018
2836,NE M L King & Rosa Parks Way,5943,S,NS,37,7,44,4,Fall2018
2837,NE M L King & Rosa Parks Way,5944,N,NS,4,26,30,14,Fall2018
2834,NE M L King & Prescott,5946,N,NS,22,51,73,4,Fall2018
2835,NE M L King & Prescott,5947,S,OP,69,20,89,3,Fall2018
2838,NE M L King & Russet,5950,S,FS,44,54,98,25,Fall2018
2839,NE M L King & Sacramento,5951,S,OP,70,24,94,8,Fall2018
2840,NE M L King & Tillamook,5955,S,NS,20,16,36,10,Fall2018
2841,NE M L King & Tillamook,5956,N,NS,23,31,54,9,Fall2018
2842,NE M L King & Wasco,5958,S,NS,15,69,84,17,Fall2018
2843,NE M L King & Weidler,5960,S,FS,41,75,116,38,Fall2018
2845,NE M L King & Wygant,5961,S,FS,25,14,39,2,Fall2018
2846,NE M L King & Wygant,5962,N,NS,14,69,83,20,Fall2018
185,15800 Block SW 72nd,5973,S,AT,1,2,3,0,Fall2018
7477,US Veterans Hospital,5975,S,AT,481,680,1161,423,Fall2018
1654,N Vancouver & Ainsworth,5976,N,NS,4,11,15,0,Fall2018
1655,N Vancouver & Ainsworth,5977,S,NS,12,2,14,0,Fall2018
1656,N Vancouver & Alberta,5978,S,NS,78,17,95,31,Fall2018
1657,N Vancouver & Beech,5979,S,NS,21,12,33,6,Fall2018
1658,N Vancouver & Fargo,5984,S,OP,62,21,83,41,Fall2018
1659,N Vancouver & Holman,5991,N,NS,1,12,13,0,Fall2018
1660,N Vancouver & Holman,5992,S,NS,11,2,13,0,Fall2018
1663,N Vancouver & Jessup,5995,S,NS,11,4,15,0,Fall2018
1664,N Vancouver & Killingsworth,5996,S,FS,64,46,110,37,Fall2018
1665,N Vancouver & Knott,5997,S,NS,56,26,82,32,Fall2018
1661,N Vancouver & Ivy,6000,S,NS,178,92,270,22,Fall2018
1666,N Vancouver & Page,6001,S,NS,46,24,70,6,Fall2018
1667,N Vancouver & Russell,6003,S,FS,60,29,89,64,Fall2018
1668,N Vancouver & Shaver,6004,S,NS,28,10,38,1,Fall2018
1669,N Vancouver & Skidmore,6005,S,NS,77,9,86,2,Fall2018
1670,N Vancouver & Stanton,6006,S,NS,178,93,271,142,Fall2018
1671,N Vancouver & Tillamook,6008,S,NS,23,11,34,3,Fall2018
1672,N Vancouver & Weidler,6009,S,NS,39,76,115,41,Fall2018
1673,N Vancouver & Wygant,6010,S,NS,26,3,29,0,Fall2018
3540,NW Vaughn & 24th,6013,E,NS,55,2,57,3,Fall2018
3541,NW Vaughn & 24th,6014,W,NS,2,51,53,5,Fall2018
265,1900 Block SW Vermont,6017,E,AT,4,0,4,0,Fall2018
326,2200 Block SW Vermont,6018,W,AT,0,2,2,0,Fall2018
558,5700 Block SW Vermont,6019,W,OP,1,1,2,0,Fall2018
7344,SW Vermont & Bertha ,6022,E,NS,7,0,7,1,Fall2018
6287,SW Capitol & Vermont,6023,E,FS,26,6,32,2,Fall2018
7345,SW Vermont & Bertha ,6024,W,FS,1,6,7,0,Fall2018
7347,SW Vermont & Chestnut ,6025,E,NS,6,55,61,0,Fall2018
7348,SW Vermont & Chestnut ,6026,W,OP,33,9,42,0,Fall2018
7349,SW Vermont & Idaho ,6027,E,OP,1,1,2,0,Fall2018
7350,SW Vermont & Idaho ,6028,W,NS,0,2,2,0,Fall2018
7351,SW Vermont & Idaho Dr ,6029,W,FS,13,37,50,2,Fall2018
7353,SW Vermont & Shattuck ,6030,W,NS,3,5,8,0,Fall2018
7346,SW Vermont & Capitol Hwy,6031,E,FS,1,0,1,0,Fall2018
7325,SW Vermont & 13th,6032,W,OP,2,2,4,0,Fall2018
7326,SW Vermont & 13th,6033,E,FS,1,2,3,0,Fall2018
7327,SW Vermont & 24th,6034,W,FS,0,1,1,0,Fall2018
7328,SW Vermont & 30th,6035,W,NS,2,8,10,0,Fall2018
7329,SW Vermont & 30th,6036,E,NS,8,1,9,0,Fall2018
7330,SW Vermont & 32nd,6037,W,FS,0,3,3,0,Fall2018
7333,SW Vermont & 37th,6041,W,NS,1,7,8,0,Fall2018
7334,SW Vermont & 37th,6042,E,NS,6,1,7,0,Fall2018
7335,SW Vermont & 42nd,6043,W,OP,0,3,3,0,Fall2018
7336,SW Vermont & 45th,6045,E,FS,26,4,30,5,Fall2018
7337,SW Vermont & 50th,6046,E,OP,0,0,0,0,Fall2018
7338,SW Vermont & 50th,6047,W,NS,0,8,8,0,Fall2018
7339,SW Vermont & 52nd,6048,E,NS,0,0,0,0,Fall2018
7340,SW Vermont & 52nd,6049,W,OP,0,8,8,0,Fall2018
7341,SW Vermont & 55th,6050,W,OP,0,6,6,0,Fall2018
7342,SW Vermont & 60th,6051,W,OP,10,10,20,0,Fall2018
7343,SW Vermont & 63rd,6052,W,OP,0,1,1,0,Fall2018
7354,SW Virginia & California ,6053,S,NS,0,4,4,0,Fall2018
7355,SW Virginia & Nebraska ,6057,N,NS,3,2,5,1,Fall2018
7356,SW Virginia & Nevada ,6059,N,NS,3,2,5,0,Fall2018
7357,SW Virginia & Taylors Ferry,6060,S,NS,2,2,4,0,Fall2018
7358,SW Virginia & Taylors Ferry,6061,N,FS,1,1,2,0,Fall2018
7359,SW Virginia & Vermont ,6062,S,NS,1,2,3,0,Fall2018
7360,SW Virginia & Vermont ,6063,N,NS,1,0,1,0,Fall2018
7367,SW Vista & Broadway,6068,S,NS,0,19,19,0,Fall2018
7368,SW Vista & Elm St,6074,S,NS,1,14,15,1,Fall2018
7369,SW Vista & Elm St,6075,N,NS,4,1,5,0,Fall2018
7370,SW Vista & Isabella,6077,S,NS,0,2,2,0,Fall2018
7371,SW Vista & Jackson,6078,S,FS,0,6,6,0,Fall2018
7372,SW Vista & Jackson,6079,N,FS,4,0,4,0,Fall2018
7373,SW Vista & Madison,6082,S,NS,0,1,1,0,Fall2018
7374,SW Vista & Main,6083,N,NS,12,3,15,0,Fall2018
7375,SW Vista & Market Street,6084,N,FS,0,0,0,0,Fall2018
7376,SW Vista & Market Street,6085,S,NS,0,1,1,0,Fall2018
7377,SW Vista & Montgomery,6086,S,FS,0,1,1,0,Fall2018
7378,SW Vista & Montgomery,6087,N,NS,0,0,0,0,Fall2018
7379,SW Vista & Myrtle,6088,S,NS,0,5,5,0,Fall2018
7380,SW Vista & Myrtle,6089,N,NS,5,0,5,0,Fall2018
7381,SW Vista & Park Pl,6090,S,FS,3,16,19,0,Fall2018
7400,SW Walnut & Brookside,6103,W,NS,3,0,3,0,Fall2018
7401,SW Walnut & Grant,6104,E,FS,2,12,14,0,Fall2018
7403,SW Walnut & Tiedeman,6105,W,FS,2,1,3,0,Fall2018
7404,SW Walnut & Watkins,6107,E,NS,1,2,3,0,Fall2018
7394,SW Walnut & 112th,6108,W,NS,0,0,0,0,Fall2018
7395,SW Walnut & 112th,6109,E,NS,0,0,0,0,Fall2018
7397,SW Walnut & 116th,6111,E,FS,3,2,5,0,Fall2018
7398,SW Walnut & 121st,6112,W,NS,8,5,13,0,Fall2018
1,100 Block Warner - Milne,6113,E,AT,2,9,11,0,Fall2018
291,200 Block Warner - Milne,6114,W,OP,6,2,8,2,Fall2018
409,300 Block Beavercreek Rd,6115,W,AT,18,2,20,2,Fall2018
783,Beavercreek & Library Ct,6117,S,FS,8,36,44,10,Fall2018
7561,Warner - Milne & Beavercreek,6118,E,NS,1,16,17,2,Fall2018
7562,Warner - Milne & Linn,6120,E,FS,7,11,18,1,Fall2018
7563,Warner - Milne & Linn,6121,W,NS,8,10,18,12,Fall2018
786,Beavercreek & Red Soils Ct,6122,E,NS,1,18,19,2,Fall2018
6415,SW Eliander & One Embassy Centre,6125,S,AT,23,91,114,13,Fall2018
703,9000 Block SW Washington Square Rd,6126,N,AT,15,2,17,0,Fall2018
704,9000 Block SW Washington Square Rd,6133,S,OP,3,22,25,0,Fall2018
5618,SE Washington & Oak,6140,E,NS,1,1,2,0,Fall2018
5619,SE Washington & Oak,6141,N,FS,1,2,3,0,Fall2018
5594,SE Washington & 105th,6143,E,OP,174,70,244,69,Fall2018
5595,SE Washington & 108th,6144,E,NS,31,22,53,8,Fall2018
5596,SE Washington & 23rd,6151,W,FS,1,17,18,1,Fall2018
5597,SE Washington & 25th,6152,E,OP,3,0,3,0,Fall2018
5598,SE Washington & 25th,6153,W,NS,0,1,1,0,Fall2018
5599,SE Washington & 29th,6156,E,OP,0,0,0,0,Fall2018
5600,SE Washington & 29th,6157,W,NS,1,0,1,0,Fall2018
7409,SW Washington & 3rd,6158,W,NS,60,366,426,22,Fall2018
5602,SE Washington & 34th,6159,E,NS,0,0,0,0,Fall2018
7410,SW Washington & 5th,6160,W,NS,331,642,973,174,Fall2018
5603,SE Washington & 80th,6165,E,FS,7,63,70,10,Fall2018
5604,SE Washington & 82nd,6166,E,FS,67,73,140,63,Fall2018
5605,SE Washington & 86th,6167,E,NS,3,12,15,2,Fall2018
5606,SE Washington & 88th,6168,E,NS,3,15,18,0,Fall2018
7411,SW Washington & 9th,6169,W,FS,48,181,229,17,Fall2018
5607,SE Washington & 90th,6170,E,NS,2,12,14,0,Fall2018
5608,SE Washington & 92nd,6171,E,FS,9,26,35,3,Fall2018
5609,SE Washington & 94th,6173,E,NS,4,5,9,0,Fall2018
6416,SW Eliander & One Embassy Centre,6175,N,OP,64,31,95,6,Fall2018
7413,SW Watson & 1st,6178,S,FS,67,13,80,9,Fall2018
7412,SW Watson & 10th,6179,S,FS,12,18,30,24,Fall2018
7421,SW Watson & 9th,6182,S,NS,5,8,13,2,Fall2018
5620,SE Webster & Bixel,6187,N,OP,1,2,3,0,Fall2018
5621,SE Webster & Cavalier Way,6189,S,NS,0,1,1,0,Fall2018
7585,Webster & Charolais,6190,N,NS,12,6,18,0,Fall2018
5622,SE Webster & Clackamas,6191,N,FS,1,0,1,0,Fall2018
5623,SE Webster & Clackamas,6192,S,FS,2,2,4,0,Fall2018
5625,SE Webster & Lake,6193,S,FS,2,3,5,2,Fall2018
7586,Webster & Clayton,6194,S,NS,3,2,5,0,Fall2018
5624,SE Webster & Cypress,6195,N,NS,1,2,3,0,Fall2018
249,18000 Block Webster,6196,N,AT,1,2,3,1,Fall2018
241,17700 Block Webster,6197,N,AT,0,3,3,0,Fall2018
7588,Webster & Kraxberger Middle School,6198,S,AT,1,1,2,1,Fall2018
5626,SE Webster & Lake,6199,N,NS,3,2,5,0,Fall2018
7589,Webster & Los Verdes,6201,S,FS,10,11,21,0,Fall2018
5627,SE Webster & Mabel,6203,S,NS,1,2,3,2,Fall2018
5628,SE Webster & Molt St,6205,S,FS,1,1,2,0,Fall2018
7590,Webster & Oatfield,6206,S,NS,1,8,9,1,Fall2018
5629,SE Webster & Pine Creek,6207,N,OP,1,2,3,1,Fall2018
7587,Webster & Kirkwood,6208,N,NS,2,4,6,0,Fall2018
5631,SE Webster & Savanna,6209,N,FS,1,1,2,0,Fall2018
5632,SE Webster & Strawberry,6210,N,NS,5,3,8,2,Fall2018
5633,SE Webster & Thiessen,6211,N,NS,8,6,14,1,Fall2018
5634,SE Webster & Thiessen,6212,S,FS,5,6,11,2,Fall2018
5635,SE Webster & Tuscany Ct,6213,S,NS,2,1,3,0,Fall2018
5636,SE Webster & Wilshire,6215,S,OP,0,0,0,0,Fall2018
3112,NE Weidler & Lloyd Center,6216,E,AT,171,177,348,244,Fall2018
3113,NE Weidler & M L King,6218,E,FS,24,30,54,30,Fall2018
1679,N Weidler & Williams,6220,E,NS,31,22,53,32,Fall2018
3102,NE Weidler & 106th,6223,W,NS,31,16,47,26,Fall2018
3103,NE Weidler & 111th,6225,W,NS,51,24,75,43,Fall2018
3105,NE Weidler & 17th,6227,E,NS,34,44,78,15,Fall2018
3109,NE Weidler & 2nd,6232,E,NS,6,20,26,22,Fall2018
3106,NE Weidler & 21st,6235,E,NS,24,91,115,45,Fall2018
3107,NE Weidler & 22nd,6237,E,NS,22,42,64,5,Fall2018
3108,NE Weidler & 24th,6239,E,NS,8,24,32,8,Fall2018
3110,NE Weidler & 7th,6240,E,NS,20,27,47,36,Fall2018
3111,NE Weidler & 9th,6242,E,NS,10,32,42,23,Fall2018
1680,N Whitaker & Hayden Meadows,6256,N,FS,6,18,24,8,Fall2018
1681,N Willamette & Alma,6258,W,NS,2,34,36,2,Fall2018
1700,N Willamette & Ida,6259,E,NS,27,2,29,0,Fall2018
1682,N Willamette & Bryant,6260,N,NS,2,10,12,0,Fall2018
1688,N Willamette & Edgewater,6262,E,FS,11,1,12,0,Fall2018
1683,N Willamette & Burr,6263,W,FS,0,9,9,0,Fall2018
1685,N Willamette & Carey,6264,N,NS,0,4,4,0,Fall2018
1686,N Willamette & Carey,6265,E,FS,3,1,4,0,Fall2018
1687,N Willamette & Chautauqua,6266,E,OP,6,1,7,0,Fall2018
1696,N Willamette & Harvard,6269,W,NS,6,19,25,0,Fall2018
1697,N Willamette & Harvard,6270,E,OP,12,6,18,0,Fall2018
1698,N Willamette & Haven,6271,W,NS,13,47,60,0,Fall2018
1699,N Willamette & Hurst,6273,W,NS,0,6,6,0,Fall2018
1701,N Willamette & Macrum,6274,E,OP,7,1,8,1,Fall2018
1702,N Willamette & Macrum,6275,W,NS,3,9,12,0,Fall2018
1703,N Willamette & Menlo,6277,W,NS,1,12,13,0,Fall2018
1704,N Willamette & Menlo,6278,E,OP,7,1,8,0,Fall2018
1705,N Willamette & Mohawk,6279,E,OP,10,0,10,11,Fall2018
1706,N Willamette & Monteith,6280,W,FS,5,10,15,0,Fall2018
1707,N Willamette & Oswego,6282,W,NS,0,13,13,11,Fall2018
1689,N Willamette & Edgewater,6283,W,OP,1,12,13,0,Fall2018
1708,N Willamette & Portsmouth,6284,W,NS,9,18,27,1,Fall2018
1709,N Willamette & Portsmouth,6285,E,FS,15,8,23,0,Fall2018
1710,N Willamette & Saratoga,6286,S,OP,4,2,6,0,Fall2018
1711,N Willamette & Tyler,6288,W,FS,0,11,11,2,Fall2018
1712,N Willamette & Tyler,6289,E,FS,9,0,9,1,Fall2018
1713,N Willamette & University of Portland,6290,E,AT,48,11,59,0,Fall2018
1714,N Willamette & Van Houten,6291,E,NS,12,4,16,0,Fall2018
1715,N Willamette & Wall,6292,W,NS,1,11,12,0,Fall2018
1716,N Willamette & Wall,6293,E,NS,15,2,17,1,Fall2018
1717,N Willamette & Washburne,6294,W,NS,0,8,8,0,Fall2018
1718,N Willamette & Washburne,6295,E,OP,5,0,5,0,Fall2018
1719,N Willamette & Woolsey,6298,W,NS,1,12,13,0,Fall2018
1720,N Willamette & Woolsey,6299,E,OP,5,1,6,0,Fall2018
7611,Willamette Dr & Mapleton Dr,6300,S,FS,2,5,7,0,Fall2018
7592,Willamette Dr & Arbor,6301,N,NS,7,1,8,0,Fall2018
7593,Willamette Dr & Arbor,6302,S,NS,0,7,7,0,Fall2018
7594,Willamette Dr & Barlow,6303,W,OP,1,2,3,0,Fall2018
7595,Willamette Dr & Barlow,6304,E,NS,2,4,6,8,Fall2018
7596,Willamette Dr & Burns,6306,W,NS,20,6,26,1,Fall2018
7597,Willamette Dr & Cedar Oak,6309,N,FS,63,11,74,2,Fall2018
3628,Pacific Hwy & Cherry,6310,N,OP,3,0,3,0,Fall2018
3636,Pacific Hwy (Hwy 43) & Cherry,6311,S,FS,0,4,4,0,Fall2018
7598,Willamette Dr & Elliott,6312,W,FS,11,2,13,0,Fall2018
7623,Willamette Dr & West A,6314,E,NS,2,10,12,0,Fall2018
3630,Pacific Hwy & Glenmorrie,6317,N,FS,1,1,2,0,Fall2018
3631,Pacific Hwy & Glenmorrie,6318,S,FS,0,1,1,0,Fall2018
7599,Willamette Dr & Hidden Springs,6319,S,NS,9,69,78,1,Fall2018
7600,Willamette Dr & Holly,6320,N,NS,10,3,13,1,Fall2018
7602,Willamette Dr & Holmes,6321,N,NS,5,1,6,0,Fall2018
7603,Willamette Dr & Holmes,6322,S,OP,0,5,5,0,Fall2018
7604,Willamette Dr & Hughes,6323,N,NS,5,1,6,0,Fall2018
7605,Willamette Dr & Hughes,6324,S,OP,0,4,4,0,Fall2018
7606,Willamette Dr & Jolie Pointe,6325,N,NS,4,2,6,0,Fall2018
7607,Willamette Dr & Jolie Pointe,6326,S,OP,1,4,5,0,Fall2018
3633,Pacific Hwy & Laurel,6327,N,OP,8,0,8,0,Fall2018
3627,Pacific Hwy & Burnham,6328,S,OP,0,7,7,0,Fall2018
7610,Willamette Dr & Mapleton,6331,N,NS,8,3,11,0,Fall2018
7612,Willamette Dr & Mark Ln,6332,N,NS,6,3,9,0,Fall2018
7609,Willamette Dr & Linnwood,6333,S,NS,3,7,10,0,Fall2018
3629,Pacific Hwy & Furman,6334,N,FS,3,1,4,0,Fall2018
3632,Pacific Hwy & Holy Names Drive,6335,N,FS,9,4,13,2,Fall2018
3626,Pacific Hwy & Brookhurst Dr,6336,S,FS,3,13,16,4,Fall2018
7613,Willamette Dr & Marylhurst Dr,6337,S,FS,3,16,19,1,Fall2018
3634,Pacific Hwy & Marylbrook Dr,6338,S,FS,1,2,3,0,Fall2018
7614,Willamette Dr & McKillican,6339,S,NS,6,20,26,1,Fall2018
7615,Willamette Dr & Pimlico,6344,N,OP,10,1,11,0,Fall2018
7616,Willamette Dr & Pimlico,6345,S,NS,1,6,7,0,Fall2018
7617,Willamette Dr & Shady Hollow,6346,N,NS,2,2,4,0,Fall2018
7618,Willamette Dr & Shady Hollow,6347,S,OP,2,1,3,0,Fall2018
7601,Willamette Dr & Holly (near gas stn),6348,S,FS,0,3,3,0,Fall2018
7620,Willamette Dr & Walling Way,6349,N,FS,7,2,9,0,Fall2018
7619,Willamette Dr & Walling Circle,6350,S,NS,1,3,4,0,Fall2018
7621,Willamette Dr & Webb,6352,S,NS,0,2,2,0,Fall2018
1728,N Williams & NE Russell,6354,N,FS,64,140,204,111,Fall2018
1722,N Williams & NE Alberta,6355,N,NS,10,58,68,28,Fall2018
1723,N Williams & NE Broadway,6357,N,FS,37,25,62,16,Fall2018
1724,N Williams & NE Cook,6359,N,FS,33,178,211,33,Fall2018
1725,N Williams & NE Fremont,6360,N,FS,26,44,70,7,Fall2018
1726,N Williams & NE Graham,6362,N,NS,35,131,166,59,Fall2018
1727,N Williams & NE Morris,6364,N,NS,67,108,175,109,Fall2018
1729,N Williams & NE Shaver,6366,N,NS,10,46,56,4,Fall2018
1730,N Williams & NE Skidmore,6367,N,NS,9,60,69,1,Fall2018
1731,N Williams & NE Tillamook,6370,N,FS,19,61,80,4,Fall2018
1733,N Williams & NE Wygant,6371,N,NS,3,31,34,0,Fall2018
1734,N Willis & Bayard,6373,W,NS,18,42,60,0,Fall2018
1735,N Willis & Chautauqua,6374,E,NS,20,2,22,0,Fall2018
1737,N Willis & Druid,6375,W,FS,0,20,20,0,Fall2018
1738,N Willis & Druid,6376,E,NS,24,1,25,0,Fall2018
1739,N Willis & Emerald,6377,E,NS,47,11,58,1,Fall2018
1753,N Willis & Wabash,6378,W,OP,6,35,41,8,Fall2018
1740,N Willis & Hereford,6379,W,NS,1,18,19,2,Fall2018
1741,N Willis & Hodge,6380,E,FS,18,1,19,2,Fall2018
1742,N Willis & Newman,6381,E,NS,32,0,32,0,Fall2018
1749,N Willis & Newman,6382,W,FS,1,24,25,0,Fall2018
1750,N Willis & Peninsular,6383,E,NS,47,15,62,4,Fall2018
1751,N Willis & Peninsular,6384,W,FS,18,44,62,4,Fall2018
1752,N Willis & Portsmouth,6385,W,NS,0,39,39,0,Fall2018
1754,N Willis & Wabash,6386,E,NS,45,9,54,2,Fall2018
1755,N Willis & Washburne,6387,W,FS,4,13,17,1,Fall2018
1756,N Willis & Washburne,6388,E,NS,31,15,46,1,Fall2018
1757,N Willis & Wayland,6389,W,NS,1,19,20,4,Fall2018
1758,N Willis & Wayland,6390,E,NS,28,1,29,2,Fall2018
1759,N Willis & Woolsey,6391,W,NS,1,20,21,1,Fall2018
1760,N Willis & Woolsey,6392,E,NS,22,1,23,0,Fall2018
5654,SE Woodstock & 94th (I-205 West End),6398,E,FS,24,21,45,7,Fall2018
5656,SE Woodstock & Moreland Ln,6399,E,NS,2,6,8,0,Fall2018
417,3000 Block SE Woodstock,6400,W,OP,5,1,6,0,Fall2018
5637,SE Woodstock & 32nd,6402,E,NS,4,7,11,0,Fall2018
5638,SE Woodstock & 32nd,6403,W,OP,22,11,33,7,Fall2018
5639,SE Woodstock & 34th,6405,E,NS,9,10,19,0,Fall2018
5640,SE Woodstock & 34th,6406,W,OP,5,6,11,0,Fall2018
5641,SE Woodstock & 36th,6407,E,NS,4,4,8,4,Fall2018
454,3600 Block SE Woodstock,6408,W,OP,7,5,12,0,Fall2018
5655,SE Woodstock & Cesar Chavez Blvd,6409,W,NS,18,3,21,2,Fall2018
5643,SE Woodstock & 41st,6411,E,NS,9,75,84,32,Fall2018
5644,SE Woodstock & 41st,6412,W,NS,65,14,79,22,Fall2018
5645,SE Woodstock & 43rd,6413,E,NS,19,74,93,53,Fall2018
5646,SE Woodstock & 43rd,6414,W,NS,107,40,147,90,Fall2018
5647,SE Woodstock & 46th,6415,E,NS,149,202,351,202,Fall2018
5648,SE Woodstock & 46th,6416,W,NS,48,54,102,75,Fall2018
5649,SE Woodstock & 49th,6419,E,FS,18,26,44,27,Fall2018
5650,SE Woodstock & 49th,6420,W,NS,21,13,34,15,Fall2018
5651,SE Woodstock & 51st,6421,W,NS,48,7,55,9,Fall2018
5653,SE Woodstock & 92nd,6427,E,NS,36,94,130,23,Fall2018
5657,SE Yamhill & 69th,6442,W,NS,8,6,14,1,Fall2018
5658,SE Yamhill & 71st,6443,E,NS,2,16,18,0,Fall2018
5659,SE Yamhill & 71st,6444,W,NS,13,3,16,0,Fall2018
5660,SE Yamhill & 73rd,6445,E,NS,2,10,12,0,Fall2018
5661,SE Yamhill & 73rd,6446,W,FS,11,3,14,4,Fall2018
5662,SE Yamhill & 76th,6447,E,NS,4,46,50,2,Fall2018
494,4200 Block NW Yeon,6458,W,AT,0,2,2,0,Fall2018
483,4000 Block NW Yeon Frontage Rd,6460,E,AT,9,1,10,0,Fall2018
469,3900 Block NW Yeon Frontage Rd,6463,E,AT,5,0,5,0,Fall2018
468,3900 Block NW Yeon,6467,W,AT,0,11,11,0,Fall2018
3560,NW Yeon & 44th,6470,E,FS,76,52,128,8,Fall2018
323,2200 Block SW 1st,6472,N,AT,3,16,19,16,Fall2018
5805,SW 1st & Madison Tower,6473,S,AT,1,1,2,9,Fall2018
5800,SW 1st & Arthur,6474,S,NS,5,0,5,0,Fall2018
5801,SW 1st & Arthur,6475,N,NS,0,6,6,0,Fall2018
5803,SW 1st & Hooker,6480,S,NS,2,0,2,0,Fall2018
5804,SW 1st & Hooker,6481,N,NS,0,1,1,0,Fall2018
5806,SW 1st & Woods,6488,S,NS,1,0,1,0,Fall2018
5807,SW 1st & Woods,6489,N,FS,0,0,0,0,Fall2018
3727,SE 10th & Maple,6495,N,NS,74,76,150,24,Fall2018
3728,SE 10th & Maple,6496,S,FS,83,63,146,23,Fall2018
5570,SE Tualatin Valley Hwy & 11th,6498,S,FS,33,24,57,3,Fall2018
3729,SE 10th & Walnut,6499,N,NS,75,93,168,14,Fall2018
3730,SE 10th & Walnut,6500,S,NS,139,76,215,19,Fall2018
3725,SE 10th & Baseline,6502,N,NS,54,4,58,3,Fall2018
0,100 Block NE 102nd,6503,S,AT,11,6,17,7,Fall2018
1767,NE 102nd & Davis,6504,N,NS,5,7,12,6,Fall2018
1761,NE 102nd & Alton,6505,S,NS,6,2,8,5,Fall2018
1762,NE 102nd & Beech,6506,N,FS,1,7,8,0,Fall2018
1763,NE 102nd & Bell,6507,S,FS,10,5,15,3,Fall2018
1764,NE 102nd & Brazee,6508,N,NS,2,7,9,0,Fall2018
1765,NE 102nd & Brazee,6509,S,FS,9,2,11,5,Fall2018
3718,SE 102nd & E Burnside,6510,N,NS,22,67,89,30,Fall2018
3717,SE 102nd & Burnside,6511,S,FS,257,149,406,141,Fall2018
1766,NE 102nd & Clackamas,6513,S,OP,6,19,25,11,Fall2018
1768,NE 102nd & Fremont,6514,N,NS,2,15,17,7,Fall2018
1769,NE 102nd & Fremont,6515,S,NS,15,2,17,2,Fall2018
1770,NE 102nd & Glisan,6516,N,NS,8,29,37,14,Fall2018
1771,NE 102nd & Glisan,6517,S,FS,29,13,42,18,Fall2018
1773,NE 102nd & Hancock,6518,N,NS,8,8,16,3,Fall2018
1774,NE 102nd & Knott,6519,S,OP,4,0,4,0,Fall2018
20,102nd & Morris St,6520,S,FS,15,4,19,1,Fall2018
1776,NE 102nd & Morris Ct,6521,N,FS,4,14,18,0,Fall2018
76,1200 Block NE 102nd,6522,N,OP,60,10,70,25,Fall2018
77,1200 Block NE 102nd,6523,S,AT,8,35,43,26,Fall2018
1777,NE 102nd & Pacific,6525,S,NS,1,12,13,3,Fall2018
3719,SE 102nd & Pine,6526,S,FS,27,45,72,11,Fall2018
1781,NE 102nd & Shaver,6528,N,NS,3,6,9,2,Fall2018
3720,SE 102nd & Washington,6529,S,NS,30,35,65,20,Fall2018
1784,NE 102nd & Tillamook,6530,N,NS,3,6,9,7,Fall2018
1785,NE 102nd & Weidler,6531,N,NS,39,11,50,13,Fall2018
1786,NE 102nd & Weidler,6532,S,NS,4,17,21,10,Fall2018
3114,NW 107th & Copeland,6535,S,NS,0,0,0,0,Fall2018
3258,NW Cornell & 107th,6536,E,NS,1,0,1,0,Fall2018
3115,NW 107th & Cornell,6537,N,NS,0,1,1,0,Fall2018
3116,NW 107th & Walters,6539,N,NS,0,0,0,0,Fall2018
3733,SE 11th & Ash,6541,S,NS,18,19,37,12,Fall2018
3734,SE 11th & Belmont,6542,S,FS,80,85,165,33,Fall2018
3735,SE 11th & Clay,6543,S,NS,16,19,35,7,Fall2018
3736,SE 11th & Division,6545,S,NS,42,69,111,8,Fall2018
5664,SW 11th & Gibbs,6548,N,NS,58,130,188,27,Fall2018
3737,SE 11th & Madison,6551,S,FS,39,81,120,6,Fall2018
3738,SE 11th & Sherman,6553,S,NS,3,16,19,0,Fall2018
3739,SE 11th & Stark,6554,S,NS,34,38,72,33,Fall2018
3740,SE 11th & Stephens,6555,S,NS,6,15,21,1,Fall2018
1793,NE 111th & Knott,6557,N,NS,0,1,1,0,Fall2018
1794,NE 111th & Knott,6558,S,NS,1,0,1,0,Fall2018
1795,NE 111th & Morris,6559,N,NS,1,2,3,0,Fall2018
1802,NE 111th & Sacramento,6561,N,NS,0,2,2,0,Fall2018
1803,NE 111th & Sacramento,6562,S,NS,2,0,2,0,Fall2018
1804,NE 111th & San Rafael,6563,N,NS,0,4,4,2,Fall2018
1805,NE 111th & San Rafael,6564,S,OP,5,0,5,0,Fall2018
1806,NE 111th & Weidler,6565,N,NS,2,4,6,3,Fall2018
1807,NE 111th & Weidler,6566,S,NS,4,3,7,2,Fall2018
3732,SE 112th & Mt Scott Blvd,6567,N,FS,9,15,24,2,Fall2018
3788,SE 12th & Clay,6576,N,NS,19,45,64,4,Fall2018
1829,NE 12th & Couch,6577,S,FS,114,70,184,35,Fall2018
3789,SE 12th & Division,6578,N,NS,77,46,123,8,Fall2018
1831,NE 12th & Glisan,6580,S,NS,64,40,104,0,Fall2018
3790,SE 12th & Harrison,6581,N,NS,22,8,30,1,Fall2018
1832,NE 12th & Irving,6582,N,NS,50,73,123,2,Fall2018
1833,NE 12th & Irving,6583,S,NS,11,4,15,0,Fall2018
3791,SE 12th & Madison,6585,N,FS,83,27,110,9,Fall2018
3792,SE 12th & Morrison,6588,N,NS,71,80,151,42,Fall2018
1830,NE 12th & E Burnside,6592,N,FS,82,144,226,46,Fall2018
3793,SE 12th & Stark,6594,N,NS,51,40,91,17,Fall2018
5675,SW 121st & North Dakota,6597,N,NS,6,1,7,0,Fall2018
5671,SW 121st & Katherine,6598,S,FS,2,6,8,0,Fall2018
5672,SW 121st & Lynn,6599,N,NS,8,3,11,0,Fall2018
5673,SW 121st & Merestone,6601,N,NS,3,1,4,0,Fall2018
5674,SW 121st & Merestone,6602,S,NS,2,1,3,0,Fall2018
5676,SW 121st & North Dakota,6603,S,NS,1,5,6,0,Fall2018
1810,NE 121st Pl & Prescott,6604,N,NS,53,48,101,7,Fall2018
5677,SW 121st & Scholls Ferry,6606,S,FS,15,21,36,1,Fall2018
5678,SW 121st & Springwood,6607,N,NS,9,7,16,1,Fall2018
5679,SW 121st & Summer,6608,S,FS,0,1,1,0,Fall2018
1812,NE 122nd & Davis,6610,S,NS,70,22,92,54,Fall2018
412,300 Block NE 122nd,6611,N,AT,15,54,69,37,Fall2018
452,3600 Block NE 122nd,6613,S,OP,28,11,39,3,Fall2018
1814,NE 122nd & Halsey,6617,S,NS,115,56,171,66,Fall2018
3741,SE 122nd & Boise,6618,N,NS,52,6,58,16,Fall2018
3742,SE 122nd & Boise,6619,S,NS,44,61,105,22,Fall2018
1811,NE 122nd & Brazee,6620,N,NS,15,13,28,7,Fall2018
3748,SE 122nd & E Burnside,6621,N,NS,153,376,529,179,Fall2018
3743,SE 122nd & Burnside,6623,S,FS,372,171,543,191,Fall2018
3744,SE 122nd & Bush,6624,N,FS,40,24,64,9,Fall2018
3745,SE 122nd & Bush,6625,S,FS,21,39,60,4,Fall2018
3751,SE 122nd & Foster,6626,N,FS,82,22,104,19,Fall2018
1815,NE 122nd & Halsey,6628,N,FS,58,80,138,67,Fall2018
3746,SE 122nd & Division,6630,N,FS,290,138,428,129,Fall2018
3747,SE 122nd & Division,6631,S,FS,147,285,432,137,Fall2018
3752,SE 122nd & Harold,6633,N,NS,61,8,69,49,Fall2018
3753,SE 122nd & Harold,6634,S,NS,6,52,58,22,Fall2018
3754,SE 122nd & Holgate,6635,N,NS,131,17,148,40,Fall2018
3755,SE 122nd & Holgate,6636,S,FS,21,91,112,58,Fall2018
3756,SE 122nd & Lincoln,6640,N,FS,61,31,92,15,Fall2018
3763,SE 122nd & Lincoln,6641,S,NS,34,68,102,13,Fall2018
3764,SE 122nd & Madison,6642,N,NS,60,22,82,47,Fall2018
117,1300 Block SE 122nd,6643,S,OP,23,57,80,55,Fall2018
3765,SE 122nd & Market,6645,N,NS,68,75,143,28,Fall2018
3766,SE 122nd & Market,6646,S,NS,98,70,168,39,Fall2018
536,500 Block NE 122nd Ave,6648,N,OP,47,70,117,84,Fall2018
614,700 Block NE 122nd,6649,S,AT,57,43,100,87,Fall2018
3768,SE 122nd & Midland Library (Morrison),6650,S,AT,62,43,105,43,Fall2018
1816,NE 122nd & Multnomah,6651,N,NS,9,24,33,7,Fall2018
3771,SE 122nd & Oak,6652,N,OP,98,155,253,77,Fall2018
3772,SE 122nd & Oak,6653,S,NS,48,38,86,26,Fall2018
1821,NE 122nd & Shaver,6654,N,NS,19,118,137,32,Fall2018
3773,SE 122nd & Powell,6655,N,FS,279,79,358,121,Fall2018
3775,SE 122nd & Ramona,6657,N,NS,45,9,54,5,Fall2018
3776,SE 122nd & Ramona,6658,S,OP,10,43,53,9,Fall2018
3777,SE 122nd & Raymond,6660,N,FS,27,3,30,2,Fall2018
3779,SE 122nd & Reedway,6662,S,NS,4,13,17,24,Fall2018
1818,NE 122nd & Sacramento,6667,S,NS,15,16,31,8,Fall2018
3780,SE 122nd & Rhone,6668,S,NS,151,114,265,88,Fall2018
3781,SE 122nd & Salmon,6669,N,FS,12,21,33,3,Fall2018
1819,NE 122nd & San Rafael,6670,N,NS,47,72,119,52,Fall2018
1820,NE 122nd & San Rafael,6671,S,FS,72,50,122,44,Fall2018
1822,NE 122nd & Shaver,6672,S,NS,102,38,140,28,Fall2018
1823,NE 122nd & Stanton,6673,N,NS,12,24,36,3,Fall2018
1824,NE 122nd & Stanton,6674,S,NS,29,18,47,15,Fall2018
3786,SE 122nd & Woodward Pl,6675,N,OP,22,9,31,20,Fall2018
3787,SE 122nd & Woodward Pl,6676,S,FS,7,20,27,7,Fall2018
1826,NE 125th Pl & Riverwood 40,6682,E,NS,1,9,10,0,Fall2018
1827,NE 125th Pl & Shaver,6683,N,FS,1,5,6,0,Fall2018
3800,SE 13th & Clatsop,6688,N,NS,12,1,13,0,Fall2018
5683,SW 13th & Custer,6689,N,NS,2,8,10,0,Fall2018
3801,SE 13th & Knapp,6691,N,NS,10,1,11,0,Fall2018
3802,SE 13th & Lambert,6693,N,NS,28,4,32,0,Fall2018
3803,SE 13th & Lambert,6694,S,NS,3,23,26,1,Fall2018
3804,SE 13th & Nehalem,6699,N,NS,35,6,41,2,Fall2018
3805,SE 13th & Nehalem,6700,S,NS,3,30,33,2,Fall2018
3806,SE 13th & Sellwood,6707,S,NS,1,6,7,0,Fall2018
3807,SE 13th & Tacoma,6708,N,NS,40,6,46,4,Fall2018
3808,SE 13th & Tacoma,6709,S,FS,9,43,52,7,Fall2018
3809,SE 13th & Umatilla,6711,N,NS,12,3,15,0,Fall2018
1834,NE 132nd & Brazee,6713,S,NS,2,0,2,0,Fall2018
1835,NE 132nd & Eugene,6714,N,FS,0,1,1,0,Fall2018
1836,NE 132nd & Eugene,6715,S,NS,1,0,1,0,Fall2018
1837,NE 132nd & Knott,6716,N,OP,1,5,6,1,Fall2018
1838,NE 132nd & San Rafael,6718,S,NS,1,0,1,0,Fall2018
1839,NE 133rd & Shaver,6719,S,NS,0,1,1,0,Fall2018
1840,NE 135th & Fremont,6720,S,FS,6,6,12,6,Fall2018
1841,NE 135th & Rose Parkway,6722,S,NS,3,3,6,0,Fall2018
586,6000 Block SE 136th,6723,N,AT,11,3,14,0,Fall2018
3794,SE 136th & Center,6725,N,FS,12,1,13,0,Fall2018
3796,SE 136th & Mall,6728,N,NS,15,2,17,19,Fall2018
3797,SE 136th & Ramona,6729,N,OP,14,5,19,0,Fall2018
3798,SE 136th & Ramona,6730,S,NS,5,17,22,2,Fall2018
3799,SE 136th & Rhone,6731,N,FS,22,4,26,1,Fall2018
5684,SW 14th Dr & Battaglia,6735,E,NS,0,0,0,0,Fall2018
5685,SW 14th Dr & Battaglia,6736,W,OP,0,0,0,0,Fall2018
5686,SW 14th Dr & Binford,6737,E,NS,1,0,1,0,Fall2018
5687,SW 14th Dr & Binford,6738,W,OP,1,1,2,0,Fall2018
5688,SW 14th Dr & Birdsdale,6739,E,NS,1,0,1,0,Fall2018
5689,SW 14th Dr & Birdsdale,6740,W,OP,0,1,1,0,Fall2018
5692,SW 14th Dr & Tegart,6742,E,FS,3,1,4,10,Fall2018
5693,SW 14th Dr & Tegart,6743,W,OP,1,1,2,5,Fall2018
5691,SW 14th Dr & Pleasant View Dr,6744,E,NS,2,1,3,0,Fall2018
5690,SW 14th Dr & Pleasant View,6745,W,NS,1,1,2,2,Fall2018
1843,NE 141st & Failing,6746,N,NS,6,0,6,0,Fall2018
1842,NE 141st & Beech,6747,S,FS,2,6,8,2,Fall2018
1844,NE 141st & Failing,6748,S,FS,6,3,9,5,Fall2018
1845,NE 141st & Fremont,6749,S,NS,2,3,5,0,Fall2018
1846,NE 141st & Milton Ct,6750,N,FS,5,0,5,1,Fall2018
1847,NE 143rd & Fremont Ct,6755,N,NS,1,1,2,0,Fall2018
1848,NE 145th & Fremont,6765,N,NS,7,4,11,0,Fall2018
1864,NE 15th & Ainsworth,6771,N,NS,2,37,39,12,Fall2018
1865,NE 15th & Ainsworth,6772,S,NS,45,2,47,5,Fall2018
1866,NE 15th & Alberta,6773,N,NS,37,245,282,33,Fall2018
1867,NE 15th & Alberta,6774,S,FS,181,48,229,30,Fall2018
1868,NE 15th & Brazee,6777,N,NS,6,33,39,2,Fall2018
1869,NE 15th & Brazee,6778,S,NS,22,5,27,0,Fall2018
1915,NE 15th & Weidler,6779,S,NS,59,79,138,33,Fall2018
1871,NE 15th & Dekum,6780,N,NS,1,78,79,8,Fall2018
1874,NE 15th & Failing,6783,N,NS,9,39,48,4,Fall2018
1875,NE 15th & Failing,6784,S,NS,47,4,51,1,Fall2018
1876,NE 15th & Fremont,6785,N,NS,35,131,166,39,Fall2018
1877,NE 15th & Fremont,6786,S,NS,117,36,153,38,Fall2018
1878,NE 15th & Going,6787,N,NS,2,42,44,3,Fall2018
1879,NE 15th & Going,6788,S,NS,50,4,54,2,Fall2018
1880,NE 15th & Halsey,6789,S,FS,29,21,50,9,Fall2018
1883,NE 15th & Holman,6790,N,NS,1,40,41,12,Fall2018
1885,NE 15th & Jarrett,6792,N,NS,3,32,35,8,Fall2018
1886,NE 15th & Jarrett,6793,S,NS,39,2,41,5,Fall2018
1889,NE 15th & Junior,6794,S,NS,78,4,82,10,Fall2018
1890,NE 15th & Killingsworth,6795,N,NS,10,88,98,10,Fall2018
1891,NE 15th & Killingsworth,6796,S,NS,77,10,87,5,Fall2018
1884,NE 15th & Holman,6797,S,FS,35,1,36,29,Fall2018
1892,NE 15th & Knott,6799,N,NS,6,48,54,1,Fall2018
1893,NE 15th & Knott,6800,S,NS,47,6,53,1,Fall2018
1894,NE 15th & Mason,6801,N,NS,4,36,40,8,Fall2018
1895,NE 15th & Mason,6802,S,NS,41,3,44,5,Fall2018
1900,NE 15th & Rosa Parks Way,6803,N,NS,1,28,29,5,Fall2018
1901,NE 15th & Rosa Parks Way,6804,S,NS,42,2,44,1,Fall2018
1898,NE 15th & Prescott,6805,S,FS,52,4,56,1,Fall2018
1908,NE 15th & Siskiyou,6808,N,NS,4,45,49,2,Fall2018
1909,NE 15th & Siskiyou,6809,S,NS,38,5,43,0,Fall2018
1899,NE 15th & Prescott,6810,N,NS,4,63,67,1,Fall2018
1910,NE 15th & Sumner,6813,S,NS,47,4,51,9,Fall2018
1911,NE 15th & Sumner,6814,N,NS,2,20,22,1,Fall2018
1912,NE 15th & Thompson,6815,N,NS,6,27,33,1,Fall2018
1913,NE 15th & Thompson,6816,S,NS,23,3,26,0,Fall2018
1914,NE 15th & Tillamook,6817,S,FS,52,16,68,34,Fall2018
1930,NE 16th & Multnomah,6818,S,NS,37,21,58,13,Fall2018
3134,NW 158th & Greenbrier Pkwy,6828,N,FS,6,25,31,1,Fall2018
3135,NW 158th & Greenbrier Pkwy,6829,S,OP,23,3,26,0,Fall2018
5695,SW 158th & Jay,6830,N,NS,1,1,2,0,Fall2018
5699,SW 158th & Walker,6832,N,FS,14,28,42,4,Fall2018
5700,SW 158th & Walker,6833,S,FS,13,13,26,4,Fall2018
1882,NE 15th & Hancock,6834,N,NS,21,54,75,54,Fall2018
219,16th & Harrison,6835,W,NS,1,1,2,0,Fall2018
220,16th & Harrison,6836,E,NS,1,1,2,0,Fall2018
221,16th & Jackson,6837,W,NS,1,1,2,0,Fall2018
1932,NE 16th & Sandy,6839,N,NS,85,144,229,35,Fall2018
222,16th & Taylor,6840,E,NS,0,1,1,0,Fall2018
223,16th & Taylor,6841,W,NS,0,0,0,0,Fall2018
1931,NE 16th & Multnomah,6842,N,FS,19,54,73,15,Fall2018
1870,NE 15th & Broadway,6843,N,NS,82,76,158,34,Fall2018
3855,SE 17th & Mitchell,6846,S,FS,3,20,23,7,Fall2018
3835,SE 17th & Bybee,6847,S,NS,18,39,57,7,Fall2018
3836,SE 17th & Bybee,6848,N,NS,9,14,23,7,Fall2018
3837,SE 17th & Center,6849,N,NS,150,94,244,15,Fall2018
3838,SE 17th & Center,6850,S,NS,99,130,229,16,Fall2018
3839,SE 17th & Clatsop,6852,S,NS,6,30,36,5,Fall2018
3853,SE 17th & Marion,6853,N,NS,14,4,18,1,Fall2018
3840,SE 17th & Claybourne,6856,N,NS,21,8,29,5,Fall2018
3841,SE 17th & Claybourne,6857,S,NS,7,16,23,5,Fall2018
3842,SE 17th & Harney,6860,N,NS,7,2,9,0,Fall2018
3843,SE 17th & Harold,6861,N,NS,13,3,16,3,Fall2018
3844,SE 17th & Harold,6862,S,NS,4,11,15,0,Fall2018
3845,SE 17th & Knight,6867,N,NS,16,4,20,1,Fall2018
3846,SE 17th & Knight,6868,S,NS,3,17,20,0,Fall2018
3847,SE 17th & Lava,6871,N,OP,12,1,13,1,Fall2018
3848,SE 17th & Lava,6872,S,FS,1,9,10,0,Fall2018
3849,SE 17th & Lexington,6873,N,NS,15,3,18,1,Fall2018
3850,SE 17th & Lexington,6874,S,NS,2,26,28,0,Fall2018
3851,SE 17th & Mall,6876,N,OP,51,119,170,28,Fall2018
3852,SE 17th & Mall,6877,S,NS,99,36,135,15,Fall2018
3854,SE 17th & McLoughlin,6882,N,NS,23,4,27,9,Fall2018
3856,SE 17th & Ochoco St,6885,N,NS,36,22,58,5,Fall2018
3857,SE 17th & Ochoco St,6886,S,NS,13,33,46,5,Fall2018
3858,SE 17th & Rex,6889,N,NS,6,2,8,0,Fall2018
3859,SE 17th & Rex,6890,S,NS,1,16,17,0,Fall2018
3862,SE 17th & Schiller,6893,N,FS,4,2,6,0,Fall2018
3869,SE 17th & Schiller,6894,S,NS,2,4,6,1,Fall2018
3871,SE 17th & Tacoma,6896,S,NS,7,47,54,6,Fall2018
3872,SE 17th & Tenino,6897,N,NS,40,5,45,2,Fall2018
3873,SE 17th & Tolman,6898,N,NS,17,6,23,5,Fall2018
3874,SE 17th & Tolman,6899,S,NS,5,23,28,2,Fall2018
3875,SE 17th & Umatilla,6900,S,FS,5,34,39,7,Fall2018
3876,SE 17th & Waverly,6901,N,NS,6,6,12,0,Fall2018
3877,SE 17th & Waverly,6902,S,NS,3,7,10,1,Fall2018
3144,NW 174th & Santiam,6904,N,OP,1,4,5,0,Fall2018
3145,NW 174th & Santiam,6905,S,FS,5,1,6,0,Fall2018
5750,SW 18th & Elizabeth,6908,N,FS,3,0,3,0,Fall2018
1933,NE 181st & Davis,6912,S,NS,1,8,9,2,Fall2018
3884,SE 181st & Yamhill,6913,N,FS,5,7,12,1,Fall2018
1934,NE 181st & E Burnside,6914,N,FS,62,45,107,15,Fall2018
657,800 Block NE 181st,6916,N,AT,9,9,18,1,Fall2018
1935,NE 181st & Everett Ct,6918,N,NS,3,3,6,1,Fall2018
1936,NE 181st & Glisan,6919,N,NS,7,8,15,3,Fall2018
1937,NE 181st & Glisan,6920,S,FS,10,17,27,6,Fall2018
3883,SE 181st & Oak,6921,N,NS,31,26,57,9,Fall2018
1943,NE 181st & Wasco,6922,N,OP,3,5,8,1,Fall2018
1944,NE 181st & Wasco,6923,S,NS,13,4,17,1,Fall2018
258,1900 Block SE 182nd,6924,N,AT,8,2,10,3,Fall2018
3887,SE 182nd & 3rd,6926,N,FS,2,1,3,1,Fall2018
3898,SE 182nd & SW 5th Dr,6928,N,NS,3,0,3,2,Fall2018
3885,SE 181st & Yamhill,6929,S,NS,5,3,8,2,Fall2018
3888,SE 182nd & Brooklyn Ct,6930,N,NS,7,1,8,0,Fall2018
3893,SE 182nd & Haig,6931,N,NS,18,1,19,1,Fall2018
3890,SE 182nd & Clinton,6934,N,NS,2,1,3,0,Fall2018
3891,SE 182nd & Division,6935,S,FS,9,36,45,12,Fall2018
3892,SE 182nd & Division,6936,N,FS,50,10,60,16,Fall2018
3894,SE 182nd & Lincoln,6937,S,FS,2,7,9,3,Fall2018
3895,SE 182nd & Market,6938,S,NS,4,6,10,2,Fall2018
3896,SE 182nd & Market,6939,N,OP,9,2,11,1,Fall2018
3897,SE 182nd & Mill,6940,N,NS,4,1,5,0,Fall2018
3901,SE 182nd & W Powell,6942,N,FS,35,0,35,5,Fall2018
3899,SE 182nd & Stephens,6943,S,NS,3,4,7,0,Fall2018
3900,SE 182nd & Tibbetts,6944,S,NS,2,7,9,0,Fall2018
386,2800 Block SW 185th,6945,N,AT,19,11,30,0,Fall2018
424,3000 Block SW 185th,6946,S,AT,11,14,25,0,Fall2018
5714,SW 185th & Aloha High School Drive,6952,S,NS,13,15,28,1,Fall2018
3146,NW 185th & Adrian,6953,N,OP,2,5,7,2,Fall2018
3147,NW 185th & Adrian,6954,S,FS,6,2,8,2,Fall2018
5715,SW 185th & Aloha Park Apts,6955,N,OP,7,16,23,0,Fall2018
5716,SW 185th & Aloha Park Apts,6956,S,AT,13,13,26,2,Fall2018
5712,SW 185th & Alexander,6957,N,FS,52,12,64,11,Fall2018
5717,SW 185th & Blanton,6959,S,FS,11,8,19,9,Fall2018
5724,SW 185th & Blanton,6960,N,OP,13,13,26,7,Fall2018
3150,NW 185th & Cornell,6961,N,FS,33,186,219,31,Fall2018
3151,NW 185th & Cornell,6964,S,FS,168,43,211,28,Fall2018
5726,SW 185th & Ewen,6968,N,FS,6,2,8,0,Fall2018
5727,SW 185th & Ewen,6969,S,OP,5,6,11,0,Fall2018
5728,SW 185th & Farmington,6970,N,FS,96,85,181,11,Fall2018
3153,NW 185th & Heritage Pkwy,6972,N,FS,25,20,45,2,Fall2018
3154,NW 185th & Heritage Pkwy,6975,S,FS,16,32,48,8,Fall2018
5729,SW 185th & Honeywood,6976,S,FS,2,1,3,0,Fall2018
5730,SW 185th & Jay,6977,N,FS,4,4,8,0,Fall2018
5731,SW 185th & Johnson,6978,N,FS,43,21,64,1,Fall2018
5732,SW 185th & Johnson,6979,S,FS,20,38,58,2,Fall2018
5733,SW 185th & Kinnaman,6980,N,NS,65,59,124,12,Fall2018
5734,SW 185th & Kinnaman,6981,S,FS,64,69,133,10,Fall2018
5735,SW 185th & Longacre,6982,N,FS,4,6,10,0,Fall2018
5736,SW 185th & Longacre,6983,S,FS,4,4,8,2,Fall2018
5737,SW 185th & Madeline,6984,N,NS,20,14,34,0,Fall2018
3157,NW 185th & McKinley School,6986,N,NS,14,42,56,8,Fall2018
3163,NW 185th & Sunset Square,6987,S,AT,67,28,95,18,Fall2018
3155,NW 185th & Holly,6990,N,OP,6,9,15,1,Fall2018
3156,NW 185th & Holly,6991,S,FS,6,7,13,1,Fall2018
3159,NW 185th & Parkview,6992,N,FS,7,27,34,1,Fall2018
5738,SW 185th & Pheasant,6993,N,FS,4,1,5,0,Fall2018
5739,SW 185th & Pheasant,6994,S,OP,1,2,3,0,Fall2018
5740,SW 185th & Pike,6995,N,NS,5,5,10,0,Fall2018
5741,SW 185th & Pike,6996,S,FS,4,6,10,2,Fall2018
3148,NW 185th & Bronson,6999,S,OP,21,3,24,0,Fall2018
3170,NW 185th & Westview HS,7000,N,AT,9,53,62,2,Fall2018
3161,NW 185th & Rock Creek School,7001,S,AT,71,11,82,7,Fall2018
5742,SW 185th & Rosa,7002,N,FS,12,20,32,1,Fall2018
5743,SW 185th & Rosa,7003,S,NS,24,24,48,3,Fall2018
5725,SW 185th & Edgeway Dr,7006,S,NS,1,8,9,0,Fall2018
5744,SW 185th & Salix Terrace,7007,N,FS,12,2,14,2,Fall2018
5745,SW 185th & Sandra,7009,S,OP,12,13,25,0,Fall2018
5746,SW 185th & Sandra,7010,N,FS,10,4,14,0,Fall2018
3162,NW 185th & Springville,7011,N,NS,0,13,13,2,Fall2018
5747,SW 185th & Tualatin Valley Hwy,7012,N,NS,96,70,166,22,Fall2018
5748,SW 185th & Tualatin Valley Hwy,7013,S,FS,72,64,136,11,Fall2018
3164,NW 185th & Tamarack,7014,N,FS,0,8,8,0,Fall2018
3165,NW 185th & Tamarack,7015,S,OP,8,0,8,0,Fall2018
615,700 Block NW 185th,7020,N,AT,13,44,57,7,Fall2018
616,700 Block NW 185th,7021,S,AT,26,15,41,9,Fall2018
5749,SW 185th & W Baseline,7023,S,FS,21,15,36,4,Fall2018
3167,NW 185th & Walker,7024,N,FS,45,77,122,12,Fall2018
3158,NW 185th & NE Walker,7025,S,FS,92,46,138,8,Fall2018
3168,NW 185th & West Union,7026,N,FS,7,70,77,12,Fall2018
3169,NW 185th & West Union,7027,S,NS,87,6,93,15,Fall2018
5796,SW 19th & Barbur,7036,S,FS,7,6,13,0,Fall2018
279,19th & Birch,7038,E,NS,33,2,35,7,Fall2018
280,19th & Cedar,7041,E,NS,64,2,66,8,Fall2018
281,19th & Elm,7043,E,NS,70,3,73,39,Fall2018
282,19th & Hawthorne,7044,E,NS,53,3,56,7,Fall2018
283,19th & Main,7046,E,FS,88,1,89,16,Fall2018
5797,SW 19th & Multnomah,7047,N,FS,5,9,14,0,Fall2018
284,19th Way & 19th Ave,7048,E,FS,133,34,167,40,Fall2018
5799,SW 19th & Spring Garden,7049,S,NS,2,3,5,0,Fall2018
618,700 Block SW 197th,7052,S,OP,4,4,8,0,Fall2018
5757,SW 197th & W Baseline,7053,N,NS,8,6,14,0,Fall2018
5755,SW 197th & Frances,7054,S,FS,3,7,10,19,Fall2018
5758,SW 198th & Blanton,7060,N,NS,6,4,10,1,Fall2018
5759,SW 198th & Blanton,7061,S,NS,9,6,15,1,Fall2018
5760,SW 198th & Butternut,7062,N,FS,2,1,3,4,Fall2018
5761,SW 198th & Butternut,7063,S,OP,1,1,2,5,Fall2018
5762,SW 198th & Carlin,7064,S,FS,21,15,36,0,Fall2018
5763,SW 198th & Carlin,7065,N,OP,15,18,33,2,Fall2018
5764,SW 198th & Celebrity,7066,S,NS,4,4,8,2,Fall2018
5765,SW 198th & Celebrity,7067,N,FS,3,3,6,0,Fall2018
5766,SW 198th & Deline,7068,S,FS,6,7,13,0,Fall2018
5767,SW 198th & Deline,7069,N,OP,5,4,9,0,Fall2018
5768,SW 198th & Farmington,7070,S,NS,24,18,42,0,Fall2018
5769,SW 198th & Farmington,7071,N,FS,21,24,45,0,Fall2018
5770,SW 198th & Imperial,7072,S,NS,3,3,6,3,Fall2018
5777,SW 198th & Johnson,7073,S,FS,3,4,7,0,Fall2018
5778,SW 198th & Johnson,7074,N,NS,5,3,8,0,Fall2018
5779,SW 198th & Kinnaman,7075,S,NS,7,8,15,0,Fall2018
5780,SW 198th & Kinnaman,7076,N,NS,8,9,17,0,Fall2018
5783,SW 198th & Prospect,7077,N,FS,3,2,5,0,Fall2018
5784,SW 198th & Prospect,7078,S,OP,2,2,4,0,Fall2018
5785,SW 198th & Rock Dr,7079,S,NS,7,11,18,0,Fall2018
5787,SW 198th & Rosa,7082,N,FS,13,10,23,10,Fall2018
5788,SW 198th & Rosa,7083,S,FS,11,10,21,10,Fall2018
5789,SW 198th & Sandra,7084,N,NS,4,4,8,0,Fall2018
5790,SW 198th & Southview,7086,S,FS,4,11,15,1,Fall2018
5791,SW 198th & Southview,7087,N,NS,10,4,14,0,Fall2018
5792,SW 198th & Trelane,7089,S,OP,4,2,6,0,Fall2018
5793,SW 198th & Trelane,7090,N,FS,3,2,5,0,Fall2018
5781,SW 198th & Oak,7092,N,FS,4,3,7,0,Fall2018
5794,SW 198th & York,7093,S,NS,3,7,10,0,Fall2018
5795,SW 198th & York,7094,N,FS,5,3,8,0,Fall2018
5820,SW 2nd & Alder,7095,N,NS,336,33,369,21,Fall2018
5821,SW 2nd & Taylor,7098,N,NS,146,62,208,8,Fall2018
3683,S 2nd & Tumwater,7101,W,FS,5,3,8,0,Fall2018
1948,NE 21st & Argyle,7105,N,NS,0,20,20,0,Fall2018
1949,NE 21st & Clackamas,7106,S,NS,9,2,11,3,Fall2018
1950,NE 21st & Clackamas,7107,N,NS,6,8,14,1,Fall2018
3905,SE 21st & Clinton,7108,S,NS,13,8,21,0,Fall2018
3906,SE 21st & Division,7110,N,NS,9,19,28,2,Fall2018
3171,NW 21st & Glisan,7112,S,NS,113,12,125,23,Fall2018
3172,NW 21st & Irving,7113,N,NS,7,63,70,16,Fall2018
3173,NW 21st & Irving,7114,S,NS,80,5,85,4,Fall2018
3180,NW 21st & Lovejoy,7121,S,NS,111,6,117,36,Fall2018
3181,NW 21st & Lovejoy,7122,N,FS,6,103,109,39,Fall2018
3182,NW 21st & Northrup,7127,S,NS,76,4,80,8,Fall2018
3183,NW 21st & Northrup,7128,N,NS,5,53,58,33,Fall2018
3184,NW 21st & Pettygrove,7130,N,FS,3,61,64,5,Fall2018
3908,SE 21st & Washington,7136,S,NS,141,149,290,49,Fall2018
1953,NE 21st & Weidler,7138,N,NS,10,23,33,9,Fall2018
1954,NE 21st & Weidler,7139,S,NS,17,13,30,19,Fall2018
3925,SE 22nd & Bluebird,7141,S,NS,1,1,2,0,Fall2018
3926,SE 22nd & Wren,7144,S,FS,0,1,1,0,Fall2018
3909,SE 223rd & Ankeny,7145,N,OP,2,1,3,0,Fall2018
3910,SE 223rd & Ankeny,7146,S,FS,2,3,5,1,Fall2018
3912,SE 223rd & Oak,7149,S,NS,6,35,41,9,Fall2018
3913,SE 223rd & Salmon,7150,N,NS,2,2,4,1,Fall2018
3914,SE 223rd & Salmon,7151,S,OP,2,2,4,2,Fall2018
3915,SE 223rd & Stark,7152,N,FS,83,9,92,14,Fall2018
3923,SE 223rd & Yamhill,7153,N,OP,2,4,6,0,Fall2018
3924,SE 223rd & Yamhill,7154,S,NS,5,4,9,0,Fall2018
3927,SE 23rd & Bybee,7156,S,NS,0,1,1,0,Fall2018
3187,NW 23rd & Flanders,7157,N,NS,18,57,75,14,Fall2018
3189,NW 23rd & Irving,7161,N,NS,10,74,84,5,Fall2018
3190,NW 23rd & Irving,7162,S,NS,137,14,151,13,Fall2018
3191,NW 23rd & Lovejoy,7163,N,NS,14,177,191,102,Fall2018
3525,NW Thurman & 22nd,7168,E,NS,34,1,35,3,Fall2018
3197,NW 23rd & Thurman,7169,N,FS,4,73,77,8,Fall2018
3928,SE 23rd & Tolman (Union Manor),7172,N,NS,27,17,44,137,Fall2018
3199,NW 23rd & Westover,7174,S,NS,34,25,59,5,Fall2018
1967,NE 24th & Broadway,7188,N,FS,16,52,68,31,Fall2018
1968,NE 24th & Fremont,7190,N,FS,5,25,30,1,Fall2018
1969,NE 24th & Fremont,7191,S,NS,26,6,32,1,Fall2018
1970,NE 24th & Hancock,7193,S,NS,15,3,18,0,Fall2018
1971,NE 24th & Klickitat,7194,N,NS,1,15,16,0,Fall2018
1972,NE 24th & Klickitat,7196,S,NS,16,2,18,0,Fall2018
1973,NE 24th & Knott,7197,N,NS,2,30,32,1,Fall2018
1974,NE 24th & Knott,7198,S,NS,29,2,31,0,Fall2018
1975,NE 24th & Siskiyou,7201,N,NS,2,29,31,1,Fall2018
1976,NE 24th & Siskiyou,7202,S,NS,29,2,31,0,Fall2018
1977,NE 24th & Thompson,7205,S,NS,17,2,19,0,Fall2018
1978,NE 24th & Thompson,7206,N,NS,2,12,14,1,Fall2018
1979,NE 24th & Tillamook,7208,N,NS,2,9,11,0,Fall2018
3932,SE 25th & Morrison,7216,N,NS,45,6,51,2,Fall2018
4364,SE Clinton & 26th,7223,W,FS,15,19,34,0,Fall2018
3933,SE 26th & Gladstone,7224,S,NS,2,10,12,0,Fall2018
3934,SE 26th & Kelly,7226,S,OP,32,11,43,0,Fall2018
3935,SE 26th & Powell,7227,N,FS,58,163,221,1,Fall2018
3936,SE 26th & Powell,7228,S,NS,94,55,149,3,Fall2018
3937,SE 26th & Rhone,7230,S,OP,14,10,24,0,Fall2018
3938,SE 26th & Rhone,7231,N,NS,15,13,28,0,Fall2018
3939,SE 26th & Tibbetts,7232,N,NS,9,2,11,0,Fall2018
3940,SE 26th & Woodward,7233,S,NS,31,6,37,0,Fall2018
3941,SE 26th & Woodward,7234,N,NS,7,1,8,0,Fall2018
1985,NE 27th & Ainsworth,7235,N,NS,0,34,34,29,Fall2018
1986,NE 27th & Ainsworth,7236,S,NS,39,1,40,28,Fall2018
1987,NE 27th & Alberta,7237,S,FS,74,18,92,19,Fall2018
1988,NE 27th & Alberta,7238,N,NS,7,81,88,21,Fall2018
1989,NE 27th & Dekum,7240,N,NS,0,24,24,2,Fall2018
1990,NE 27th & Highland,7245,S,NS,15,0,15,1,Fall2018
1992,NE 27th & Holman,7246,N,NS,0,27,27,2,Fall2018
1993,NE 27th & Holman,7247,S,NS,36,0,36,2,Fall2018
1994,NE 27th & Jarrett,7248,N,NS,1,17,18,9,Fall2018
1995,NE 27th & Jarrett,7249,S,NS,13,0,13,1,Fall2018
1996,NE 27th & Killingsworth,7250,N,NS,1,29,30,1,Fall2018
1997,NE 27th & Killingsworth,7251,S,NS,29,2,31,0,Fall2018
1998,NE 27th & Prescott,7256,N,NS,1,24,25,0,Fall2018
1999,NE 27th & Prescott,7257,S,NS,27,2,29,0,Fall2018
2000,NE 27th & Sumner,7260,N,NS,1,24,25,3,Fall2018
2001,NE 27th & Sumner,7261,S,NS,41,1,42,0,Fall2018
2002,NE 27th & Wygant,7266,S,FS,13,0,13,0,Fall2018
2003,NE 27th & Wygant,7267,N,NS,0,13,13,0,Fall2018
3950,SE 28th & Bybee,7270,N,NS,2,0,2,0,Fall2018
3952,SE 28th & Gladstone,7277,N,NS,23,4,27,1,Fall2018
3953,SE 28th & Holgate,7281,S,FS,13,24,37,1,Fall2018
3954,SE 28th & Holgate,7282,N,NS,26,14,40,0,Fall2018
3955,SE 28th & Martins,7286,N,NS,0,1,1,0,Fall2018
3956,SE 28th & Raymond,7288,S,NS,8,22,30,0,Fall2018
3957,SE 28th & Raymond,7289,N,OP,33,7,40,1,Fall2018
395,28th & Rex,7290,S,NS,0,4,4,0,Fall2018
3958,SE 28th & Steele,7293,S,NS,12,20,32,0,Fall2018
3959,SE 28th & Tolman,7294,N,NS,0,2,2,0,Fall2018
3960,SE 28th & Tolman,7295,S,NS,2,0,2,0,Fall2018
3942,SE 282nd & Chase,7297,N,NS,0,1,1,1,Fall2018
3943,SE 282nd & Chase,7298,S,NS,2,0,2,0,Fall2018
3944,SE 282nd & Orient,7303,S,NS,1,0,1,0,Fall2018
2004,NE 29th & Alameda,7306,N,NS,1,17,18,0,Fall2018
2005,NE 29th & Alameda,7307,S,NS,13,1,14,0,Fall2018
2006,NE 29th & Bryce,7309,N,NS,0,22,22,0,Fall2018
2007,NE 29th & Bryce,7310,S,NS,20,0,20,0,Fall2018
3204,NW 29th & Industrial,7311,N,NS,1,23,24,1,Fall2018
3205,NW 29th & Industrial,7313,S,NS,32,1,33,1,Fall2018
3206,NW 29th & Nela,7314,N,NS,1,12,13,5,Fall2018
3207,NW 29th & Nela,7315,S,OP,21,1,22,2,Fall2018
3208,NW 29th & Nicolai,7316,S,NS,12,0,12,0,Fall2018
2014,NE 29th & Skidmore,7317,N,NS,1,30,31,6,Fall2018
3203,NW 29th & 31st,7320,N,OP,1,19,20,0,Fall2018
2015,NE 30th & Alberta,7326,S,NS,19,23,42,17,Fall2018
2016,NE 30th & Emerson,7327,N,NS,6,8,14,2,Fall2018
2017,NE 30th & Emerson,7328,S,NS,9,11,20,1,Fall2018
2018,NE 30th & Killingsworth,7329,N,NS,23,17,40,2,Fall2018
3963,SE 32nd & Floss,7334,S,OP,7,6,13,0,Fall2018
3961,SE 32nd & Bybee,7335,N,NS,1,4,5,0,Fall2018
3962,SE 32nd & Bybee,7336,S,NS,5,1,6,0,Fall2018
3968,SE 32nd & Hillside,7339,N,OP,19,9,28,25,Fall2018
3966,SE 32nd & Harvey,7340,S,OP,3,5,8,1,Fall2018
3967,SE 32nd & Harvey,7341,N,NS,5,5,10,1,Fall2018
3975,SE 32nd & Hillside,7342,S,NS,12,17,29,21,Fall2018
3977,SE 32nd & Knapp,7344,N,NS,1,4,5,0,Fall2018
3978,SE 32nd & Knapp,7345,S,NS,3,0,3,0,Fall2018
3979,SE 32nd & Malcolm,7346,N,OP,5,5,10,0,Fall2018
3980,SE 32nd & Malcolm,7347,S,FS,5,3,8,0,Fall2018
3981,SE 32nd & Meek,7349,S,NS,4,10,14,6,Fall2018
3983,SE 32nd & Olsen,7350,N,NS,9,6,15,0,Fall2018
3984,SE 32nd & Olsen,7351,S,FS,6,7,13,0,Fall2018
3985,SE 32nd & Rex,7352,S,NS,16,4,20,0,Fall2018
3986,SE 32nd & Tolman,7357,N,NS,0,3,3,0,Fall2018
3987,SE 32nd & Tolman,7358,S,NS,4,1,5,0,Fall2018
3988,SE 32nd & Van Water,7359,N,OP,1,2,3,0,Fall2018
3990,SE 32nd & Woodstock,7360,N,NS,4,12,16,1,Fall2018
2019,NE 33rd & Ainsworth,7361,S,FS,9,0,9,1,Fall2018
2020,NE 33rd & Ainsworth,7362,N,NS,0,8,8,1,Fall2018
2022,NE 33rd & Alberta,7363,S,NS,28,1,29,2,Fall2018
2023,NE 33rd & Alberta Ct,7364,N,NS,0,12,12,0,Fall2018
2024,NE 33rd & Brazee,7365,N,OP,2,4,6,0,Fall2018
2025,NE 33rd & Brazee,7366,S,NS,9,3,12,0,Fall2018
2026,NE 33rd & Bryce,7368,S,NS,4,1,5,0,Fall2018
2027,NE 33rd & Dekum,7369,N,NS,15,13,28,1,Fall2018
2028,NE 33rd & Dekum,7370,S,NS,20,18,38,3,Fall2018
2029,NE 33rd & Emerson,7371,N,NS,5,31,36,6,Fall2018
2030,NE 33rd & Emerson,7372,S,NS,31,5,36,1,Fall2018
2021,NE 33rd & Alameda,7373,N,NS,3,18,21,1,Fall2018
2031,NE 33rd & Fremont,7374,S,NS,13,4,17,0,Fall2018
2032,NE 33rd & Going,7375,N,NS,1,8,9,4,Fall2018
2033,NE 33rd & Hancock,7377,S,NS,5,6,11,1,Fall2018
2034,NE 33rd & Holman,7378,N,NS,1,15,16,3,Fall2018
2035,NE 33rd & Holman,7379,S,FS,16,2,18,0,Fall2018
2036,NE 33rd & Jarrett,7380,N,OP,2,12,14,12,Fall2018
2037,NE 33rd & Jarrett,7381,S,NS,12,2,14,8,Fall2018
2038,NE 33rd & Killingsworth,7382,S,NS,35,35,70,5,Fall2018
2039,NE 33rd & Killingsworth,7383,N,NS,24,39,63,5,Fall2018
2040,NE 33rd & Knott,7385,N,FS,2,6,8,0,Fall2018
2041,NE 33rd & Knott,7386,S,FS,7,2,9,0,Fall2018
2044,NE 33rd & Rosa Parks Way,7388,S,NS,12,0,12,2,Fall2018
2045,NE 33rd & Rosa Parks Way,7389,N,NS,0,8,8,1,Fall2018
2042,NE 33rd & Prescott,7390,N,NS,0,9,9,0,Fall2018
2043,NE 33rd & Prescott,7391,S,NS,18,1,19,0,Fall2018
2046,NE 33rd & Schuyler,7392,N,NS,16,11,27,5,Fall2018
2047,NE 33rd & Shaver,7393,N,NS,1,7,8,1,Fall2018
2048,NE 33rd & Shaver,7394,S,NS,7,1,8,0,Fall2018
2049,NE 33rd & Siskiyou,7395,N,NS,1,6,7,1,Fall2018
2050,NE 33rd & Siskiyou,7396,S,NS,9,1,10,1,Fall2018
2051,NE 33rd & Skidmore,7397,S,NS,8,0,8,0,Fall2018
2052,NE 33rd & Skidmore,7398,N,NS,1,10,11,1,Fall2018
2053,NE 33rd & Stanton,7399,N,FS,1,8,9,0,Fall2018
2054,NE 33rd & Stanton,7400,S,NS,6,1,7,0,Fall2018
2055,NE 33rd & US Grant Pl,7402,N,FS,4,4,8,0,Fall2018
2056,NE 33rd & US Grant Pl,7403,S,NS,2,2,4,0,Fall2018
2057,NE 33rd & Webster,7404,N,NS,1,10,11,0,Fall2018
3991,SE 34th & Sellwood,7407,N,NS,1,0,1,0,Fall2018
3992,SE 34th & Sellwood,7408,S,NS,0,1,1,0,Fall2018
3993,SE 34th & Washington,7409,N,NS,0,0,0,0,Fall2018
3994,SE 34th & Wister,7410,N,NS,1,0,1,0,Fall2018
3995,SE 34th & Wister,7411,S,NS,0,1,1,0,Fall2018
5822,SW 35th & Caldew,7412,S,NS,0,2,2,0,Fall2018
5823,SW 35th & Caldew,7413,N,OP,2,0,2,0,Fall2018
5830,SW 35th & California,7414,S,NS,0,2,2,0,Fall2018
5831,SW 35th & California,7415,N,OP,1,0,1,0,Fall2018
5832,SW 35th & Canby,7417,N,NS,1,0,1,0,Fall2018
5833,SW 35th & Huber,7419,S,NS,1,5,6,0,Fall2018
5834,SW 35th & Indian Hills Apts,7420,N,AT,7,1,8,0,Fall2018
5835,SW 35th & Indian Hills Apts,7421,S,OP,1,3,4,0,Fall2018
5836,SW 35th & Logan,7422,S,NS,0,2,2,0,Fall2018
5837,SW 35th & Logan,7423,N,OP,3,0,3,0,Fall2018
5838,SW 35th & Nevada,7425,S,NS,0,6,6,0,Fall2018
5839,SW 35th & Nevada,7426,N,NS,5,0,5,0,Fall2018
5840,SW 35th & Ridge Dr,7427,N,NS,3,2,5,0,Fall2018
5841,SW 35th & Ridge Dr,7428,S,OP,2,2,4,0,Fall2018
5842,SW 35th & Texas,7429,S,FS,0,1,1,0,Fall2018
5843,SW 35th & Texas,7430,N,OP,2,0,2,0,Fall2018
4308,SE Cesar Chavez Blvd & Alder,7434,S,NS,6,10,16,6,Fall2018
4309,SE Cesar Chavez Blvd & Ash,7435,N,NS,3,5,8,1,Fall2018
4310,SE Cesar Chavez Blvd & Ash,7436,S,OP,8,7,15,3,Fall2018
4311,SE Cesar Chavez Blvd & Belmont,7437,N,NS,109,152,261,44,Fall2018
4312,SE Cesar Chavez Blvd & Belmont,7438,S,NS,126,96,222,28,Fall2018
4313,SE Cesar Chavez Blvd & Brooklyn,7439,N,NS,12,2,14,0,Fall2018
4319,SE Cesar Chavez Blvd & E Burnside,7440,N,NS,52,134,186,29,Fall2018
2294,NE Cesar Chavez Blvd & E Burnside,7441,S,NS,142,45,187,24,Fall2018
4314,SE Cesar Chavez Blvd & Clinton,7442,N,NS,15,13,28,6,Fall2018
4315,SE Cesar Chavez Blvd & Clinton,7443,S,NS,7,14,21,1,Fall2018
4316,SE Cesar Chavez Blvd & Cora,7444,S,NS,3,10,13,1,Fall2018
4317,SE Cesar Chavez Blvd & Division,7445,N,FS,221,145,366,78,Fall2018
4318,SE Cesar Chavez Blvd & Division,7446,S,NS,169,222,391,105,Fall2018
4320,SE Cesar Chavez Blvd & Francis,7447,S,NS,11,28,39,4,Fall2018
4321,SE Cesar Chavez Blvd & Franklin,7448,S,NS,5,13,18,1,Fall2018
4322,SE Cesar Chavez Blvd & Gladstone,7449,N,FS,107,25,132,8,Fall2018
4323,SE Cesar Chavez Blvd & Gladstone,7450,S,NS,21,74,95,12,Fall2018
2295,NE Cesar Chavez Blvd & Glisan,7451,N,NS,30,77,107,35,Fall2018
2296,NE Cesar Chavez Blvd & Glisan,7452,S,AT,73,23,96,25,Fall2018
4324,SE Cesar Chavez Blvd & Harold,7456,N,NS,6,1,7,1,Fall2018
4325,SE Cesar Chavez Blvd & Harold,7457,S,NS,1,7,8,0,Fall2018
4326,SE Cesar Chavez Blvd & Hawthorne,7459,N,NS,191,214,405,100,Fall2018
4327,SE Cesar Chavez Blvd & Hawthorne,7460,S,NS,234,202,436,133,Fall2018
2298,NE Cesar Chavez Blvd & Hazelfern,7461,N,NS,1,5,6,0,Fall2018
4328,SE Cesar Chavez Blvd & Holgate,7463,S,NS,39,89,128,100,Fall2018
4329,SE Cesar Chavez Blvd & Kelly,7464,N,NS,11,3,14,0,Fall2018
4330,SE Cesar Chavez Blvd & Knight,7465,N,NS,40,4,44,1,Fall2018
4331,SE Cesar Chavez Blvd & Knight,7466,S,NS,2,43,45,3,Fall2018
4332,SE Cesar Chavez Blvd & Lafayette,7467,N,OP,27,33,60,12,Fall2018
4333,SE Cesar Chavez Blvd & Lincoln,7468,N,NS,26,11,37,2,Fall2018
4307,SE Cesar Chavez Blvd  & Lincoln,7469,S,NS,12,20,32,0,Fall2018
4334,SE Cesar Chavez Blvd & Long,7470,S,OP,32,46,78,62,Fall2018
4335,SE Cesar Chavez Blvd & Long,7471,N,OP,19,11,30,13,Fall2018
4336,SE Cesar Chavez Blvd & Main,7472,N,NS,42,18,60,14,Fall2018
4337,SE Cesar Chavez Blvd & Main,7473,S,NS,15,58,73,10,Fall2018
4338,SE Cesar Chavez Blvd & Mall,7474,N,NS,137,48,185,88,Fall2018
2299,NE Cesar Chavez Blvd & Multnomah,7475,N,NS,3,6,9,1,Fall2018
4339,SE Cesar Chavez Blvd & Powell,7476,S,NS,136,221,357,75,Fall2018
4346,SE Cesar Chavez Blvd & Powell,7477,N,FS,204,106,310,49,Fall2018
4347,SE Cesar Chavez Blvd & Raymond,7478,N,FS,9,3,12,1,Fall2018
4348,SE Cesar Chavez Blvd & Raymond,7479,S,FS,4,10,14,1,Fall2018
2300,NE Cesar Chavez Blvd & Royal,7482,N,NS,5,5,10,0,Fall2018
2301,NE Cesar Chavez Blvd & Royal Ct,7483,S,NS,6,3,9,0,Fall2018
2302,NE Cesar Chavez Blvd & Sandy,7484,N,NS,38,10,48,16,Fall2018
4349,SE Cesar Chavez Blvd & Stark,7485,N,NS,36,29,65,11,Fall2018
4350,SE Cesar Chavez Blvd & Stark,7486,S,NS,26,31,57,12,Fall2018
4351,SE Cesar Chavez Blvd & Steele,7487,N,NS,32,29,61,0,Fall2018
4352,SE Cesar Chavez Blvd & Steele,7488,S,NS,35,33,68,3,Fall2018
4353,SE Cesar Chavez Blvd & Stephens,7489,N,OP,7,4,11,1,Fall2018
4354,SE Cesar Chavez Blvd & Stephens,7490,S,NS,8,7,15,2,Fall2018
4355,SE Cesar Chavez Blvd & Taylor,7491,N,FS,17,29,46,6,Fall2018
4356,SE Cesar Chavez Blvd & Taylor,7492,S,NS,29,24,53,2,Fall2018
4357,SE Cesar Chavez Blvd & Tibbetts,7493,S,NS,4,12,16,1,Fall2018
2303,NE Cesar Chavez Blvd & Wasco,7494,S,NS,17,4,21,3,Fall2018
2069,NE 41st & Alameda,7497,N,OP,2,18,20,0,Fall2018
2072,NE 41st & Wistaria,7498,S,NS,11,2,13,0,Fall2018
2070,NE 41st & Klickitat,7499,N,FS,1,42,43,0,Fall2018
2071,NE 41st & Klickitat,7500,S,NS,22,1,23,0,Fall2018
2081,NE 42nd & Fremont,7501,N,FS,29,57,86,5,Fall2018
2073,NE 42nd & Alberta Ct,7504,S,NS,67,26,93,2,Fall2018
2074,NE 42nd & Alberta St,7505,N,NS,23,72,95,4,Fall2018
2075,NE 42nd & Beech,7506,N,NS,6,23,29,0,Fall2018
2076,NE 42nd & Brazee,7507,N,NS,5,8,13,1,Fall2018
2077,NE 42nd & Brazee,7508,S,NS,6,3,9,3,Fall2018
2078,NE 42nd & Broadway,7509,N,NS,116,75,191,73,Fall2018
2079,NE 42nd & Broadway,7510,S,FS,83,85,168,49,Fall2018
2080,NE 42nd & Failing,7511,S,NS,14,3,17,0,Fall2018
2082,NE 42nd & Fremont,7512,S,NS,57,34,91,3,Fall2018
2083,NE 42nd & Holman,7516,N,NS,12,38,50,4,Fall2018
2084,NE 42nd & Holman,7517,S,FS,42,10,52,1,Fall2018
2085,NE 42nd & Killingsworth,7519,S,NS,138,97,235,20,Fall2018
2086,NE 42nd & Killingsworth,7520,N,FS,102,159,261,26,Fall2018
2087,NE 42nd & Knott,7521,N,NS,4,10,14,0,Fall2018
2088,NE 42nd & Knott,7522,S,NS,10,2,12,0,Fall2018
3997,SE 42nd & Llewellyn,7523,N,OP,53,64,117,34,Fall2018
3998,SE 42nd & Llewellyn,7524,S,NS,58,57,115,44,Fall2018
2089,NE 42nd & Prescott,7525,S,FS,52,15,67,1,Fall2018
2090,NE 42nd & Prescott,7526,N,NS,13,46,59,2,Fall2018
2091,NE 42nd & Sandy,7527,S,NS,79,127,206,27,Fall2018
2092,NE 42nd & Sandy,7528,N,FS,127,92,219,47,Fall2018
2093,NE 42nd & Shaver,7529,N,NS,4,19,23,1,Fall2018
2094,NE 42nd & Shaver,7530,S,NS,14,4,18,1,Fall2018
2095,NE 42nd & Simpson St,7531,N,NS,3,9,12,0,Fall2018
2096,NE 42nd & Simpson St,7532,S,OP,15,5,20,0,Fall2018
2097,NE 42nd & Skidmore,7533,N,NS,5,28,33,7,Fall2018
2098,NE 42nd & Skidmore,7534,S,NS,19,4,23,3,Fall2018
2099,NE 42nd & Sumner,7535,N,NS,5,33,38,1,Fall2018
2100,NE 42nd & Sumner,7536,S,NS,37,6,43,0,Fall2018
2101,NE 42nd & Tillamook,7537,N,FS,42,17,59,4,Fall2018
2102,NE 42nd & Tillamook,7538,S,NS,18,34,52,4,Fall2018
5848,SW 45th & Caldew,7540,S,FS,0,0,0,0,Fall2018
4001,SE 45th & Evergreen,7542,N,OP,8,3,11,2,Fall2018
4002,SE 45th & Evergreen,7543,S,NS,3,12,15,3,Fall2018
5849,SW 45th & Flower Pl,7544,S,FS,1,2,3,0,Fall2018
4003,SE 45th & Harney,7546,N,OP,37,5,42,19,Fall2018
4004,SE 45th & Harney St,7548,S,NS,6,30,36,11,Fall2018
5850,SW 45th & Illinois,7549,S,NS,8,2,10,0,Fall2018
4005,SE 45th & Knapp,7551,S,NS,4,26,30,0,Fall2018
4006,SE 45th & Knapp,7552,N,FS,29,7,36,0,Fall2018
4008,SE 45th & Malden Dr,7554,N,NS,35,3,38,0,Fall2018
5852,SW 45th & Pendleton,7555,S,NS,9,4,13,0,Fall2018
4009,SE 45th & Rex,7556,S,NS,2,27,29,0,Fall2018
4010,SE 45th & Rural,7557,N,FS,20,3,23,3,Fall2018
4011,SE 45th & Rural,7558,S,NS,3,24,27,2,Fall2018
5853,SW 45th & Vermont,7559,S,NS,0,1,1,0,Fall2018
3999,SE 45th & 46th/Nehalem,7560,N,FS,20,2,22,5,Fall2018
4000,SE 45th & 46th/Nehalem,7561,S,OP,1,10,11,7,Fall2018
4012,SE 46th & Henry,7563,N,FS,17,3,20,2,Fall2018
4013,SE 46th & Henry,7564,S,NS,3,13,16,1,Fall2018
4014,SE 46th & Woodstock,7565,N,NS,60,59,119,51,Fall2018
2103,NE 47th & Halsey,7571,N,FS,6,15,21,1,Fall2018
5855,SW 49th & Coronado,7577,S,NS,0,18,18,0,Fall2018
5856,SW 49th & Coronado,7578,N,NS,26,0,26,1,Fall2018
5857,SW 49th & Hidalgo,7579,N,FS,31,2,33,2,Fall2018
5867,SW 5th & Alder,7586,S,NS,635,264,899,86,Fall2018
5868,SW 5th & Broadway,7588,S,NS,149,55,204,21,Fall2018
5869,SW 5th & Caruthers,7591,S,FS,38,30,68,5,Fall2018
5871,SW 5th & Columbia,7594,S,NS,384,213,597,67,Fall2018
7478,Union Station/NW 5th & Glisan MAX Stn,7601,S,NS,762,1095,1857,0,Fall2018
5873,SW 5th & Harrison,7602,S,NS,730,389,1119,73,Fall2018
563,5th & High,7604,W,NS,4,3,7,9,Fall2018
2121,NE 5th & Hood,7605,W,NS,6,1,7,1,Fall2018
3608,PSU South/SW 5th & Jackson MAX Stn,7606,S,NS,438,1322,1760,0,Fall2018
852,City Hall/SW 5th & Jefferson MAX Station,7608,S,NS,786,1342,2128,0,Fall2018
564,5th & Jefferson,7609,E,NS,11,10,21,13,Fall2018
565,5th & Jefferson,7610,W,NS,7,10,17,16,Fall2018
5875,SW 5th & Madison,7612,S,NS,625,315,940,125,Fall2018
5876,SW 5th & Main,7614,S,NS,586,201,787,70,Fall2018
5883,SW 5th & Market,7616,S,NS,349,288,637,64,Fall2018
3610,PSU Urban Center/SW 5th & Mill MAX Station,7618,S,FS,659,2365,3024,0,Fall2018
566,5th & Monroe,7620,E,NS,17,21,38,2,Fall2018
567,5th & Monroe,7621,W,NS,15,13,28,20,Fall2018
5884,SW 5th & Morrison,7625,S,NS,1094,474,1568,244,Fall2018
5885,SW 5th & Oak MAX Station,7627,S,NS,1024,1361,2385,1,Fall2018
5886,SW 5th & Pine,7631,S,OP,1263,1162,2425,449,Fall2018
5887,SW 5th & Salmon,7634,S,NS,540,273,813,81,Fall2018
5874,SW 5th & Harvey Milk (Stark),7636,S,NS,508,176,684,148,Fall2018
5888,SW 5th & Taylor,7640,S,NS,908,342,1250,160,Fall2018
5889,SW 5th & Washington,7642,S,NS,318,181,499,74,Fall2018
568,5th & Washington (Oregon City),7643,E,NS,13,29,42,27,Fall2018
7566,Washington & 16th,7644,S,NS,0,1,1,0,Fall2018
3646,Pioneer Place/SW 5th Ave MAX Station,7646,S,NS,2730,2365,5095,1,Fall2018
4016,SE 50th & Clay,7651,S,NS,13,47,60,3,Fall2018
4017,SE 50th & Clinton,7653,S,NS,34,22,56,8,Fall2018
4018,SE 50th & Division,7654,N,NS,85,39,124,20,Fall2018
4019,SE 50th & Division,7655,S,NS,46,81,127,12,Fall2018
4020,SE 50th & Haig,7656,N,NS,72,44,116,21,Fall2018
4021,SE 50th & Hawthorne,7658,N,NS,46,21,67,2,Fall2018
4029,SE 50th & Lincoln,7659,N,NS,42,6,48,5,Fall2018
4030,SE 50th & Lincoln,7660,S,NS,10,40,50,2,Fall2018
4031,SE 50th & Tibbetts,7665,N,NS,17,6,23,1,Fall2018
4028,SE 50th & Kelly,7666,S,FS,2,16,18,1,Fall2018
5861,SW 51st & Custer,7667,N,NS,3,3,6,0,Fall2018
5862,SW 51st & Moss,7668,N,NS,0,1,1,0,Fall2018
4033,SE 52nd & Boise,7669,N,NS,10,5,15,2,Fall2018
4036,SE 52nd & Clinton,7672,N,FS,17,4,21,2,Fall2018
4037,SE 52nd & Clinton,7673,S,FS,40,9,49,1,Fall2018
4038,SE 52nd & Cooper,7675,N,FS,15,2,17,0,Fall2018
4039,SE 52nd & Cooper,7676,S,NS,4,13,17,1,Fall2018
4040,SE 52nd & Division,7678,N,NS,44,60,104,19,Fall2018
4041,SE 52nd & Division,7679,S,FS,61,45,106,12,Fall2018
4042,SE 52nd & Duke,7680,N,NS,16,4,20,2,Fall2018
4043,SE 52nd & Duke,7682,S,NS,4,12,16,2,Fall2018
4044,SE 52nd & Foster,7683,N,NS,20,53,73,25,Fall2018
4034,SE 52nd & Bush,7684,S,FS,46,33,79,14,Fall2018
4045,SE 52nd & Franklin,7685,N,FS,12,2,14,1,Fall2018
4046,SE 52nd & Franklin,7687,S,FS,7,14,21,0,Fall2018
4047,SE 52nd & Gladstone,7688,S,NS,5,12,17,1,Fall2018
4048,SE 52nd & Harold,7690,N,NS,16,26,42,1,Fall2018
4049,SE 52nd & Harold,7691,S,NS,7,10,17,0,Fall2018
4050,SE 52nd & Holgate,7692,N,NS,37,47,84,18,Fall2018
4051,SE 52nd & Holgate,7693,S,NS,51,58,109,9,Fall2018
4052,SE 52nd & Lincoln,7695,N,NS,22,8,30,0,Fall2018
4053,SE 52nd & Lincoln,7696,S,FS,8,19,27,4,Fall2018
5863,SW 52nd & Maplewood School,7698,N,AT,5,5,10,0,Fall2018
5864,SW 52nd & Nevada Ct,7700,N,NS,5,3,8,0,Fall2018
4054,SE 52nd & Ogden,7702,N,NS,19,4,23,0,Fall2018
4055,SE 52nd & Ogden,7703,S,FS,6,26,32,0,Fall2018
4056,SE 52nd & Powell,7704,N,NS,76,101,177,21,Fall2018
4057,SE 52nd & Powell,7706,S,FS,104,74,178,19,Fall2018
4058,SE 52nd & Reedway,7708,N,NS,5,3,8,0,Fall2018
4059,SE 52nd & Reedway,7709,S,NS,1,6,7,0,Fall2018
4060,SE 52nd & Schiller,7711,S,OP,4,10,14,1,Fall2018
4061,SE 52nd & Schiller,7713,N,NS,12,4,16,0,Fall2018
4062,SE 52nd & Steele,7714,N,NS,21,12,33,0,Fall2018
4063,SE 52nd & Steele,7716,S,FS,28,33,61,2,Fall2018
4035,SE 52nd & Carlton,7718,S,NS,84,95,179,42,Fall2018
4065,SE 52nd & Tolman,7719,N,NS,72,49,121,30,Fall2018
4066,SE 52nd & Woodstock,7721,N,FS,45,28,73,12,Fall2018
4064,SE 52nd & Taggart Ct,7722,N,NS,83,100,183,2,Fall2018
4068,SE 52nd & Woodward,7723,S,FS,91,82,173,3,Fall2018
5865,SW 55th & Texas,7728,N,NS,3,2,5,0,Fall2018
5866,SW 55th & Vermont,7729,N,NS,2,1,3,0,Fall2018
2105,NE 57th & Fremont,7732,N,NS,7,30,37,12,Fall2018
2106,NE 57th & Fremont,7733,S,FS,26,11,37,8,Fall2018
2107,NE 57th & Hancock,7734,N,NS,5,9,14,1,Fall2018
2108,NE 57th & Hancock,7735,S,NS,12,2,14,0,Fall2018
2109,NE 57th & Sandy,7737,N,FS,38,47,85,33,Fall2018
2110,NE 57th & Sandy,7738,S,NS,40,40,80,25,Fall2018
2111,NE 57th & Siskiyou,7740,N,NS,2,12,14,0,Fall2018
2112,NE 57th & Siskiyou,7741,S,NS,9,2,11,0,Fall2018
2113,NE 57th & Thompson,7743,N,FS,3,14,17,0,Fall2018
2120,NE 57th & Thompson,7744,S,NS,18,4,22,1,Fall2018
407,29900 Block SE Eagle Creek Rd,7745,N,AT,2,0,2,0,Fall2018
5900,SW 6th & Alder,7747,N,NS,500,1004,1504,291,Fall2018
5901,SW 6th & Broadway,7749,N,NS,14,62,76,9,Fall2018
2134,NE 6th & N Broadway,7750,W,NS,24,1,25,1,Fall2018
5916,SW 6th & W Burnside,7751,N,NS,610,745,1355,261,Fall2018
5902,SW 6th & Clay,7756,N,NS,144,289,433,46,Fall2018
3251,NW Broadway & Davis,7759,N,NS,106,94,200,70,Fall2018
7479,Union Station/NW 6th & Hoyt MAX Stn,7763,N,AT,960,884,1844,0,Fall2018
5905,SW 6th & Jefferson,7765,N,NS,209,467,676,84,Fall2018
5907,SW 6th & Main,7767,N,NS,283,508,791,128,Fall2018
2133,NE 6th & Main,7770,E,NS,1,24,25,0,Fall2018
5908,SW 6th & Market,7772,N,NS,421,668,1089,90,Fall2018
5909,SW 6th & Mill,7773,N,NS,318,579,897,137,Fall2018
3611,PSU Urban Center/SW 6th & Montgomery MAX Stn,7774,N,OP,2103,585,2688,0,Fall2018
3645,Pioneer Courthouse/SW 6th Ave MAX Stn,7777,N,NS,2303,2535,4838,0,Fall2018
5910,SW 6th & Oak,7782,N,NS,250,410,660,90,Fall2018
5911,SW 6th & Pine MAX Station,7787,N,OP,1412,992,2404,0,Fall2018
5912,SW 6th & Salmon,7789,N,NS,197,604,801,88,Fall2018
5913,SW 6th & Sheridan,7793,N,FS,46,45,91,13,Fall2018
5914,SW 6th & Sheridan,7794,S,OP,35,55,90,25,Fall2018
5904,SW 6th & Harvey Milk (Stark),7797,N,NS,191,312,503,59,Fall2018
5915,SW 6th & Taylor,7800,N,NS,290,673,963,121,Fall2018
5917,SW 6th & Washington,7803,N,NS,264,433,697,69,Fall2018
5918,SW 6th & Yamhill,7807,N,NS,498,881,1379,149,Fall2018
4069,SE 60th & Belmont,7812,N,FS,38,85,123,15,Fall2018
4070,SE 60th & Belmont,7813,S,NS,62,45,107,9,Fall2018
4071,SE 60th & E Burnside,7814,S,FS,104,46,150,15,Fall2018
4072,SE 60th & E Burnside,7815,N,NS,40,103,143,21,Fall2018
2124,NE 60th & Everett,7816,N,OP,3,6,9,0,Fall2018
2125,NE 60th & Everett,7817,S,NS,13,3,16,0,Fall2018
2126,NE 60th & Glisan,7818,N,NS,20,48,68,22,Fall2018
2127,NE 60th & Glisan,7819,S,NS,53,21,74,27,Fall2018
2128,NE 60th & Halsey,7820,N,NS,11,34,45,6,Fall2018
2129,NE 60th & Hassalo,7821,N,FS,3,5,8,1,Fall2018
4074,SE 60th & Hawthorne,7823,N,OP,6,5,11,2,Fall2018
4081,SE 60th & Hawthorne,7824,S,NS,5,9,14,1,Fall2018
2122,NE 60th & 60th Ave MAX Stn/I-84,7827,N,AT,146,216,362,58,Fall2018
2123,NE 60th & 60th Ave MAX Stn/I-84,7828,S,AT,211,168,379,51,Fall2018
4082,SE 60th & Salmon,7830,N,NS,4,5,9,0,Fall2018
4083,SE 60th & Salmon,7831,S,OP,5,6,11,0,Fall2018
4084,SE 60th & Stark,7832,N,NS,10,13,23,2,Fall2018
4085,SE 60th & Stark,7833,S,NS,10,8,18,0,Fall2018
4086,SE 60th & Stephens,7835,S,OP,2,15,17,2,Fall2018
2130,NE 60th & Wasco,7837,S,NS,22,4,26,2,Fall2018
5892,SW 65th & Borland,7839,N,NS,0,25,25,0,Fall2018
5895,SW 68th & Baylor,7844,N,NS,1,4,5,0,Fall2018
5896,SW 68th & Clinton,7846,S,FS,2,2,4,1,Fall2018
5897,SW 68th & Franklin,7847,N,NS,4,22,26,1,Fall2018
5898,SW 68th & Franklin,7848,S,NS,8,5,13,0,Fall2018
5899,SW 68th & Freeway Entrance/Dartmouth,7849,N,FS,1,5,6,0,Fall2018
4087,SE 69th & Yamhill,7853,S,NS,4,32,36,0,Fall2018
4099,SE 7th & Clay,7855,S,NS,26,25,51,5,Fall2018
4100,SE 7th & Clay,7856,N,FS,17,38,55,2,Fall2018
4101,SE 7th & Grant,7857,S,NS,4,6,10,4,Fall2018
4102,SE 7th & Grant,7858,N,FS,12,13,25,0,Fall2018
4103,SE 7th & Harrison,7859,S,FS,43,62,105,10,Fall2018
4104,SE 7th & Harrison,7860,N,FS,40,36,76,9,Fall2018
205,16500 Block SW 72nd,7865,N,OP,1,0,1,0,Fall2018
212,16500 Block SW 72nd,7866,S,AT,0,2,2,0,Fall2018
5919,SW 72nd & Bonita,7867,N,NS,2,0,2,0,Fall2018
5920,SW 72nd & Bonita,7868,S,NS,0,1,1,0,Fall2018
4092,SE 72nd & Luther,7874,S,OP,9,12,21,10,Fall2018
4089,SE 72nd & Flavel,7875,S,FS,16,62,78,16,Fall2018
5925,SW 72nd & Hunziker,7876,S,FS,8,12,20,16,Fall2018
5926,SW 72nd & Kable,7877,N,OP,1,1,2,0,Fall2018
5927,SW 72nd & Kable,7878,S,FS,0,3,3,0,Fall2018
7466,Tualatin Park & Ride,7879,N,AT,309,109,418,32,Fall2018
7473,Tualatin Park & Ride,7880,S,AT,52,241,293,14,Fall2018
4090,SE 72nd & Lexington,7881,N,OP,40,8,48,17,Fall2018
4091,SE 72nd & Lexington,7882,S,NS,7,32,39,33,Fall2018
5921,SW 72nd & Cardinal,7885,N,NS,3,2,5,0,Fall2018
5928,SW 72nd & Sandburg,7887,N,NS,1,0,1,0,Fall2018
4093,SE 72nd & Tenino,7891,N,NS,22,7,29,3,Fall2018
4094,SE 72nd & Tenino,7892,S,FS,7,23,30,11,Fall2018
5929,SW 72nd & Upper Boones Ferry,7893,N,NS,39,11,50,0,Fall2018
5936,SW 72nd & Varns,7894,N,FS,12,5,17,1,Fall2018
160,14100 Block SW 72nd,7895,N,AT,1,0,1,0,Fall2018
161,14100 Block SW 72nd,7896,S,OP,0,0,0,0,Fall2018
4095,SE 76th & Washington,7897,N,NS,7,35,42,1,Fall2018
4096,SE 76th & Washington,7898,S,NS,27,9,36,4,Fall2018
4097,SE 76th & Yamhill,7899,S,NS,51,8,59,4,Fall2018
5937,SW 78th & Beaverton-Hillsdale Hwy,7900,S,NS,0,0,0,0,Fall2018
5939,SW 78th & Westmoor,7901,S,NS,0,0,0,0,Fall2018
5941,SW 80th & Birch,7904,S,OP,0,1,1,0,Fall2018
5942,SW 80th & Birch,7905,N,FS,0,0,0,0,Fall2018
5943,SW 80th & Cedarcrest,7906,S,FS,1,1,2,13,Fall2018
5944,SW 80th & Cedarcrest,7907,N,NS,1,1,2,0,Fall2018
5945,SW 80th & Elmwood,7910,S,NS,0,0,0,0,Fall2018
5946,SW 80th & Elmwood,7911,N,NS,1,0,1,0,Fall2018
5947,SW 80th & Landau,7912,S,OP,0,0,0,0,Fall2018
5948,SW 80th & Landau,7913,N,NS,1,0,1,0,Fall2018
5949,SW 80th & Locust,7914,S,NS,0,0,0,0,Fall2018
5950,SW 80th & Taylors Ferry,7915,N,NS,2,1,3,0,Fall2018
2139,NE 81st & Clackamas,7916,N,OP,11,6,17,12,Fall2018
4149,SE 82nd & King,7918,N,FS,183,34,217,43,Fall2018
4111,SE 82nd & Boyer Drive,7920,N,NS,228,93,321,149,Fall2018
4112,SE 82nd & Boyer Drive,7921,S,OP,45,151,196,89,Fall2018
322,2200 Block SE 82nd,7923,S,OP,22,120,142,6,Fall2018
2142,NE 82nd & Alberta,7927,N,NS,16,35,51,2,Fall2018
4193,SE 82nd & Washington,7928,N,NS,46,83,129,34,Fall2018
4106,SE 82nd & Alder,7929,S,NS,40,28,68,24,Fall2018
4107,SE 82nd & Ash,7930,N,NS,13,14,27,5,Fall2018
4108,SE 82nd & Ash,7931,S,FS,16,17,33,6,Fall2018
2160,NE 82nd & Pacific,7932,S,FS,25,19,44,2,Fall2018
2143,NE 82nd & Beech,7933,N,NS,13,63,76,23,Fall2018
2144,NE 82nd & Beech,7934,S,NS,39,17,56,12,Fall2018
4109,SE 82nd & Boise,7935,N,FS,157,47,204,61,Fall2018
4135,SE 82nd & E Burnside,7936,N,NS,144,248,392,88,Fall2018
2147,NE 82nd & E Burnside,7937,S,NS,267,144,411,89,Fall2018
4113,SE 82nd & Causey,7941,N,NS,183,42,225,49,Fall2018
4114,SE 82nd & Causey,7942,S,NS,33,156,189,47,Fall2018
4139,SE 82nd & Francis,7943,N,NS,125,38,163,27,Fall2018
4116,SE 82nd & Clatsop,7945,S,OP,12,19,31,2,Fall2018
4117,SE 82nd & Clatsop,7946,N,NS,20,14,34,3,Fall2018
4118,SE 82nd & Clinton,7947,N,NS,29,37,66,6,Fall2018
4119,SE 82nd & Clinton,7948,S,NS,25,18,43,4,Fall2018
4120,SE 82nd & Cooper,7950,S,NS,10,42,52,9,Fall2018
4121,SE 82nd & Cornwell,7951,N,NS,18,8,26,10,Fall2018
4122,SE 82nd & Cornwell,7952,S,FS,16,44,60,39,Fall2018
4123,SE 82nd & Crystal Springs,7953,N,NS,74,29,103,32,Fall2018
4124,SE 82nd & Crystal Springs,7954,S,FS,27,72,99,30,Fall2018
2145,NE 82nd & Davis,7955,N,NS,19,20,39,2,Fall2018
2146,NE 82nd & Davis,7956,S,OP,22,21,43,2,Fall2018
4125,SE 82nd & Division,7957,N,FS,380,374,754,115,Fall2018
4126,SE 82nd & Division,7958,S,NS,401,315,716,106,Fall2018
4127,SE 82nd & Duke,7960,N,NS,146,52,198,80,Fall2018
4134,SE 82nd & Duke,7961,S,FS,59,143,202,77,Fall2018
4136,SE 82nd & Flavel,7962,N,FS,93,60,153,24,Fall2018
4137,SE 82nd & Flavel,7963,S,NS,23,68,91,12,Fall2018
4138,SE 82nd & Foster,7964,N,FS,304,150,454,63,Fall2018
4147,SE 82nd & Insley,7965,S,OP,97,254,351,42,Fall2018
2148,NE 82nd & Fremont,7966,S,NS,127,35,162,25,Fall2018
2149,NE 82nd & Fremont,7967,N,NS,56,122,178,31,Fall2018
4140,SE 82nd & Glenwood,7970,N,NS,32,12,44,10,Fall2018
2150,NE 82nd & Glisan,7972,N,FS,103,115,218,60,Fall2018
2151,NE 82nd & Glisan,7973,S,NS,119,100,219,62,Fall2018
4141,SE 82nd & Harmony,7975,S,FS,19,8,27,4,Fall2018
2152,NE 82nd & Hassalo,7978,S,OP,39,28,67,7,Fall2018
4143,SE 82nd & Hawthorne,7979,N,NS,28,21,49,3,Fall2018
4144,SE 82nd & Hawthorne,7980,S,NS,23,22,45,1,Fall2018
4161,SE 82nd & Ogden,7982,N,OP,87,28,115,16,Fall2018
4145,SE 82nd & Holgate,7984,N,FS,295,229,524,147,Fall2018
4146,SE 82nd & Holgate,7986,S,NS,236,265,501,126,Fall2018
2153,NE 82nd & Holladay,7987,N,NS,15,17,32,3,Fall2018
4148,SE 82nd & Johnson Creek,7988,S,FS,32,45,77,32,Fall2018
4150,SE 82nd & King,7990,S,FS,40,359,399,67,Fall2018
2154,NE 82nd & Klickitat,7991,N,NS,10,50,60,4,Fall2018
2155,NE 82nd & Klickitat,7992,S,NS,66,20,86,11,Fall2018
4151,SE 82nd & Lambert,7993,N,FS,35,26,61,25,Fall2018
4152,SE 82nd & Lambert,7994,S,NS,47,78,125,34,Fall2018
4153,SE 82nd & Lindy,7995,N,NS,157,80,237,108,Fall2018
4154,SE 82nd & Lindy,7996,S,FS,65,121,186,85,Fall2018
2140,NE 82nd & 82nd Ave MAX Stn/I-84,7999,N,AT,922,819,1741,143,Fall2018
2141,NE 82nd & 82nd Ave MAX Stn/I-84,8000,S,AT,648,633,1281,82,Fall2018
2156,NE 82nd & Madison HS,8001,N,OP,147,233,380,11,Fall2018
2157,NE 82nd & Madison HS,8002,S,AT,210,211,421,6,Fall2018
4155,SE 82nd & Main,8004,S,NS,14,17,31,0,Fall2018
4156,SE 82nd & McBride,8005,N,OP,2,17,19,3,Fall2018
4157,SE 82nd & McBride,8006,S,NS,18,4,22,2,Fall2018
4158,SE 82nd & Mill,8007,N,NS,47,36,83,2,Fall2018
4159,SE 82nd & Mill,8008,S,FS,39,61,100,1,Fall2018
4160,SE 82nd & Mitchell,8009,S,FS,14,33,47,10,Fall2018
2158,NE 82nd & Multnomah,8010,N,NS,27,33,60,9,Fall2018
4162,SE 82nd & Ogden,8013,S,NS,24,68,92,16,Fall2018
2159,NE 82nd & Oregon,8014,N,OP,6,6,12,1,Fall2018
4163,SE 82nd & Otty,8015,N,NS,90,62,152,40,Fall2018
4164,SE 82nd & Otty,8016,S,FS,44,89,133,40,Fall2018
4165,SE 82nd & Overland,8017,N,FS,73,50,123,33,Fall2018
4166,SE 82nd & Overland,8018,S,NS,29,45,74,19,Fall2018
4167,SE 82nd & Powell,8023,N,FS,402,327,729,138,Fall2018
4168,SE 82nd & Powell,8024,S,FS,342,401,743,120,Fall2018
2161,NE 82nd & Prescott,8025,S,FS,68,44,112,17,Fall2018
2162,NE 82nd & Prescott,8026,N,NS,47,66,113,14,Fall2018
4169,SE 82nd & Ramona,8027,N,OP,39,27,66,6,Fall2018
4170,SE 82nd & Ramona,8028,S,NS,67,58,125,21,Fall2018
4172,SE 82nd & Raymond Ct,8029,N,NS,80,28,108,27,Fall2018
4171,SE 82nd & Raymond,8030,S,NS,29,69,98,26,Fall2018
4173,SE 82nd & Rhone,8031,N,NS,23,20,43,2,Fall2018
2163,NE 82nd & Russell,8033,N,NS,43,33,76,6,Fall2018
2164,NE 82nd & Russell,8034,S,OP,51,14,65,6,Fall2018
2178,NE 82nd & Thompson,8035,S,FS,35,23,58,6,Fall2018
2165,NE 82nd & Sacramento,8036,N,NS,23,29,52,3,Fall2018
4174,SE 82nd & Salmon,8037,N,OP,14,15,29,1,Fall2018
2166,NE 82nd & Sandy,8038,S,NS,187,114,301,61,Fall2018
2173,NE 82nd & Sandy,8039,N,FS,114,189,303,68,Fall2018
4175,SE 82nd & Schiller,8040,N,NS,23,10,33,11,Fall2018
4176,SE 82nd & Schiller,8041,S,OP,5,13,18,4,Fall2018
2174,NE 82nd & Schuyler,8042,N,FS,16,11,27,2,Fall2018
2175,NE 82nd & Schuyler,8043,S,NS,17,11,28,7,Fall2018
2176,NE 82nd & Siskiyou,8045,S,NS,79,22,101,3,Fall2018
2177,NE 82nd & Siskiyou,8046,N,FS,26,49,75,6,Fall2018
4177,SE 82nd & Stark,8047,N,FS,73,103,176,46,Fall2018
4178,SE 82nd & Stark,8048,S,NS,141,131,272,52,Fall2018
4187,SE 82nd & Sunnyside,8049,N,FS,8,17,25,5,Fall2018
4188,SE 82nd & Sunnyside Dr,8050,S,NS,8,7,15,2,Fall2018
4189,SE 82nd & Tibbetts,8052,N,OP,55,26,81,9,Fall2018
4190,SE 82nd & Tibbetts,8053,S,NS,19,49,68,17,Fall2018
2179,NE 82nd & Tillamook,8055,N,NS,44,35,79,5,Fall2018
2180,NE 82nd & Tillamook,8056,S,NS,32,21,53,1,Fall2018
4191,SE 82nd & Tolman,8057,N,NS,32,13,45,2,Fall2018
4192,SE 82nd & Tolman,8058,S,NS,13,38,51,3,Fall2018
4194,SE 82nd & Woodstock,8059,N,NS,24,15,39,4,Fall2018
4195,SE 82nd & Woodstock,8060,S,NS,14,37,51,5,Fall2018
4196,SE 82nd & Woodward,8061,N,NS,67,49,116,13,Fall2018
4197,SE 82nd & Woodward,8062,S,FS,47,80,127,7,Fall2018
2182,NE 82nd & Wygant,8063,N,NS,5,20,25,2,Fall2018
2183,NE 82nd & Wygant,8064,S,NS,38,8,46,4,Fall2018
4198,SE 82nd & Yamhill,8065,N,NS,31,16,47,17,Fall2018
4199,SE 82nd & Yamhill,8066,S,FS,17,30,47,22,Fall2018
4200,SE 82nd Dr & Beaverlake Dr,8067,S,FS,6,10,16,5,Fall2018
4209,SE 82nd Dr & Scotts Tree Way,8070,N,OP,14,6,20,1,Fall2018
4201,SE 82nd Dr & Clackamas,8071,N,NS,5,1,6,0,Fall2018
4203,SE 82nd Dr & Greenhouse Square,8072,S,OP,41,49,90,36,Fall2018
4204,SE 82nd Dr & Greenhouse Square,8073,N,AT,37,42,79,26,Fall2018
4202,SE 82nd Dr & Enoch Ct,8074,N,NS,5,5,10,1,Fall2018
4205,SE 82nd Dr & Herbert Ct,8075,S,NS,4,6,10,0,Fall2018
4206,SE 82nd Dr & Jannsen,8076,N,OP,16,6,22,1,Fall2018
4207,SE 82nd Dr & Jannsen,8077,S,NS,7,15,22,2,Fall2018
4208,SE 82nd Dr & Manfield Ct,8078,S,FS,5,5,10,0,Fall2018
186,15900 Block SE 82nd Dr,8079,N,AT,55,14,69,5,Fall2018
4210,SE 82nd Dr & Scotts Tree Way,8080,S,NS,7,14,21,7,Fall2018
4211,SE 82nd Dr & Tolbert,8082,S,FS,3,12,15,0,Fall2018
4212,SE 82nd Dr & Tolbert,8083,N,FS,10,4,14,0,Fall2018
213,16700 Block SE 82nd Dr,8084,N,AT,10,6,16,0,Fall2018
214,16700 Block SE 82nd Dr,8085,S,OP,6,4,10,1,Fall2018
187,15900 Block SE 82nd Dr,8086,S,OP,19,51,70,6,Fall2018
731,9th & Jackson,8092,E,NS,1,1,2,0,Fall2018
732,9th & Jefferson,8093,E,NS,1,1,2,1,Fall2018
733,9th & Jefferson,8094,W,NS,0,1,1,0,Fall2018
734,9th & Main,8096,W,NS,2,8,10,3,Fall2018
735,9th & Monroe,8097,S,NS,1,2,3,0,Fall2018
742,9th & Monroe,8098,W,NS,1,0,1,0,Fall2018
743,9th & Washington,8100,W,NS,2,3,5,1,Fall2018
3217,NW 90th & W Stark,8105,N,FS,0,1,1,0,Fall2018
5951,SW 90th & Taylor,8106,S,NS,2,0,2,0,Fall2018
5952,SW 90th & Washington,8108,S,FS,0,0,0,0,Fall2018
2188,NE 92nd & Russell,8114,S,NS,2,3,5,17,Fall2018
2189,NE 92nd & Russell,8115,N,OP,3,2,5,17,Fall2018
2190,NE 92nd & Sacramento,8116,N,NS,1,4,5,1,Fall2018
2191,NE 92nd & Schuyler,8118,S,NS,5,1,6,0,Fall2018
2192,NE 92nd & Schuyler,8119,N,OP,2,1,3,0,Fall2018
2193,NE 92nd & Thompson,8124,S,FS,8,1,9,0,Fall2018
2194,NE 92nd & Tillamook,8125,N,OP,4,4,8,0,Fall2018
2195,NE 92nd & Tillamook,8126,S,NS,1,2,3,0,Fall2018
4220,SE 97th & Foster,8134,N,NS,7,73,80,6,Fall2018
2196,NE 99th & Glisan,8140,N,FS,7,35,42,19,Fall2018
2197,NE 99th & Glisan,8141,S,NS,30,9,39,20,Fall2018
1775,NE 102nd & Knott,8149,N,NS,2,7,9,0,Fall2018
4892,SE International Way & 40th,8152,E,FS,10,8,18,0,Fall2018
501,4400 Block SE International Way,8153,E,AT,4,4,8,1,Fall2018
517,4900 Block SE International Way (Blount),8154,E,OP,4,3,7,0,Fall2018
4896,SE International Way & Mallard,8155,E,OP,4,2,6,2,Fall2018
551,5600 Block SE International Way,8156,S,OP,2,2,4,0,Fall2018
4897,SE International Way & Mallard,8164,W,NS,2,3,5,0,Fall2018
518,4900 Block SE International Way (Blount),8165,W,AT,4,3,7,0,Fall2018
507,4500 Block SE International Way,8166,W,OP,3,5,8,0,Fall2018
4893,SE International Way & 40th,8167,W,OP,9,10,19,1,Fall2018
3976,SE 32nd & Johnson Creek,8168,N,NS,15,5,20,9,Fall2018
1089,Hillsboro Transit Center,8181,E,AT,411,183,594,128,Fall2018
1046,Gateway Transit Center,8190,S,AT,91,11,102,26,Fall2018
1045,Gateway TC (Drop off only stop),8194,N,AT,177,666,843,152,Fall2018
1167,Lake Oswego Transit Center,8207,S,AT,146,78,224,37,Fall2018
1168,Lake Oswego Transit Center,8208,S,AT,103,173,276,81,Fall2018
7461,Tigard Transit Center,8209,S,AT,228,331,559,54,Fall2018
7462,Tigard Transit Center,8210,S,AT,73,72,145,10,Fall2018
7463,Tigard Transit Center,8211,S,AT,242,239,481,95,Fall2018
7464,Tigard Transit Center,8212,S,AT,167,88,255,21,Fall2018
763,Barbur Transit Center,8213,E,AT,77,597,674,25,Fall2018
4900,SE Jackson & Main St,8223,W,NS,432,256,688,194,Fall2018
4898,SE Jackson & 21st,8225,E,NS,380,241,621,194,Fall2018
7261,SW Troy & 37th ,8227,W,FS,0,1,1,0,Fall2018
6618,SW Hamilton & 54th Pl,8229,E,FS,0,0,0,0,Fall2018
3136,NW 158th & Schendel,8230,S,NS,35,19,54,6,Fall2018
5698,SW 158th & W Baseline,8232,N,OP,0,1,1,0,Fall2018
3137,NW 158th & Schendel,8233,N,FS,15,20,35,2,Fall2018
5696,SW 158th & Jenkins,8234,N,NS,3,2,5,0,Fall2018
4110,SE 82nd & Boise,8237,S,NS,29,129,158,40,Fall2018
4015,SE 50th & Brooklyn,8241,S,FS,68,64,132,2,Fall2018
4032,SE 50th & Woodward,8242,N,FS,71,156,227,4,Fall2018
5642,SE Woodstock & 38th,8243,E,NS,1,11,12,0,Fall2018
6790,SW Martinazzi & Martinazzi Square,8249,N,OP,9,3,12,0,Fall2018
6794,SW Martinazzi & Tualatin-Sherwood,8250,N,FS,10,9,19,1,Fall2018
6791,SW Martinazzi & Martinazzi Square,8252,S,AT,4,10,14,1,Fall2018
128,13300 Block SW Pacific Hwy,8260,E,AT,13,3,16,4,Fall2018
7422,SW Watson & Broadway,8262,S,NS,94,6,100,14,Fall2018
6235,SW Canyon & Red Robin,8265,W,AT,0,13,13,0,Fall2018
6238,SW Canyon & Watson ,8270,E,NS,3,103,106,15,Fall2018
6225,SW Canyon & Broadway,8271,E,NS,18,2,20,6,Fall2018
6232,SW Canyon & Hall ,8272,W,NS,49,3,52,6,Fall2018
113,12900 Block SW Canyon,8273,W,AT,34,8,42,2,Fall2018
7012,SW Sagert & Tillamook,8276,W,OP,1,2,3,0,Fall2018
7013,SW Sagert & Tillamook,8278,E,FS,1,0,1,0,Fall2018
5893,SW 65th & Borland,8279,S,OP,6,0,6,0,Fall2018
7004,SW Sagert & 68th,8281,W,FS,33,0,33,0,Fall2018
7007,SW Sagert & 72nd,8282,W,NS,10,0,10,0,Fall2018
654,7800 Block SW Sagert,8283,W,OP,4,0,4,0,Fall2018
7010,SW Sagert & Martinazzi,8284,W,FS,3,51,54,12,Fall2018
6792,SW Martinazzi & Mohawk,8285,N,NS,99,26,125,19,Fall2018
3989,SE 32nd & Van Water,8301,S,FS,2,3,5,0,Fall2018
638,7500 Block NE 21st,8303,N,OP,0,11,11,0,Fall2018
639,7500 Block NE 21st,8304,S,AT,10,0,10,0,Fall2018
201,16400 Block SW Langer,8306,N,OP,14,1,15,2,Fall2018
7567,Washington & 16th,8309,N,OP,1,1,2,0,Fall2018
3692,S Holcomb & Front Ave,8310,E,OP,1,5,6,1,Fall2018
3695,S Holcomb & Hunter Ave,8311,E,NS,0,1,1,0,Fall2018
1193,Longview & Holcomb,8312,N,FS,2,5,7,0,Fall2018
695,900 Block Abernethy,8313,W,OP,0,0,0,0,Fall2018
5020,SE Main & 3rd,8315,N,NS,6,0,6,0,Fall2018
478,3900 Block SW Murray,8316,S,OP,3,13,16,2,Fall2018
724,9800 Block NE Pacific St,8321,W,OP,1,80,81,16,Fall2018
3964,SE 32nd & Floss,8326,N,NS,7,7,14,0,Fall2018
1622,N Rosa Parks Way & Knowles,8329,W,NS,1,9,10,0,Fall2018
1173,Library/SW 9th Ave MAX Station,8333,E,AT,1291,1961,3252,0,Fall2018
3648,Pioneer Square South MAX Station,8334,E,AT,1815,3614,5429,0,Fall2018
1199,Mall/SW 4th Ave MAX Station,8335,E,AT,1165,1452,2617,0,Fall2018
7646,Yamhill District MAX Station,8336,E,AT,1145,975,2120,0,Fall2018
3566,Oak/ SW 1st Ave MAX Station,8337,N,NS,606,455,1061,0,Fall2018
7424,Skidmore Fountain MAX Station,8338,N,AT,541,530,1071,0,Fall2018
3583,Old Town/Chinatown MAX Station,8339,N,AT,1014,616,1630,0,Fall2018
3675,Rose Quarter TC MAX Station,8340,E,AT,2533,1437,3970,0,Fall2018
865,Convention Center MAX Station,8341,E,AT,1019,955,1974,0,Fall2018
2137,NE 7th Ave MAX Station,8342,E,FS,995,1017,2012,0,Fall2018
1190,Lloyd Center/NE 11th Ave MAX Station,8343,E,AT,1937,1970,3907,0,Fall2018
1100,Hollywood/NE 42nd Ave TC MAX Station,8344,E,AT,1077,1451,2528,0,Fall2018
2131,NE 60th Ave MAX Station,8345,E,AT,444,1112,1556,0,Fall2018
2184,NE 82nd Ave MAX Station,8346,E,AT,938,1366,2304,0,Fall2018
1051,Gateway/NE 99th Ave TC MAX Station,8347,S,AT,3880,3665,7545,0,Fall2018
901,E 102nd Ave MAX Station,8348,E,FS,500,632,1132,0,Fall2018
903,E 122nd Ave MAX Station,8349,E,FS,474,1107,1581,0,Fall2018
905,E 148th Ave MAX Station,8350,E,FS,198,648,846,0,Fall2018
907,E 162nd Ave MAX Station,8351,E,FS,355,1061,1416,0,Fall2018
909,E 172nd Ave MAX Station,8352,E,FS,128,376,504,0,Fall2018
911,E 181st Ave MAX Station,8353,E,FS,224,782,1006,0,Fall2018
3671,Rockwood/E 188th Ave MAX Station,8354,E,NS,174,610,784,0,Fall2018
3681,Ruby Junction/E 197th Ave MAX Station,8355,E,FS,210,488,698,0,Fall2018
1070,Gresham City Hall MAX Station,8356,E,OP,79,564,643,0,Fall2018
1068,Gresham Central TC MAX Station,8357,E,AT,72,897,969,0,Fall2018
862,Cleveland Ave MAX Station,8359,W,NS,1023,1058,2081,0,Fall2018
1069,Gresham Central TC MAX Station,8360,W,AT,865,76,941,0,Fall2018
1071,Gresham City Hall MAX Station,8361,W,AT,581,70,651,0,Fall2018
3682,Ruby Junction/E 197th Ave MAX Station,8362,W,FS,313,137,450,0,Fall2018
3672,Rockwood/E 188th Ave MAX Station,8363,W,FS,689,166,855,0,Fall2018
912,E 181st Ave MAX Station,8364,W,FS,794,233,1027,0,Fall2018
910,E 172nd Ave MAX Station,8365,W,FS,364,116,480,0,Fall2018
908,E 162nd Ave MAX Station,8366,W,FS,1065,353,1418,0,Fall2018
906,E 148th Ave MAX Station,8367,W,FS,610,195,805,0,Fall2018
904,E 122nd Ave MAX Station,8368,W,FS,1134,473,1607,0,Fall2018
902,E 102nd Ave MAX Station,8369,W,FS,654,530,1184,0,Fall2018
1052,Gateway/NE 99th Ave TC MAX Station,8370,N,AT,3222,3717,6939,0,Fall2018
2185,NE 82nd Ave MAX Station,8371,W,AT,1460,899,2359,0,Fall2018
2132,NE 60th Ave MAX Station,8372,W,AT,1139,469,1608,0,Fall2018
1101,Hollywood/NE 42nd Ave TC MAX Station,8373,W,AT,1322,1168,2490,0,Fall2018
1191,Lloyd Center/NE 11th Ave MAX Station,8374,W,AT,1747,2213,3960,0,Fall2018
2138,NE 7th Ave MAX Station,8375,W,NS,1000,1112,2112,0,Fall2018
866,Convention Center MAX Station,8376,W,AT,1131,938,2069,0,Fall2018
3676,Rose Quarter TC MAX Station,8377,W,AT,1216,2479,3695,0,Fall2018
3584,Old Town/Chinatown MAX Station,8378,S,AT,624,1215,1839,0,Fall2018
7425,Skidmore Fountain MAX Station,8379,S,AT,529,559,1088,0,Fall2018
3567,Oak/ SW 1st Ave MAX Station,8380,S,FS,545,630,1175,0,Fall2018
1262,Morrison/SW 3rd Ave MAX Station,8381,W,NS,1388,1237,2625,0,Fall2018
1200,Mall/SW 5th Ave MAX Station,8382,W,AT,1818,1794,3612,0,Fall2018
3647,Pioneer Square North MAX Station,8383,W,AT,3281,1242,4523,0,Fall2018
1044,Galleria/SW 10th Ave MAX Station,8384,W,AT,1598,1647,3245,0,Fall2018
3542,NW Vaughn & 26th,8385,E,NS,52,1,53,4,Fall2018
7183,SW Taylors Ferry & 76th Pl,8387,W,NS,0,0,0,0,Fall2018
7182,SW Taylors Ferry & 75th,8388,E,NS,2,1,3,0,Fall2018
5953,SW 95th & Commerce Circle,8389,N,NS,6,0,6,0,Fall2018
729,9900 Block SW Commerce Circle,8391,S,AT,0,1,1,0,Fall2018
3358,NW Everett & Park,8402,E,NS,21,17,38,5,Fall2018
3513,NW St Helens & Newberry Rd,8403,S,NS,0,0,0,0,Fall2018
4685,SE Harold & 67th,8404,W,NS,25,2,27,0,Fall2018
3369,NW Evergreen Pkwy & Tanasbourne Terr,8406,W,OP,2,0,2,0,Fall2018
3363,NW Evergreen Pkwy & NE Amberglen (NW 194th),8408,E,FS,10,27,37,12,Fall2018
3370,NW Evergreen Pkwy & Tanasbourne Terr,8409,E,AT,2,5,7,0,Fall2018
3543,NW Vaughn & 26th,8414,W,NS,1,51,52,12,Fall2018
441,3300 Block SW Dosch,8416,N,AT,0,0,0,0,Fall2018
4853,SE Hwy 224 &232nd Dr,8420,W,NS,1,0,1,0,Fall2018
4854,SE Hwy 224 &232nd Dr,8421,E,NS,0,1,1,0,Fall2018
4682,SE Harold & 64th,8422,W,NS,20,2,22,0,Fall2018
204,16500 Block SE 82nd Dr,8430,N,OP,10,10,20,6,Fall2018
1053,Gillihan Rd & Sauvie Island,8437,N,AT,46,46,92,7,Fall2018
3503,NW St Helens & Harborton Dr,8438,S,NS,1,0,1,0,Fall2018
3507,NW St Helens & Larson,8439,S,OP,1,0,1,0,Fall2018
3693,S Holcomb & Front Ave,8441,W,NS,6,1,7,1,Fall2018
4527,SE Eagle Creek Rd & River Mill Rd,8442,S,NS,0,2,2,0,Fall2018
6702,SW Jenkins & Meridian,8443,W,FS,3,6,9,37,Fall2018
757,Abernethy & Redland Rd,8446,W,FS,0,0,0,0,Fall2018
758,Abernethy & Redland Rd,8447,E,NS,0,1,1,0,Fall2018
671,8300 Block SE Causey,8448,E,AT,13,20,33,11,Fall2018
7228,SW Terwilliger & Cheltenham,8450,S,NS,0,1,1,0,Fall2018
7323,SW US Veterans Rd & Bldg 16,8455,N,AT,73,88,161,26,Fall2018
4245,SE Bell & Sandview ,8457,S,NS,14,50,64,28,Fall2018
1028,E Powell & NE Liberty,8461,W,NS,2,3,5,0,Fall2018
5484,SE Stark & SW 257th Dr ,8464,W,FS,134,53,187,82,Fall2018
1783,NE 102nd & Thompson,8465,S,NS,2,1,3,0,Fall2018
4215,SE 90th & Monterey,8467,S,NS,1,8,9,11,Fall2018
3087,NE Shaver & Parkrose Middle School,8471,E,AT,2,30,32,1,Fall2018
3132,NW 158th & Blueridge,8474,S,FS,15,3,18,2,Fall2018
3133,NW 158th & Blueridge,8475,N,NS,5,19,24,0,Fall2018
1471,N Lombard & Baltimore,8480,N,NS,55,127,182,125,Fall2018
3559,NW Wardway & Montgomery Pk,8481,W,AT,2,46,48,1,Fall2018
3455,NW Nicolai & Wardway,8482,E,FS,5,35,40,1,Fall2018
3202,NW 27th & Vaughn at Montgomery Park,8484,S,NS,288,88,376,26,Fall2018
6736,SW Lombard & 2nd,8491,S,NS,15,11,26,9,Fall2018
5070,SE McLoughlin & Naef,8494,S,NS,12,38,50,4,Fall2018
184,15700 Block SW 72nd,8495,N,AT,0,0,0,0,Fall2018
547,5500 Block N Channel Ave (Shipyards),8496,E,AT,4,9,13,0,Fall2018
2304,NE Columbia Blvd & 24th,8498,W,OP,0,0,0,0,Fall2018
2308,NE Columbia Blvd & 29th,8499,E,NS,3,0,3,3,Fall2018
2307,NE Columbia Blvd & 27th,8500,E,NS,3,0,3,0,Fall2018
2420,NE Evergreen Pkwy & Cornelius Pass Rd,8505,E,NS,2,6,8,0,Fall2018
7011,SW Sagert & Martinazzi,8506,E,FS,2,19,21,2,Fall2018
2305,NE Columbia Blvd & 24th,8507,E,FS,1,0,1,0,Fall2018
2309,NE Columbia Blvd & 29th,8508,W,FS,1,10,11,2,Fall2018
1120,Jackson & 9th,8509,S,NS,1,0,1,0,Fall2018
7519,W Burnside & SW 20th,8511,E,NS,331,114,445,155,Fall2018
924,E Burnside & NE 20th,8512,W,NS,82,38,120,11,Fall2018
1808,NE 11th & Holladay,8513,N,NS,68,233,301,39,Fall2018
992,E Main & NE 14th,8514,E,OP,1,1,2,0,Fall2018
993,E Main & NE 14th,8537,W,FS,0,1,1,0,Fall2018
2423,NE Evergreen Pkwy & NW Atkeson Ln,8539,E,NS,1,11,12,0,Fall2018
3364,NW Evergreen Pkwy & NE John Olsen,8540,W,FS,21,9,30,0,Fall2018
3361,NW Evergreen Pkwy & NE Aloclek Ct,8541,W,FS,14,3,17,0,Fall2018
2269,NE Century (NW 229th) & Butler,8542,S,NS,4,4,8,0,Fall2018
2332,NE Cornell & Century (NW 229th),8543,W,FS,3,8,11,4,Fall2018
2337,NE Cornell & Elam Young West,8545,W,OP,5,6,11,2,Fall2018
433,3300 Block NE Cornell,8546,W,AT,4,9,13,1,Fall2018
2315,NE Cornell & 25th,8547,W,FS,12,20,32,8,Fall2018
2341,NE Cornell & Hillaire Dr,8548,W,NS,15,13,28,2,Fall2018
2320,NE Cornell & Arrington,8549,W,NS,18,13,31,2,Fall2018
2339,NE Cornell & Grant,8550,S,NS,7,5,12,1,Fall2018
2343,NE Cornell & Jackson,8551,S,NS,2,3,5,0,Fall2018
3726,SE 10th & E Main,8552,N,NS,21,3,24,7,Fall2018
2344,NE Cornell & Jackson,8553,N,OP,4,1,5,0,Fall2018
2340,NE Cornell & Grant,8554,N,NS,6,7,13,1,Fall2018
2321,NE Cornell & Arrington,8555,E,OP,12,18,30,1,Fall2018
2342,NE Cornell & Hillaire Dr,8556,E,FS,22,15,37,2,Fall2018
1980,NE 25th & Cornell,8557,N,FS,3,4,7,2,Fall2018
2317,NE Cornell & 34th,8558,E,NS,7,5,12,2,Fall2018
2338,NE Cornell & Elam Young West,8559,E,FS,6,5,11,2,Fall2018
2333,NE Cornell & Century (NW 231st),8561,E,FS,7,4,11,1,Fall2018
3362,NW Evergreen Pkwy & NE Aloclek Dr,8562,E,FS,3,16,19,1,Fall2018
3365,NW Evergreen Pkwy & NE John Olsen,8563,E,NS,9,21,30,0,Fall2018
1859,NE 148th & Sacramento,8564,N,NS,1,1,2,0,Fall2018
1856,NE 148th & Fremont,8567,N,NS,3,2,5,0,Fall2018
2971,NE Sandy & 152nd,8569,E,FS,3,15,18,2,Fall2018
2975,NE Sandy & 158th,8570,E,NS,14,36,50,2,Fall2018
2977,NE Sandy & 162nd,8571,E,NS,49,34,83,26,Fall2018
2979,NE Sandy & 165th,8572,E,FS,5,11,16,1,Fall2018
1938,NE 181st & Halsey,8580,S,NS,26,10,36,10,Fall2018
1939,NE 181st & Halsey,8581,N,NS,10,30,40,8,Fall2018
1940,NE 181st & San Rafael,8582,N,NS,2,8,10,0,Fall2018
2980,NE Sandy & 165th,8584,W,FS,11,3,14,1,Fall2018
2978,NE Sandy & 162nd,8585,W,OP,22,15,37,5,Fall2018
2972,NE Sandy & 152nd,8587,W,OP,13,3,16,0,Fall2018
1855,NE 148th & 147th,8589,S,FS,1,0,1,0,Fall2018
1860,NE 148th & Sacramento,8592,S,OP,0,0,0,0,Fall2018
5814,SW 257th & Hensley Rd,8595,S,FS,3,2,5,6,Fall2018
5810,SW 257th & 28th,8597,S,FS,0,4,4,1,Fall2018
5818,SW 257th & SE Stark,8598,N,FS,22,9,31,4,Fall2018
5811,SW 257th & 28th,8599,N,OP,1,0,1,0,Fall2018
5713,SW 185th & Alexander,8603,S,NS,9,94,103,17,Fall2018
6809,SW Murray & Allen,8604,S,FS,47,86,133,20,Fall2018
6820,SW Murray & Davis,8605,S,NS,4,9,13,5,Fall2018
6827,SW Murray & Kilchis,8606,S,FS,2,3,5,0,Fall2018
6825,SW Murray & Hart,8607,S,FS,15,7,22,1,Fall2018
6844,SW Murray & Sexton Mtn Dr,8608,S,FS,4,10,14,0,Fall2018
6830,SW Murray & Maverick Terr,8609,S,FS,10,24,34,10,Fall2018
6813,SW Murray & Beard,8610,S,FS,12,28,40,3,Fall2018
6852,SW Murray & Weir Rd,8611,S,FS,6,18,24,2,Fall2018
6842,SW Murray & Osprey Dr,8612,S,NS,15,61,76,4,Fall2018
6846,SW Murray & Teal Blvd,8613,S,NS,17,52,69,3,Fall2018
7032,SW Scholls Ferry & 135th,8614,E,NS,25,23,48,2,Fall2018
7030,SW Scholls Ferry & 130th,8615,E,FS,4,10,14,1,Fall2018
7076,SW Scholls Ferry & North Dakota,8616,E,NS,18,47,65,4,Fall2018
7028,SW Scholls Ferry & 121st,8617,E,FS,30,30,60,11,Fall2018
7070,SW Scholls Ferry & Murray,8618,E,FS,44,49,93,3,Fall2018
7051,SW Scholls Ferry & Boones Bend Dr,8619,W,FS,28,19,47,2,Fall2018
7029,SW Scholls Ferry & 125th,8620,W,FS,52,19,71,14,Fall2018
7031,SW Scholls Ferry & 130th,8621,W,FS,10,7,17,1,Fall2018
7033,SW Scholls Ferry & 135th,8622,W,FS,26,18,44,0,Fall2018
6847,SW Murray & Teal Blvd,8625,N,NS,30,14,44,1,Fall2018
6843,SW Murray & Osprey Dr,8626,N,FS,51,18,69,6,Fall2018
6853,SW Murray & Weir Rd,8627,N,OP,20,5,25,2,Fall2018
6194,SW Brockman & Stallion ,8628,E,NS,4,0,4,0,Fall2018
6837,SW Murray & Maverick Terr,8629,N,FS,15,10,25,9,Fall2018
6845,SW Murray & Sexton Mtn Dr,8630,N,FS,10,4,14,0,Fall2018
6823,SW Murray & Hargis,8631,N,NS,3,0,3,0,Fall2018
6826,SW Murray & Hart,8632,N,FS,15,16,31,2,Fall2018
6811,SW Murray & Barlow,8633,N,NS,4,2,6,0,Fall2018
6807,SW Murray & 22nd,8634,N,FS,7,6,13,4,Fall2018
6810,SW Murray & Allen,8635,N,NS,52,50,102,11,Fall2018
6824,SW Murray & Hargis,8636,S,FS,0,2,2,0,Fall2018
2271,NE Century (NW 229th) & Cornell,8643,N,FS,4,4,8,0,Fall2018
6909,SW Pacific Hwy & Durham ,8644,S,NS,19,74,93,31,Fall2018
300,20500 Block NW Evergreen Pkwy,8646,W,OP,6,3,9,0,Fall2018
301,20500 Block NW Evergreen Pkwy,8647,E,AT,3,4,7,0,Fall2018
2424,NE Evergreen Pkwy & NW Atkeson Ln,8648,W,OP,10,2,12,0,Fall2018
2347,NE Cornell & Orenco Station Pkwy,8649,E,NS,18,10,28,1,Fall2018
2348,NE Cornell & Orenco Station Pkwy,8650,W,FS,11,19,30,2,Fall2018
3514,NW St Helens & Riverview Drive,8654,S,NS,0,0,0,0,Fall2018
4216,SE 90th & Monterey,8659,N,FS,9,2,11,10,Fall2018
6916,SW Pacific Hwy & Home Street Bank,8663,N,AT,12,7,19,6,Fall2018
4698,SE Harold & Foster ,8664,E,NS,42,47,89,6,Fall2018
7059,SW Scholls Ferry & Davies,8665,E,FS,11,7,18,1,Fall2018
7128,SW Talbot & Talbot Terrace,8672,S,NS,0,1,1,0,Fall2018
7060,SW Scholls Ferry & Davies,8673,W,FS,14,10,24,1,Fall2018
4213,SE 90th & Causey,8677,N,NS,19,11,30,12,Fall2018
4007,SE 45th & Lexington,8678,S,NS,1,13,14,0,Fall2018
405,29600 Block SE Eagle Creek Rd,8685,S,AT,0,1,1,0,Fall2018
1941,NE 181st & San Rafael,8714,S,NS,5,1,6,2,Fall2018
309,21700 Block SE Hwy 224,8720,E,AT,0,1,1,0,Fall2018
310,21700 Block SE Hwy 224,8721,W,OP,1,0,1,0,Fall2018
576,600 Block NW Wade,8722,N,AT,0,0,0,0,Fall2018
660,800 Block NW Wade (at Library),8723,S,AT,1,7,8,0,Fall2018
108,12700 Block SE McLoughlin,8726,N,AT,6,8,14,1,Fall2018
1991,NE 27th & Highland,8727,N,FS,0,14,14,2,Fall2018
6922,SW Pacific Hwy & Royalty Parkway,8728,S,FS,9,52,61,20,Fall2018
569,5th & Washington (Oregon City),8732,W,NS,18,14,32,32,Fall2018
294,20000 Block SE Hwy 224,8735,W,AT,0,0,0,0,Fall2018
232,17300 Block SE Hwy 224,8736,W,OP,0,0,0,0,Fall2018
234,17400 Block SE Hwy 224,8737,E,AT,0,0,0,0,Fall2018
3096,NE Vancouver Way & 3rd,8740,S,NS,3,1,4,0,Fall2018
364,2700 Block W Powell,8742,E,AT,59,85,144,56,Fall2018
371,2700 Block W Powell,8743,W,OP,93,54,147,72,Fall2018
3504,NW St Helens & Harborton Dr,8744,N,NS,0,0,0,0,Fall2018
944,E Burnside & NE 97th,8745,W,NS,11,15,26,4,Fall2018
7537,W Columbia River Hwy & NW Graham,8746,W,FS,53,3,56,4,Fall2018
295,20000 Block SE Hwy 224,8755,S,AT,0,0,0,0,Fall2018
3585,Oregon City Transit Center,8758,N,AT,290,192,482,108,Fall2018
3586,Oregon City Transit Center,8759,N,AT,68,113,181,27,Fall2018
3587,Oregon City Transit Center,8760,S,AT,188,175,363,62,Fall2018
3588,Oregon City Transit Center,8761,S,AT,280,277,557,140,Fall2018
3589,Oregon City Transit Center,8762,W,AT,214,195,409,51,Fall2018
7583,Webster & Cason,8763,N,NS,6,2,8,10,Fall2018
230,17100 Block SE Webster,8764,N,AT,1,3,4,0,Fall2018
6858,SW Naito Parkway & Sheridan,8770,S,NS,49,5,54,4,Fall2018
4931,SE Kane & Powell Valley,8776,S,NS,18,6,24,1,Fall2018
3220,NW Bethany & Bronson,8779,S,NS,20,7,27,2,Fall2018
7009,SW Sagert & 86th,8788,W,OP,2,4,6,0,Fall2018
6910,SW Pacific Hwy & Durham ,8792,N,FS,57,10,67,17,Fall2018
4891,SE Hwy 224 & Tong,8794,E,OP,0,0,0,0,Fall2018
240,17700 Block SE Hwy 224,8795,W,AT,0,0,0,0,Fall2018
6046,SW Barnes & Barnes,8798,W,FS,3,18,21,0,Fall2018
7532,W Burnside & SW Barnes,8799,E,NS,19,4,23,0,Fall2018
486,4100 Block SE 182nd,8800,S,AT,0,18,18,4,Fall2018
3544,NW Vaughn & 27th,8802,W,NS,5,111,116,10,Fall2018
339,2400 Block NW 29th,8808,N,AT,1,8,9,4,Fall2018
348,2500 Block NW 29th,8809,S,OP,1,0,1,1,Fall2018
514,4700 Block W Powell,8812,E,OP,17,33,50,17,Fall2018
1610,N Rosa Parks Way & Albina,8814,W,NS,11,16,27,7,Fall2018
5068,SE McLoughlin & Meldrum,8819,N,FS,10,4,14,7,Fall2018
6375,SW Council Crest & Tualatin (north leg),8821,N,NS,2,0,2,0,Fall2018
4869,SE Hwy 224 & Glover Rd224 & Glover Rd,8823,S,FS,0,0,0,0,Fall2018
4878,SE Hwy 224 & Hwy 211,8824,N,AT,2,1,3,0,Fall2018
277,19800 Block NE Halsey,8825,W,OP,6,2,8,0,Fall2018
118,13000 Block NW Cornell,8828,E,AT,8,8,16,1,Fall2018
4846,SE Hwy 224 &135th,8830,W,NS,12,2,14,0,Fall2018
6524,SW Greenburg & Lehman,8832,S,OP,2,6,8,1,Fall2018
6525,SW Greenburg & Lehman,8835,N,NS,4,9,13,2,Fall2018
2847,NE Main & 3rd,8837,S,NS,0,4,4,0,Fall2018
2848,NE Main & 3rd,8838,N,OP,3,0,3,0,Fall2018
3471,NW Springville & 178th,8839,E,FS,1,11,12,0,Fall2018
3774,SE 122nd & Powell,8843,S,NS,15,222,237,64,Fall2018
4645,SE Harold & 101st,8844,W,NS,23,1,24,0,Fall2018
6949,SW Park Way & 135th,8845,E,OP,0,1,1,0,Fall2018
3472,NW Springville & 181st,8850,E,NS,1,4,5,0,Fall2018
5482,SE Stark & NE Kelly ,8851,W,OP,2,2,4,7,Fall2018
3473,NW Springville & 181st,8852,W,FS,2,1,3,0,Fall2018
347,2500 Block NE Riverside Way,8854,E,AT,0,7,7,0,Fall2018
659,800 Block NW Wade,8857,N,AT,6,1,7,0,Fall2018
2665,NE Halsey & 181st,8860,W,FS,71,51,122,21,Fall2018
3376,NW Front & Kittridge,8875,E,FS,4,1,5,0,Fall2018
506,4500 Block NW Front,8877,E,OP,1,0,1,0,Fall2018
498,4300 Block NW Front,8878,E,OP,2,0,2,0,Fall2018
453,3600 Block NW Front,8879,E,OP,13,3,16,0,Fall2018
7512,W Burnside & NW Maywood Dr,8880,W,NS,0,3,3,0,Fall2018
7513,W Burnside & NW Maywood Dr,8881,E,OP,2,0,2,0,Fall2018
1951,NE 21st & Riverside Way,8883,N,NS,0,6,6,0,Fall2018
3166,NW 185th & Tanasbourne Rd,8884,N,FS,35,149,184,18,Fall2018
3356,NW Everett & 5th,8886,E,NS,469,367,836,137,Fall2018
6504,SW Garden Home & Capitol Hwy,8888,E,NS,1,6,7,0,Fall2018
2181,NE 82nd & Webster,8889,S,OP,14,12,26,2,Fall2018
342,24300 Block SW Boones Ferry Rd,8891,S,AT,0,1,1,0,Fall2018
343,24300 Block SW Boones Ferry Rd,8892,N,AT,1,0,1,0,Fall2018
3982,SE 32nd & Meek,8894,N,OP,39,11,50,31,Fall2018
894,Division & Warren St,8899,W,OP,1,1,2,0,Fall2018
656,7th & Taylor,8900,W,NS,1,1,2,0,Fall2018
492,4200 Block NW Front,8901,E,OP,1,0,1,0,Fall2018
493,4200 Block NW Front,8902,W,AT,1,3,4,0,Fall2018
464,3800 Block NW Front,8903,E,OP,1,0,1,0,Fall2018
465,3800 Block NW Front,8904,W,AT,0,1,1,0,Fall2018
1813,NE 122nd & Fremont,8907,N,FS,9,26,35,3,Fall2018
5846,SW 40th & Garden Home,8911,S,NS,2,2,4,0,Fall2018
4218,SE 96th & Mall 205,8912,S,OP,12,36,48,11,Fall2018
5021,SE Main & 96th,8913,E,FS,20,13,33,7,Fall2018
6,10000 Block SE Main,8914,E,AT,19,15,34,21,Fall2018
24,10500 Block SE Cherry Blossom,8915,W,AT,9,8,17,3,Fall2018
15,10200 Block SE Main,8917,W,AT,20,20,40,17,Fall2018
4217,SE 96th & Main,8918,N,FS,27,40,67,17,Fall2018
4219,SE 96th & Mall 205 Dr,8919,N,NS,26,14,40,11,Fall2018
7385,SW Walker & Butner,8920,W,NS,3,3,6,0,Fall2018
7389,SW Walker & Meadow Dr,8921,W,NS,1,2,3,0,Fall2018
7382,SW Walker & 150th,8922,W,NS,4,4,8,0,Fall2018
7386,SW Walker & Greystone Ct,8923,W,OP,0,0,0,0,Fall2018
7383,SW Walker & 158th,8924,E,NS,1,1,2,0,Fall2018
7387,SW Walker & Greystone Ct,8925,E,FS,0,0,0,0,Fall2018
7388,SW Walker & Koll Parkway,8926,E,NS,3,2,5,0,Fall2018
7390,SW Walker & Meadow Dr,8927,E,NS,3,1,4,0,Fall2018
7391,SW Walker & Murray,8928,E,NS,2,2,4,0,Fall2018
5610,SE Washington & 99th,8935,E,NS,6,31,37,11,Fall2018
4226,SE 99th & Washington,8936,N,NS,15,6,21,8,Fall2018
2726,NE Holladay & 11th,8937,E,NS,199,31,230,42,Fall2018
1809,NE 11th & Multnomah,8938,N,NS,23,94,117,27,Fall2018
3767,SE 122nd & Midland Library,8940,N,OP,28,49,77,35,Fall2018
276,19500 Block SW 65th,8944,S,AT,37,1,38,0,Fall2018
5321,SE Powell Valley & Greenway,8945,W,FS,0,0,0,0,Fall2018
5322,SE Powell Valley & Greenway,8946,E,OP,0,0,0,0,Fall2018
393,28400 Block SE Hwy 224,8947,N,AT,0,0,0,0,Fall2018
394,28400 Block SE Hwy 224,8948,E,OP,0,1,1,0,Fall2018
4483,SE Division & 96th,8949,E,NS,12,28,40,5,Fall2018
6239,SW Canyon & Watson ,8950,W,NS,18,4,22,4,Fall2018
5858,SW 49th & PCC Entrance,8951,S,NS,3,42,45,0,Fall2018
297,20200 Block SW Pacific Hwy,8954,E,AT,2,0,2,0,Fall2018
1113,I-5 Off Ramp & SW Lower Boones Ferry,8956,S,AT,1,149,150,3,Fall2018
3429,NW Leahy & Leahy Terrace,8961,W,NS,0,1,1,0,Fall2018
3430,NW Leahy & Leahy Terrace,8962,S,OP,1,0,1,0,Fall2018
3188,NW 23rd & Flanders,8963,S,NS,72,19,91,8,Fall2018
3193,NW 23rd & Overton,8981,N,FS,13,76,89,14,Fall2018
3526,NW Thurman & 23rd Pl,8984,W,NS,2,44,46,7,Fall2018
3198,NW 23rd & Thurman,8986,S,FS,109,6,115,14,Fall2018
3192,NW 23rd & Marshall,8989,S,NS,175,27,202,64,Fall2018
5523,SE Sunnyside & 105th,8991,E,NS,4,8,12,0,Fall2018
5551,SE Sunnyside & Valley View Terr,8993,E,NS,3,19,22,1,Fall2018
5527,SE Sunnyside & 119th,8995,E,FS,8,34,42,7,Fall2018
5041,SE Mather & 122nd,8998,W,FS,4,1,5,0,Fall2018
5039,SE Mather & 119th Ct,8999,W,NS,0,0,0,0,Fall2018
5045,SE Mather & Cranberry Loop,9000,S,FS,5,0,5,0,Fall2018
46,11000 Block SE Mather,9001,W,AT,0,0,0,0,Fall2018
26,10500 Block SE Mather,9002,W,AT,7,1,8,0,Fall2018
4221,SE 97th & Lawnfield,9004,N,NS,7,1,8,0,Fall2018
4224,SE 97th & Talbert Dr,9005,N,NS,3,1,4,0,Fall2018
148,14000 Block SE 97th,9007,W,AT,7,0,7,0,Fall2018
4835,SE Hubbard & 128th ,9008,W,OP,0,0,0,0,Fall2018
4836,SE Hubbard & 128th ,9009,E,NS,0,1,1,0,Fall2018
3279,NW Cornell & 185th,9010,E,FS,82,27,109,18,Fall2018
2345,NE Cornell & NW 185th,9012,W,FS,45,83,128,17,Fall2018
3286,NW Cornell & 188th,9013,W,FS,9,13,22,2,Fall2018
2349,NE Cornell & Stucki,9014,W,FS,24,41,65,9,Fall2018
3152,NW 185th & Evergreen,9022,S,FS,156,59,215,20,Fall2018
6795,SW Martinazzi & Tualatin-Sherwood,9026,S,NS,1,9,10,1,Fall2018
1825,NE 122nd & Wasco,9027,N,FS,7,83,90,34,Fall2018
7264,SW Tualatin Valley Hwy & 153rd,9029,E,NS,1,3,4,0,Fall2018
3195,NW 23rd & Raleigh,9030,S,FS,89,6,95,3,Fall2018
3196,NW 23rd & Raleigh,9031,N,NS,5,94,99,8,Fall2018
6126,SW Bertha & Chestnut ,9033,N,NS,11,3,14,0,Fall2018
7082,SW Scholls Ferry & Springwood,9038,W,OP,16,25,41,1,Fall2018
1235,Molalla & Char Diaz Dr,9041,N,OP,3,0,3,0,Fall2018
1248,Molalla & Oregon City Post Office,9042,N,AT,5,1,6,6,Fall2018
6319,SW Columbia & 10th,9044,E,NS,186,70,256,29,Fall2018
5815,SW 257th & Hensley Rd,9046,N,FS,1,2,3,2,Fall2018
5923,SW 72nd & Durham Rd,9047,S,NS,0,0,0,0,Fall2018
5924,SW 72nd & Durham Rd,9048,N,OP,0,0,0,0,Fall2018
3291,NW Cornell & Bethany ,9050,W,FS,28,27,55,5,Fall2018
3299,NW Cornell & Evergreen Pkwy,9051,W,FS,12,25,37,2,Fall2018
3272,NW Cornell & 167th Pl,9052,W,FS,8,10,18,9,Fall2018
3277,NW Cornell & 173rd Pl,9053,W,NS,21,31,52,6,Fall2018
3273,NW Cornell & 167th Pl,9054,E,NS,7,5,12,9,Fall2018
3276,NW Cornell & 173rd Ave,9055,E,FS,27,23,50,8,Fall2018
3292,NW Cornell & Bethany Ct ,9056,E,NS,38,48,86,16,Fall2018
3278,NW Cornell & 179th,9059,E,NS,18,11,29,2,Fall2018
3882,SE 181st & E Burnside,9061,S,FS,32,54,86,15,Fall2018
6595,SW Hall & Tigard City Hall,9065,S,AT,1,3,4,1,Fall2018
6560,SW Hall & Fanno Creek Ct,9067,S,OP,4,5,9,0,Fall2018
6548,SW Hall & Bonita,9068,S,NS,9,33,42,0,Fall2018
6579,SW Hall & Murdock,9069,S,OP,1,7,8,0,Fall2018
6590,SW Hall & Sattler,9070,S,FS,4,9,13,1,Fall2018
6546,SW Hall & Avon,9071,N,FS,36,5,41,0,Fall2018
673,8300 Block SW Durham,9072,E,OP,6,11,17,0,Fall2018
6396,SW Durham & 76th,9073,E,OP,0,4,4,0,Fall2018
6400,SW Durham & Upper Boones Ferry,9076,S,FS,5,34,39,0,Fall2018
625,7200 Block SW Durham,9077,W,OP,6,1,7,0,Fall2018
6401,SW Durham & Upper Boones Ferry,9078,N,FS,22,4,26,0,Fall2018
6397,SW Durham & 76th,9079,W,NS,2,1,3,0,Fall2018
669,8200 Block SW Durham,9080,W,AT,5,7,12,0,Fall2018
6545,SW Hall & Ashford,9082,N,NS,4,2,6,0,Fall2018
6580,SW Hall & Murdock,9083,N,NS,5,0,5,0,Fall2018
6549,SW Hall & Bonita,9084,N,NS,34,7,41,1,Fall2018
6578,SW Hall & McDonald,9085,N,NS,6,2,8,0,Fall2018
6584,SW Hall & Omara,9086,N,OP,23,7,30,6,Fall2018
5808,SW 257th & 16th Way,9092,N,NS,6,18,24,2,Fall2018
5812,SW 257th & Cherry Park,9094,N,NS,1,4,5,0,Fall2018
238,17600 Block NE Sandy,9095,E,AT,13,24,37,0,Fall2018
5819,SW 257th & Sturges,9101,S,NS,4,1,5,0,Fall2018
5813,SW 257th & Cherry Park,9103,S,NS,19,5,24,2,Fall2018
1787,NE 105th & Killingsworth,9105,N,FS,3,3,6,1,Fall2018
1791,NE 105th & Simpson,9106,N,FS,3,3,6,0,Fall2018
44,11000 Block NE Holman,9107,E,AT,4,11,15,4,Fall2018
2210,NE Airport Way & Ainsworth Circle,9108,E,NS,3,13,16,1,Fall2018
2201,NE Airport Way & 122nd,9110,E,NS,9,24,33,5,Fall2018
2203,NE Airport Way & 138th,9112,E,NS,6,14,20,2,Fall2018
5752,SW 18th & Morrison,9122,N,NS,25,15,40,1,Fall2018
3201,NW 25th & Lovejoy,9125,N,NS,0,1,1,0,Fall2018
3300,NW Cornell & Marshall ,9126,N,AT,0,1,1,0,Fall2018
3315,NW Cornell & Summit Ct ,9127,N,OP,0,1,1,0,Fall2018
3318,NW Cornell & Westover ,9129,S,NS,0,3,3,0,Fall2018
3321,NW Cumberland & Fairfax ,9130,S,FS,1,1,2,0,Fall2018
3322,NW Cumberland & Shenandoah,9131,W,NS,2,0,2,0,Fall2018
3319,NW Cumberland & Ariel ,9132,W,FS,1,0,1,0,Fall2018
3456,NW Powhatan & Greenbrier Terr,9133,S,FS,0,1,1,0,Fall2018
3435,NW Macleay & Hermosa,9135,E,FS,2,3,5,0,Fall2018
3436,NW Macleay & Lomita Terrace,9136,E,NS,0,0,0,0,Fall2018
3434,NW Macleay & Beuhla Vista,9137,S,NS,0,1,1,0,Fall2018
3437,NW Macleay & W Burnside,9139,S,NS,0,0,0,0,Fall2018
7384,SW Walker & 158th,9145,W,FS,1,3,4,0,Fall2018
7392,SW Walker & Schendel,9146,W,NS,5,1,6,0,Fall2018
3551,NW Walker & 167th,9147,W,NS,0,0,0,0,Fall2018
3552,NW Walker & 173rd,9148,W,NS,0,0,0,0,Fall2018
3556,NW Walker & 185th,9150,E,FS,4,1,5,0,Fall2018
3553,NW Walker & 173rd,9151,E,NS,1,0,1,0,Fall2018
7393,SW Walker & Schendel,9152,E,NS,4,4,8,0,Fall2018
3558,NW Walker & SW 167th,9153,E,FS,0,0,0,0,Fall2018
3256,NW Cedar Hills & Leahy,9158,N,FS,0,5,5,0,Fall2018
6331,SW Conestoga & Boones Bend,9159,N,OP,0,10,10,0,Fall2018
6336,SW Conestoga & Welch,9160,W,NS,0,4,4,0,Fall2018
6333,SW Conestoga & Downing,9161,W,NS,0,8,8,0,Fall2018
6329,SW Conestoga & 125th,9162,W,NS,0,14,14,0,Fall2018
5682,SW 125th & Longhorn,9163,N,FS,0,5,5,1,Fall2018
5680,SW 125th & Footpath,9164,N,AT,0,4,4,1,Fall2018
6192,SW Brockman & Sorrento ,9165,W,FS,0,1,1,0,Fall2018
6187,SW Brockman & 135th ,9166,W,NS,0,11,11,0,Fall2018
6189,SW Brockman & Davies ,9167,W,NS,0,4,4,0,Fall2018
6191,SW Brockman & Pony ,9168,W,FS,0,2,2,0,Fall2018
7077,SW Scholls Ferry & Progress Park & Ride,9169,S,AT,4,26,30,0,Fall2018
7208,SW Teal & 152nd ,9170,W,FS,3,2,5,0,Fall2018
7209,SW Teal & 155th ,9171,S,NS,2,2,4,0,Fall2018
7210,SW Teal & Bobwhite Circle ,9172,E,NS,1,1,2,0,Fall2018
7212,SW Teal & Pintail ,9173,S,NS,4,3,7,0,Fall2018
7084,SW Scholls Ferry & Teal Blvd,9174,E,FS,19,15,34,1,Fall2018
7034,SW Scholls Ferry & 147th,9175,E,FS,5,3,8,0,Fall2018
6190,SW Brockman & Davies ,9176,E,FS,6,0,6,0,Fall2018
6188,SW Brockman & 135th ,9177,E,FS,12,0,12,0,Fall2018
6193,SW Brockman & Sorrento ,9178,E,OP,2,0,2,0,Fall2018
5681,SW 125th & Footpath,9179,S,AT,7,0,7,0,Fall2018
720,9600 Block SW 125th,9180,S,AT,6,3,9,0,Fall2018
6330,SW Conestoga & 125th,9181,E,FS,19,0,19,0,Fall2018
6334,SW Conestoga & Downing,9182,E,OP,7,0,7,0,Fall2018
6335,SW Conestoga & Trapper Terrace,9183,E,FS,4,0,4,0,Fall2018
6332,SW Conestoga & Boones Bend,9184,S,NS,11,1,12,0,Fall2018
7078,SW Scholls Ferry & Progress Park & Ride,9185,N,OP,24,6,30,0,Fall2018
7319,SW Tualatin-Sherwood Rd & Pacific Hwy,9186,S,FS,0,75,75,2,Fall2018
7303,SW Tualatin-Sherwood Rd & Baler ,9187,E,NS,0,26,26,23,Fall2018
6713,SW Langer & Sherwood Plaza,9188,W,OP,1,21,22,5,Fall2018
202,16400 Block SW Langer,9189,S,AT,2,15,17,3,Fall2018
193,16100 Block SW Langer,9190,E,AT,13,0,13,1,Fall2018
1606,N Rivergate Blvd & Lombard St,9192,W,FS,13,19,32,0,Fall2018
124,13300 Block N Rivergate,9193,N,OP,0,0,0,0,Fall2018
1607,N Rivergate Blvd & Ramsey,9194,N,NS,2,5,7,0,Fall2018
125,13300 Block N Rivergate Blvd,9196,S,AT,0,0,0,0,Fall2018
1521,N Lombard & Simmons,9197,N,OP,3,3,6,0,Fall2018
620,7100 Block N Marine,9198,E,AT,2,2,4,0,Fall2018
559,5900 Block N Marine,9199,E,OP,0,0,0,0,Fall2018
553,5700 Block N Marine,9200,E,OP,1,1,2,0,Fall2018
542,5300 Block N Marine,9202,W,AT,0,0,0,0,Fall2018
554,5700 Block N Marine,9203,W,FS,1,2,3,0,Fall2018
560,5900 Block N Marine,9204,W,AT,0,0,0,0,Fall2018
621,7100 Block N Marine,9205,W,OP,1,3,4,0,Fall2018
1522,N Lombard & Simmons,9206,S,NS,1,2,3,0,Fall2018
7278,SW Tualatin Valley Hwy & 198th,9207,E,FS,58,75,133,14,Fall2018
173,14700 Block SW Teal,9208,W,OP,8,3,11,2,Fall2018
3555,NW Walker & 180th,9209,W,FS,0,0,0,0,Fall2018
246,18000 Block NW Walker,9210,E,OP,1,0,1,0,Fall2018
5017,SE Main & 100th,9211,W,OP,4,3,7,2,Fall2018
3294,NW Cornell & Bronson Creek Pk,9212,W,AT,7,9,16,1,Fall2018
3293,NW Cornell & Birch Pointe Apts,9213,E,AT,16,10,26,1,Fall2018
3320,NW Cumberland & Culpepper,9214,W,OP,4,4,8,0,Fall2018
7211,SW Teal & Nighthawk Dr ,9215,S,NS,1,1,2,0,Fall2018
7608,Willamette Dr & Lazy River Dr,9216,N,NS,11,2,13,0,Fall2018
3100,NE Wasco & 82nd,9217,E,NS,8,32,40,15,Fall2018
5018,SE Main & 100th,9218,E,NS,3,5,8,2,Fall2018
3783,SE 122nd & Stark,9219,S,FS,130,65,195,43,Fall2018
7570,Washington Square Transit Center,9220,S,AT,53,49,102,17,Fall2018
6935,SW Palmblad & Hall Blvd ,9221,N,NS,5,2,7,0,Fall2018
6398,SW Durham & 79th,9224,E,OP,8,5,13,0,Fall2018
6399,SW Durham & 79th,9225,W,NS,6,10,16,0,Fall2018
6589,SW Hall & Ross,9226,N,FS,9,3,12,0,Fall2018
3557,NW Walker & Cambray,9230,E,FS,2,0,2,0,Fall2018
3554,NW Walker & 178th,9232,W,NS,1,1,2,0,Fall2018
5178,SE Orient Dr & 262nd,9233,E,NS,0,2,2,0,Fall2018
5179,SE Orient Dr & 262nd/Barnes/Salquist,9234,W,NS,2,0,2,0,Fall2018
3269,NW Cornell & 153rd,9245,W,NS,10,15,25,0,Fall2018
4462,SE Division & 61st,9248,W,NS,19,12,31,1,Fall2018
5697,SW 158th & Jenkins,9252,S,NS,0,1,1,0,Fall2018
2465,NE Fremont & 66th,9253,E,NS,1,2,3,0,Fall2018
626,7200 Block SW Durham,9257,S,AT,2,10,12,0,Fall2018
3404,NW Graham/257th & W Columbia River Hwy,9261,S,NS,9,1,10,2,Fall2018
4403,SE Division & 148th,9263,W,FS,98,86,184,51,Fall2018
4442,SE Division & 42nd,9265,W,NS,56,33,89,12,Fall2018
1945,NE 181st & Wilkes,9266,N,NS,1,3,4,0,Fall2018
7625,Willamette Falls Dr & 12th St,9269,E,NS,3,0,3,1,Fall2018
814,Blankenship & Virginia Lane,9270,N,OP,3,2,5,3,Fall2018
810,Blankenship & 19th St,9276,W,NS,1,1,2,0,Fall2018
812,Blankenship & Ostman,9277,W,NS,1,1,2,0,Fall2018
3593,Ostman & Dollar,9279,S,NS,2,1,3,0,Fall2018
7634,Willamette Falls Dr & 19th St,9284,E,OP,1,1,2,0,Fall2018
7633,Willamette Falls Dr & 16th St,9285,E,FS,0,0,0,0,Fall2018
7632,Willamette Falls Dr & 14th St,9286,E,NS,4,1,5,1,Fall2018
40,10th St & 8th Court,9296,N,NS,4,11,15,4,Fall2018
813,Blankenship & Tannler Dr,9297,N,FS,2,2,4,0,Fall2018
3215,NW 6th & Davis MAX Station,9299,N,NS,826,638,1464,0,Fall2018
3216,NW 6th & Flanders,9300,N,NS,4,231,235,48,Fall2018
3214,NW 5th & Davis,9301,S,NS,617,422,1039,213,Fall2018
3213,NW 5th & Couch MAX Station,9303,S,NS,751,861,1612,1,Fall2018
2855,NE Multnomah & 11th,9305,E,FS,112,58,170,20,Fall2018
5501,SE Steele & 46th ,9307,W,NS,22,4,26,0,Fall2018
1516,N Lombard & Ramsey,9308,N,NS,4,2,6,0,Fall2018
1517,N Lombard & Ramsey,9309,S,FS,2,5,7,0,Fall2018
3398,NW Glisan & 3rd,9311,W,FS,88,257,345,65,Fall2018
4889,SE Hwy 224 & Suttle Rd,9312,W,OP,1,0,1,0,Fall2018
4890,SE Hwy 224 & Suttle Rd,9313,E,FS,0,1,1,0,Fall2018
7189,SW Taylors Ferry & Capitol Hwy,9320,E,FS,2,17,19,0,Fall2018
374,27500 Block SE Hwy 224,9321,E,AT,0,1,1,0,Fall2018
375,27600 Block SE Hwy 224,9322,W,AT,0,0,0,0,Fall2018
6812,SW Murray & Barlow,9323,S,OP,2,3,5,0,Fall2018
6816,SW Murray & Brockman,9324,N,FS,22,12,34,6,Fall2018
5851,SW 45th & Nevada,9328,S,NS,0,2,2,0,Fall2018
1561,N Marine & Leadbetter,9334,E,FS,4,1,5,0,Fall2018
1562,N Marine & Leadbetter,9335,W,FS,1,12,13,0,Fall2018
6226,SW Canyon & Camelot Ct,9338,N,NS,52,12,64,16,Fall2018
2060,NE 33rd Dr & Sunderland,9339,N,OP,0,0,0,0,Fall2018
1881,NE 15th & Halsey,9342,N,NS,29,34,63,13,Fall2018
7542,W Powell & NW Miller,9347,W,FS,19,4,23,4,Fall2018
3160,NW 185th & Rock Creek,9351,S,FS,57,8,65,2,Fall2018
6153,SW Boones Ferry Rd & Avery ,9352,S,FS,0,5,5,0,Fall2018
6154,SW Boones Ferry Rd & Avery ,9353,N,FS,7,0,7,0,Fall2018
7534,W Burnside & SW Osage,9354,E,NS,32,28,60,4,Fall2018
2868,NE Multnomah & 3rd ,9362,E,OP,21,60,81,36,Fall2018
2058,NE 33rd Dr & Elrod Dr,9365,N,NS,0,10,10,1,Fall2018
719,9600 Block NE Sunderland,9367,S,AT,0,2,2,0,Fall2018
3095,NE Sunderland & Columbia River Corr Cntr,9368,S,AT,62,47,109,12,Fall2018
2059,NE 33rd Dr & Elrod Dr,9369,S,NS,22,0,22,0,Fall2018
338,2400 Block NE Riverside Way,9371,W,AT,6,0,6,0,Fall2018
5318,SE Powell Valley & Barnes Flag Stop,9383,W,AT,0,0,0,0,Fall2018
5802,SW 1st & Arthur,9397,S,NS,9,5,14,1,Fall2018
1387,N Going & Port Center Way,9399,E,NS,49,10,59,1,Fall2018
1952,NE 21st & Riverside Way,9402,S,FS,8,0,8,0,Fall2018
1449,N Killingsworth & Greeley,9403,E,FS,40,6,46,8,Fall2018
3200,NW 23rd Pl & Westover,9404,N,NS,0,0,0,0,Fall2018
6626,SW Hamilton & 55th Pl,9405,E,OP,1,0,1,0,Fall2018
6135,SW Boones Ferry Rd & 13th Ct ,9406,W,NS,0,1,1,0,Fall2018
6136,SW Boones Ferry Rd & 13th Ct ,9407,E,FS,1,0,1,0,Fall2018
1038,Exceed Enterprises,9412,S,AT,8,9,17,37,Fall2018
3094,NE Sunderland & 33rd Dr (In),9414,E,NS,0,0,0,0,Fall2018
3323,NW Division & Angeline ,9425,W,OP,6,3,9,2,Fall2018
3324,NW Division & Angeline ,9426,E,NS,1,6,7,1,Fall2018
5816,SW 257th & Jennings Way,9427,E,NS,0,2,2,0,Fall2018
5817,SW 257th & Jennings Way,9428,W,OP,8,1,9,0,Fall2018
5024,SE Main & E 1st,9429,N,NS,2,1,3,0,Fall2018
2849,NE Main & E 1st,9430,S,NS,0,3,3,0,Fall2018
1484,N Lombard & Catlin,9431,N,NS,2,48,50,22,Fall2018
1545,N Lombard & Weyerhauser,9432,N,FS,0,26,26,1,Fall2018
168,14500 Block N Lombard,9434,N,AT,3,1,4,0,Fall2018
1485,N Lombard & Catlin,9435,S,NS,54,2,56,21,Fall2018
14,10200 Block N Lombard,9436,S,AT,30,0,30,1,Fall2018
3097,NE Vancouver Way & Freightliner,9438,N,FS,1,9,10,0,Fall2018
1563,N Marine & Leadbetter,9439,E,NS,2,3,5,0,Fall2018
1557,N Marine & Bybee Lake Road,9440,E,FS,1,0,1,0,Fall2018
587,6100 Block N Marine,9441,E,AT,2,0,2,0,Fall2018
543,5300 Block N Marine,9442,E,OP,0,0,0,0,Fall2018
1559,N Marine & Gantenbein,9444,E,OP,0,0,0,0,Fall2018
2136,NE 6th Drive & South Shore,9447,S,FS,0,0,0,0,Fall2018
702,9000 Block NE Vancouver Way,9449,W,AT,53,12,65,2,Fall2018
2850,NE Middlefield & 6th Drive,9451,E,NS,0,0,0,0,Fall2018
2135,NE 6th Drive & Faloma,9453,N,NS,2,1,3,0,Fall2018
1560,N Marine & Gantenbein,9454,W,NS,0,0,0,0,Fall2018
1556,N Marine & Anchor,9455,W,NS,1,0,1,0,Fall2018
588,6100 Block N Marine,9457,W,AT,0,5,5,0,Fall2018
1558,N Marine & Bybee Lake Road,9458,W,NS,0,3,3,0,Fall2018
1564,N Marine & Pacific Gateway Blvd,9459,W,FS,1,3,4,0,Fall2018
169,14500 Block N Lombard,9460,S,OP,1,4,5,0,Fall2018
6670,SW Hocken & Millikan,9462,S,NS,8,9,17,8,Fall2018
131,13500 Block SW Millikan,9463,W,AT,4,3,7,0,Fall2018
141,13900 Block SW Millikan,9464,W,AT,2,2,4,0,Fall2018
162,14100 Block SW Millikan,9465,E,OP,1,4,5,0,Fall2018
142,13900 Block SW Millikan,9466,E,OP,3,3,6,0,Fall2018
3149,NW 185th & Bronson,9467,N,FS,7,45,52,3,Fall2018
139,13900 Block SW 72nd,9469,E,AT,1,2,3,0,Fall2018
3401,NW Graham/257th & 257th Way,9470,N,FS,1,22,23,3,Fall2018
3402,NW Graham/257th & 257th Way,9471,S,OP,33,2,35,3,Fall2018
700,900 Block NW North Frontage Rd,9472,W,AT,0,6,6,0,Fall2018
2851,NE Middlefield Rd & N Vancouver Way,9477,N,FS,22,7,29,1,Fall2018
2,1000 Block N Marine,9478,E,AT,0,1,1,0,Fall2018
3098,NE Vancouver Way & Gertz Rd,9480,S,FS,45,10,55,21,Fall2018
43,1100 Block NW Frontage Rd,9481,E,AT,135,130,265,41,Fall2018
714,9400 Block SW Commerce Circle,9484,W,AT,0,7,7,0,Fall2018
3782,SE 122nd & Schiller,9487,N,FS,24,3,27,9,Fall2018
450,3505 SW US Veterans Rd,9488,W,OP,52,40,92,1,Fall2018
549,5500 Block SE International Way,9503,S,AT,4,2,6,0,Fall2018
1510,N Lombard & New York,9505,S,NS,134,16,150,43,Fall2018
140,13900 Block SW 72nd,9509,W,OP,1,0,1,0,Fall2018
6166,SW Boones Ferry Rd & Iowa Dr ,9511,N,FS,5,0,5,0,Fall2018
6167,SW Boones Ferry Rd & Iowa Dr ,9512,S,FS,0,6,6,0,Fall2018
785,Beavercreek & Molalla,9516,E,NS,4,25,29,6,Fall2018
784,Beavercreek & Library Ct,9517,N,OP,51,7,58,6,Fall2018
299,20300 Block SW Pacific Hwy,9519,W,AT,0,5,5,2,Fall2018
4522,SE Eagle Creek Rd & Hinman,9520,N,NS,0,0,0,0,Fall2018
4529,SE Eagle Creek Rd & Strubhar Lane,9521,S,FS,0,1,1,0,Fall2018
6506,SW Garden Home & Orchard Lane,9525,S,NS,1,1,2,0,Fall2018
7527,W Burnside & SW 2nd,9526,E,NS,416,192,608,190,Fall2018
6056,SW Barnes & NW 118th,9531,W,NS,8,29,37,0,Fall2018
6033,SW Barnes & 117th,9532,E,NS,8,4,12,0,Fall2018
6866,SW Oak & Dennis,9535,E,NS,11,23,34,8,Fall2018
540,5200 Block NE 148th (Relay Resources),9537,S,AT,1,0,1,0,Fall2018
6717,SW Laurelwood & Laurel,9544,S,FS,1,63,64,0,Fall2018
1169,Lake Oswego Transit Center,9545,E,NS,39,128,167,62,Fall2018
2500,NE Fremont & Sandy,9548,E,NS,6,6,12,2,Fall2018
2923,NE Riverside Way & 33rd Dr,9549,W,FS,21,1,22,1,Fall2018
380,2800 Block NE Riverside Way,9550,E,AT,1,11,12,0,Fall2018
7019,SW Salmon & 18th,9552,W,NS,74,13,87,2,Fall2018
1189,Linn & Williams,9559,S,OP,6,30,36,19,Fall2018
403,29200 Block SE Eagle Creek Rd,9561,S,AT,0,1,1,0,Fall2018
404,29200 Block SE Eagle Creek Rd,9562,N,OP,0,0,0,0,Fall2018
2318,NE Cornell & 48th,9564,W,FS,13,9,22,8,Fall2018
6395,SW Durham & 72nd,9565,E,NS,1,7,8,0,Fall2018
691,8800 Block SW Oleson,9570,E,OP,2,0,2,1,Fall2018
1518,N Lombard & Reno,9575,S,NS,90,1,91,6,Fall2018
1519,N Lombard & Reno,9576,N,NS,0,84,84,19,Fall2018
224,1700 Block Beavercreek Rd,9578,W,AT,7,1,8,2,Fall2018
188,1600 Block Beavercreek Rd,9579,W,AT,5,1,6,1,Fall2018
781,Beavercreek & Hwy 213,9580,W,FS,16,1,17,3,Fall2018
189,1600 Block Beavercreek Rd,9581,E,AT,1,10,11,3,Fall2018
292,2000 Block Beavercreek Rd,9582,E,AT,0,7,7,1,Fall2018
782,Beavercreek & Hwy 213,9583,E,NS,0,6,6,2,Fall2018
6923,SW Pacific Hwy & Royalty Parkway,9597,N,FS,53,10,63,28,Fall2018
6802,SW Morrison & 12th,9598,W,NS,65,29,94,27,Fall2018
6805,SW Morrison & 17th,9599,W,FS,196,63,259,38,Fall2018
5663,SW 11th & Alder,9600,S,NS,83,173,256,90,Fall2018
3359,NW Evergreen Pkwy & NE 79th (NW 215th),9601,W,NS,7,1,8,2,Fall2018
3360,NW Evergreen Pkwy & NE 79th (NW 215th),9602,E,NS,2,12,14,2,Fall2018
345,2500 Block NE Century (NW 229th),9603,N,AT,8,31,39,0,Fall2018
346,2500 Block NE Century (NW 229th),9604,S,AT,27,9,36,0,Fall2018
1983,NE 25th & Sunrise Lane,9606,N,OP,0,0,0,0,Fall2018
1984,NE 25th & Sunrise Lane,9607,S,NS,0,0,0,0,Fall2018
7639,Willow Creek Transit Center,9610,E,AT,506,178,684,87,Fall2018
2104,NE 57th & Failing,9611,N,NS,2,7,9,0,Fall2018
6804,SW Morrison & 16th,9613,W,NS,74,29,103,13,Fall2018
2270,NE Century (NW 229th) & Butler,9614,N,NS,3,5,8,0,Fall2018
599,6400 Block SE Lake,9615,N,AT,1,2,3,1,Fall2018
1789,NE 105th & Marx,9619,N,NS,0,2,2,0,Fall2018
7640,Willow Creek Transit Center,9621,E,AT,201,177,378,58,Fall2018
6839,SW Murray & NW Milburn,9623,N,NS,6,5,11,0,Fall2018
7450,Sunset TC MAX Station,9624,W,AT,643,2426,3069,0,Fall2018
7452,Sunset Transit Center,9625,W,AT,240,275,515,64,Fall2018
6047,SW Barnes & Cedar Hills Blvd,9627,E,FS,35,45,80,10,Fall2018
6048,SW Barnes & Cedar Hills Blvd,9628,W,NS,37,38,75,5,Fall2018
6628,SW Hamilton & 58th,9634,W,FS,0,1,1,0,Fall2018
1598,N Portsmouth & Willamette,9635,S,NS,59,71,130,10,Fall2018
1962,NE 223rd & Glisan,9636,S,FS,21,7,28,3,Fall2018
7320,SW Tualatin-Sherwood Rd & Pacific Hwy,9639,N,NS,82,2,84,21,Fall2018
4886,SE Hwy 224 & Sherman Cooper,9640,E,NS,0,0,0,0,Fall2018
4887,SE Hwy 224 & Sherman Cooper,9641,W,OP,0,1,1,0,Fall2018
1817,NE 122nd & Multnomah,9642,S,OP,55,10,65,32,Fall2018
226,1700 Block SE Orient Dr,9644,N,AT,2,0,2,0,Fall2018
6898,SW Pacific Hwy & 74th (Park & Ride),9648,E,FS,151,43,194,11,Fall2018
7571,Washington Square Transit Center,9649,N,AT,210,214,424,49,Fall2018
7572,Washington Square Transit Center,9650,N,AT,269,265,534,59,Fall2018
7579,Washington Square Transit Center,9651,N,AT,269,253,522,44,Fall2018
7580,Washington Square Transit Center,9652,S,AT,277,309,586,68,Fall2018
6657,SW Hart & Forest Dr,9663,W,NS,6,11,17,0,Fall2018
6655,SW Hart & Dunsmuir,9664,W,OP,1,2,3,0,Fall2018
6648,SW Hart & 155th,9665,W,FS,1,3,4,0,Fall2018
6651,SW Hart & 160th,9667,W,NS,10,15,25,0,Fall2018
6653,SW Hart & 165th,9668,W,OP,4,13,17,1,Fall2018
5981,SW Bany & Tallac Way,9669,W,OP,6,16,22,0,Fall2018
5701,SW 170th & Canby,9670,N,NS,4,3,7,0,Fall2018
5704,SW 170th & Ivy Glenn,9671,N,NS,1,3,4,0,Fall2018
5706,SW 170th & Oak,9672,N,FS,4,7,11,2,Fall2018
5708,SW 170th & Rosa Place,9673,N,FS,1,3,4,0,Fall2018
6441,SW Farmington & 185th,9674,W,NS,21,24,45,2,Fall2018
5705,SW 170th & Ivy Glenn,9675,S,NS,3,1,4,1,Fall2018
5709,SW 170th & Rosa Place,9676,S,OP,1,1,2,0,Fall2018
5707,SW 170th & Oak,9677,S,FS,5,5,10,0,Fall2018
5702,SW 170th & Cynthia,9678,S,NS,3,4,7,1,Fall2018
5982,SW Bany & Tallac Way,9679,E,FS,14,6,20,0,Fall2018
6654,SW Hart & 165th,9680,E,FS,13,7,20,1,Fall2018
6652,SW Hart & 161st,9681,E,FS,6,4,10,0,Fall2018
6650,SW Hart & 157th,9682,E,FS,11,5,16,0,Fall2018
6649,SW Hart & 155th,9683,E,FS,4,3,7,0,Fall2018
6656,SW Hart & Dunsmuir,9684,E,FS,2,1,3,0,Fall2018
5973,SW Arctic Dr & Western Ave,9685,E,FS,0,7,7,0,Fall2018
5976,SW Arctic Drive & Harvest Court,9686,S,OP,0,20,20,0,Fall2018
5965,SW Allen & Lombard,9687,E,FS,2,5,7,3,Fall2018
5963,SW Allen & King,9688,E,NS,1,4,5,0,Fall2018
22,10400 Block SW Allen,9689,E,AT,34,2,36,0,Fall2018
5978,SW Arctic Drive & Sunshine Court,9694,N,NS,10,2,12,0,Fall2018
5977,SW Arctic Drive & Harvest Court,9695,N,FS,8,2,10,0,Fall2018
5974,SW Arctic Dr & Western Ave,9696,W,NS,3,0,3,0,Fall2018
5890,SW 5th & Western,9697,W,FS,2,2,4,0,Fall2018
38,10900 Block SW 5th,9698,W,OP,4,2,6,0,Fall2018
39,10900 Block SW 5th,9699,E,AT,1,4,5,0,Fall2018
5891,SW 5th & Western,9700,E,NS,0,1,1,0,Fall2018
5975,SW Arctic Drive & Allen,9701,S,NS,1,7,8,0,Fall2018
28,10500 Block SW Allen,9703,W,AT,0,20,20,0,Fall2018
5964,SW Allen & King,9704,W,NS,5,1,6,0,Fall2018
537,5000 Block SW Griffith Drive,9705,N,AT,2,1,3,0,Fall2018
516,4800 Block SW Griffith Drive,9706,N,AT,2,1,3,0,Fall2018
523,4900 Block SW Griffith Drive,9707,E,AT,0,2,2,0,Fall2018
6803,SW Morrison & 14th,9708,W,NS,42,28,70,18,Fall2018
2560,NE Glisan & 28th,9709,W,FS,57,38,95,4,Fall2018
254,18600 Block NE Sandy,9715,E,FS,1,4,5,0,Fall2018
268,19000 Block NE Sandy (East Entrance),9716,E,NS,1,1,2,0,Fall2018
307,21100 Block NE Sandy,9717,E,AT,3,4,7,3,Fall2018
2989,NE Sandy & 201st,9718,E,FS,24,17,41,23,Fall2018
2991,NE Sandy & 205th,9719,E,FS,29,19,48,6,Fall2018
308,21100 Block NE Sandy,9722,W,OP,4,3,7,2,Fall2018
2992,NE Sandy & 206th Pl,9723,W,FS,23,25,48,7,Fall2018
2990,NE Sandy & 201st,9724,W,NS,18,24,42,31,Fall2018
269,19000 Block NE Sandy (East Entrance),9725,W,OP,1,1,2,1,Fall2018
255,18600 Block NE Sandy,9726,W,NS,2,1,3,0,Fall2018
779,Beavercreek & Fir,9755,W,NS,1,0,1,2,Fall2018
3008,NE Sandy & 42nd,9756,W,FS,152,94,246,76,Fall2018
3665,Providence Park MAX Station,9757,W,AT,1048,1781,2829,0,Fall2018
3666,Providence Park MAX Station,9758,E,AT,1301,1068,2369,0,Fall2018
1149,Kings Hill/SW Salmon St MAX Station,9759,N,AT,334,389,723,0,Fall2018
5972,SW Apple Way & Laurelwood,9760,E,NS,2,1,3,1,Fall2018
5940,SW 78th & Westmoor,9761,N,FS,0,0,0,0,Fall2018
5938,SW 78th & Brentwood,9762,N,NS,0,0,0,0,Fall2018
6181,SW Brentwood & Laurelwood ,9763,W,NS,0,0,0,0,Fall2018
6714,SW Laurelwood & Beaverton-Hillsdale Hwy,9764,S,NS,0,0,0,0,Fall2018
678,8500 Block SW Apple Way,9765,S,FS,0,0,0,0,Fall2018
1963,NE 223rd & Glisan,9766,N,NS,4,24,28,3,Fall2018
1964,NE 223rd & Park Lane,9767,S,FS,32,16,48,23,Fall2018
1965,NE 223rd & Park Lane,9772,N,FS,17,29,46,28,Fall2018
144,1400 Block NE 223rd,9773,N,AT,6,6,12,0,Fall2018
2994,NE Sandy & 223rd,9775,E,FS,6,11,17,0,Fall2018
2995,NE Sandy & 223rd,9776,W,FS,8,7,15,0,Fall2018
6380,SW Denney & King,9781,W,FS,6,3,9,1,Fall2018
6746,SW Lombard & Camden,9782,N,NS,1,1,2,0,Fall2018
6747,SW Lombard & Camden,9785,S,NS,2,1,3,0,Fall2018
2272,NE Century (NW 229th) & Evergreen Pkwy,9790,S,FS,9,5,14,0,Fall2018
2279,NE Century (NW 229th) & Evergreen Pkwy,9791,N,NS,3,13,16,0,Fall2018
5487,SE Stark & SW Sundial ,9792,W,FS,28,26,54,20,Fall2018
3270,NW Cornell & 158th,9793,W,OP,9,25,34,1,Fall2018
3349,NW Eastman & Division,9795,S,FS,7,1,8,1,Fall2018
6049,SW Barnes & Cedar Hills Blvd,9808,W,FS,1,1,2,0,Fall2018
266,19000 Block NE Sandy,9811,E,AT,2,4,6,0,Fall2018
797,Beaverton TC MAX Station,9818,S,AT,1605,1637,3242,0,Fall2018
795,Beaverton Creek MAX Station,9819,N,AT,141,734,875,0,Fall2018
1150,Kings Hill/SW Salmon St MAX Station,9820,S,AT,314,336,650,0,Fall2018
798,Beaverton TC MAX Station,9821,N,AT,2949,3353,6302,0,Fall2018
796,Beaverton Creek MAX Station,9822,S,AT,750,127,877,0,Fall2018
787,Beaverton Central MAX Station,9823,W,AT,392,412,804,0,Fall2018
788,Beaverton Central MAX Station,9824,E,AT,434,437,871,0,Fall2018
1227,Millikan Way MAX Station,9825,W,AT,424,1026,1450,0,Fall2018
1228,Millikan Way MAX Station,9826,E,AT,1147,421,1568,0,Fall2018
1224,Merlo Rd/SW 158th Ave MAX Station,9827,W,AT,220,610,830,0,Fall2018
1225,Merlo Rd/SW 158th Ave MAX Station,9828,E,AT,636,231,867,0,Fall2018
1036,Elmonica/SW 170th Ave MAX Station,9829,W,AT,322,1134,1456,0,Fall2018
1037,Elmonica/SW 170th Ave MAX Station,9830,E,AT,1130,259,1389,0,Fall2018
7643,Willow Creek/SW 185th Ave TC MAX Station,9831,E,AT,1307,480,1787,0,Fall2018
7644,Willow Creek/SW 185th Ave TC MAX Station,9832,W,AT,511,1306,1817,0,Fall2018
3667,Quatama MAX Station,9833,W,AT,259,1064,1323,0,Fall2018
3668,Quatama MAX Station,9834,E,AT,1169,268,1437,0,Fall2018
3591,Orenco MAX Station,9835,E,AT,953,314,1267,0,Fall2018
3592,Orenco MAX Station,9836,W,AT,344,960,1304,0,Fall2018
1041,Fair Complex/Hillsboro Airport MAX Stn,9837,W,AT,122,741,863,0,Fall2018
1042,Fair Complex/Hillsboro Airport MAX Stn,9838,E,AT,755,128,883,0,Fall2018
1078,Hawthorn Farm MAX Station,9839,E,AT,279,106,385,0,Fall2018
1079,Hawthorn Farm MAX Station,9840,W,AT,98,272,370,0,Fall2018
7581,Washington/SE 12th Ave MAX Station,9841,E,AT,368,102,470,0,Fall2018
7582,Washington/SE 12th Ave MAX Station,9842,W,AT,98,353,451,0,Fall2018
7475,Tuality Hospital/SE 8th Ave MAX Station,9843,E,AT,425,72,497,0,Fall2018
7476,Tuality Hospital/SE 8th Ave MAX Station,9844,W,AT,62,443,505,0,Fall2018
1086,Hillsboro Central/SE 3rd TC MAX Station,9845,W,AT,44,855,899,0,Fall2018
1087,Hillsboro Central/SE 3rd TC MAX Station,9846,E,AT,801,43,844,0,Fall2018
1077,Hatfield Government Center MAX Station,9848,S,AT,949,910,1859,0,Fall2018
6063,SW Baseline & Dennis,9850,W,NS,16,16,32,3,Fall2018
2282,NE Century (NW 229th) & Rosebay Dr,9851,S,NS,2,2,4,0,Fall2018
267,19000 Block NE Sandy,9853,W,OP,4,1,5,0,Fall2018
7518,W Burnside & SW 18th,9860,E,NS,106,33,139,40,Fall2018
7242,SW Terwilliger & Sam Jackson,9861,N,NS,4,21,25,1,Fall2018
41,1100 Block N Hayden Meadows Dr,9862,N,NS,72,26,98,71,Fall2018
7641,Willow Creek Transit Center,9869,E,AT,178,526,704,77,Fall2018
7642,Willow Creek Transit Center,9871,E,AT,14,23,37,0,Fall2018
646,7600 Block SW Barnes,9872,W,OP,3,12,15,0,Fall2018
575,600 Block NW Naito Parkway,9873,N,AT,4,3,7,9,Fall2018
698,900 Block NW Naito Parkway,9874,N,OP,3,5,8,8,Fall2018
3451,NW Naito Parkway & 9th,9875,N,OP,11,3,14,3,Fall2018
3371,NW Front & 15th,9877,N,FS,5,9,14,0,Fall2018
3372,NW Front & 17th,9878,N,FS,8,16,24,2,Fall2018
3374,NW Front & 21st,9879,N,OP,1,7,8,2,Fall2018
3377,NW Front & Nicolai,9880,N,FS,7,16,23,0,Fall2018
415,3000 Block NW Front,9881,N,OP,0,11,11,0,Fall2018
699,900 Block NW Naito Parkway,9889,S,AT,8,4,12,9,Fall2018
3452,NW Naito Parkway & 9th,9890,S,FS,6,18,24,2,Fall2018
3373,NW Front & 17th,9893,S,NS,28,13,41,1,Fall2018
3375,NW Front & 21st,9894,S,NS,3,1,4,1,Fall2018
3378,NW Front & Nicolai,9896,S,NS,10,6,16,0,Fall2018
2403,NE Evergreen & 13th,9920,W,OP,0,1,1,0,Fall2018
2414,NE Evergreen & NW Jackson School Rd N,9921,W,FS,0,0,0,0,Fall2018
2874,NE Orenco Station Loop & MAX Station,9923,E,AT,148,54,202,6,Fall2018
410,300 Block E Main,9931,W,AT,1,0,1,0,Fall2018
990,E Main & N 1st,9933,W,NS,1,0,1,0,Fall2018
1265,N 1st & NE Edison,9935,N,NS,1,0,1,2,Fall2018
1272,N 1st & NE Grant,9936,N,NS,1,0,1,0,Fall2018
1273,N 1st & NE Tiffany,9937,N,FS,0,0,0,0,Fall2018
381,2800 Block NW Glencoe,9938,N,OP,2,8,10,0,Fall2018
3383,NW Glencoe & NE Cory,9939,N,FS,3,3,6,0,Fall2018
3384,NW Glencoe & NE Lenox,9940,N,NS,2,4,6,1,Fall2018
3385,NW Glencoe & NE Milne,9941,N,NS,0,1,1,0,Fall2018
2413,NE Evergreen & NW Glencoe,9942,E,FS,0,0,0,0,Fall2018
2405,NE Evergreen & 3rd,9943,E,NS,1,0,1,0,Fall2018
2415,NE Evergreen & Sunburst,9944,E,NS,0,0,0,0,Fall2018
2411,NE Evergreen & Jackson School Rd,9945,E,NS,0,0,0,0,Fall2018
2410,NE Evergreen & Jackson Road Loop,9946,E,NS,0,0,0,0,Fall2018
2404,NE Evergreen & 13th,9947,E,NS,1,1,2,0,Fall2018
1887,NE 15th & Jones Farm Pkwy,9948,S,NS,6,2,8,0,Fall2018
2616,NE Griffin Oaks & 15th,9949,E,FS,3,2,5,0,Fall2018
242,1800 Block NE Griffin Oaks,9950,E,AT,2,1,3,0,Fall2018
320,2200 Block NE Griffin Oaks,9951,E,AT,2,2,4,0,Fall2018
1981,NE 25th & Kathryn,9952,S,NS,1,0,1,0,Fall2018
1040,Fair Complex/Airport Park & Ride,9953,E,AT,45,50,95,36,Fall2018
1090,Hillsboro Transit Center,9954,E,AT,52,13,65,8,Fall2018
1091,Hillsboro Transit Center,9955,E,AT,277,469,746,150,Fall2018
1092,Hillsboro Transit Center,9956,E,AT,190,69,259,55,Fall2018
1229,Millikan Way MAX Station/Park and Ride,9957,W,AT,67,232,299,18,Fall2018
1230,Millikan Way MAX Station/Park and Ride,9958,W,AT,193,79,272,25,Fall2018
3086,NE Shaver & Parkrose HS,9959,W,AT,25,10,35,0,Fall2018
2067,NE 34th & Cornell,9962,N,NS,0,0,0,0,Fall2018
1982,NE 25th & Kathryn,9963,N,OP,0,1,1,0,Fall2018
2617,NE Griffin Oaks & 15th,9965,W,NS,5,2,7,0,Fall2018
243,1800 Block NE Griffin Oaks,9966,W,OP,1,4,5,0,Fall2018
1888,NE 15th & Jones Farm Pkwy,9967,N,OP,3,3,6,0,Fall2018
7451,Sunset TC MAX Station,9969,E,AT,2428,534,2962,0,Fall2018
7453,Sunset Transit Center,9970,W,AT,140,75,215,32,Fall2018
7454,Sunset Transit Center,9971,W,AT,80,110,190,0,Fall2018
7455,Sunset Transit Center,9972,W,AT,20,25,45,2,Fall2018
7456,Sunset Transit Center,9975,W,AT,70,176,246,44,Fall2018
800,Beaverton Transit Center,9976,S,AT,278,252,530,67,Fall2018
801,Beaverton Transit Center,9977,E,AT,164,190,354,7,Fall2018
802,Beaverton Transit Center,9978,S,AT,527,449,976,169,Fall2018
803,Beaverton Transit Center,9979,N,AT,428,385,813,84,Fall2018
804,Beaverton Transit Center,9981,S,AT,497,24,521,167,Fall2018
805,Beaverton Transit Center,9982,S,AT,539,35,574,155,Fall2018
806,Beaverton Transit Center,9983,S,AT,142,157,299,22,Fall2018
807,Beaverton Transit Center,9984,N,AT,1007,825,1832,201,Fall2018
808,Beaverton Transit Center,9985,S,AT,407,362,769,90,Fall2018
809,Beaverton Transit Center,9986,S,AT,539,469,1008,126,Fall2018
2412,NE Evergreen & Jackson School Rd S,9987,W,OP,1,0,1,0,Fall2018
2416,NE Evergreen & Sunburst,9988,W,OP,0,0,0,0,Fall2018
2406,NE Evergreen & 3rd,9989,W,OP,1,0,1,0,Fall2018
425,30900 Block NE Evergreen,9990,W,OP,0,0,0,0,Fall2018
382,2800 Block NW Glencoe,9991,S,AT,8,1,9,0,Fall2018
3381,NW Glencoe & Cory,9992,S,FS,4,2,6,0,Fall2018
431,3100 Block NW Glencoe,9993,S,AT,7,2,9,1,Fall2018
3382,NW Glencoe & Milne,9994,S,NS,3,1,4,0,Fall2018
1274,N 1st & NW Garibaldi,9995,S,NS,1,1,2,0,Fall2018
1275,N 1st & NW Tiffany,9996,S,NS,1,0,1,0,Fall2018
411,300 Block N 1st,9997,S,AT,1,0,1,5,Fall2018
2785,NE Lincoln & 2nd ,9998,E,NS,0,2,2,1,Fall2018
2068,NE 3rd & E Main,10000,S,NS,0,2,2,0,Fall2018
545,5400 Block NE Dawson Creek,10001,W,AT,1,0,1,0,Fall2018
2407,NE Evergreen & Brookwood,10004,E,NS,1,1,2,0,Fall2018
426,3100 Block NE Dawson Creek,10005,N,AT,1,3,4,36,Fall2018
3922,SE 223rd & Stark,10006,S,FS,13,57,70,11,Fall2018
584,600 Block SE 223rd,10007,N,AT,4,9,13,2,Fall2018
3288,NW Cornell & 192nd,10008,W,OP,5,21,26,2,Fall2018
3305,NW Cornell & NE Amberglen (NW 194th),10009,W,FS,15,13,28,5,Fall2018
3310,NW Cornell & NE Overlook (NW Amberbrook),10010,W,NS,6,9,15,1,Fall2018
3308,NW Cornell & NE John Olsen,10011,W,NS,18,15,33,1,Fall2018
3303,NW Cornell & NE Aloclek ,10013,W,FS,3,9,12,0,Fall2018
2334,NE Cornell & Cornelius Pass,10014,W,FS,4,9,13,1,Fall2018
2324,NE Cornell & Butler,10015,S,FS,10,14,24,4,Fall2018
2351,NE Cornell & Walbridge,10016,W,FS,4,5,9,3,Fall2018
3306,NW Cornell & NE Amberglen (NW Amberwood),10021,E,NS,18,22,40,3,Fall2018
3311,NW Cornell & NE Overlook (NW Amberbrook),10022,E,NS,7,5,12,2,Fall2018
3309,NW Cornell & NE John Olsen (NW 206th),10023,E,NS,24,13,37,2,Fall2018
3289,NW Cornell & 192nd,10024,E,NS,12,3,15,0,Fall2018
3304,NW Cornell & NE Aloclek ,10025,E,FS,5,6,11,3,Fall2018
2316,NE Cornell & 25th,10026,E,FS,21,22,43,12,Fall2018
2319,NE Cornell & 48th,10028,E,NS,5,13,18,6,Fall2018
3307,NW Cornell & NE Cornelius Pass,10029,E,FS,6,2,8,1,Fall2018
2325,NE Cornell & Butler,10030,E,NS,15,19,34,8,Fall2018
2346,NE Cornell & NW Walbridge,10031,E,NS,6,8,14,7,Fall2018
2350,NE Cornell & Stucki (NW Amberglen),10032,E,FS,31,19,50,6,Fall2018
2284,NE Century (NW 231st) & Alder/Orenco Stn,10033,N,FS,8,25,33,2,Fall2018
487,4100 Block SW 110th,10035,S,OP,54,1,55,0,Fall2018
496,4200 Block SW 110th,10036,N,AT,1,56,57,0,Fall2018
19,10200 Block SW Park Way,10037,W,AT,1,0,1,0,Fall2018
2286,NE Century (NW 231st) & Carillion,10041,S,NS,1,5,6,0,Fall2018
2292,NE Century (NW 231st) & Orenco Max Stn,10042,S,NS,29,97,126,7,Fall2018
2288,NE Century (NW 231st) & Dogwood,10043,S,NS,1,2,3,1,Fall2018
2293,NE Century (NW 231st) & Orenco Ridge,10044,S,FS,1,4,5,0,Fall2018
1021,E Main (W Baseline) & SE 58th Ct,10045,W,OP,1,2,3,1,Fall2018
1017,E Main (W Baseline) & NE 53rd,10046,W,NS,7,8,15,0,Fall2018
1015,E Main (W Baseline) & NE 49th,10047,W,NS,2,1,3,0,Fall2018
1022,E Main (W Baseline) & SE 58th Ct,10049,E,NS,2,0,2,0,Fall2018
1018,E Main (W Baseline) & NE 53rd,10050,E,NS,7,10,17,1,Fall2018
1016,E Main (W Baseline) & NE 49th,10051,E,NS,1,1,2,0,Fall2018
2285,NE Century (NW 231st) & Campus Way,10052,N,NS,5,1,6,1,Fall2018
2289,NE Century (NW 231st) & Dogwood,10053,N,NS,2,1,3,0,Fall2018
2287,NE Century (NW 231st) & Deer Run,10054,N,FS,6,2,8,0,Fall2018
2418,NE Evergreen Pkwy & 106th (NW 188th),10056,E,NS,13,32,45,7,Fall2018
881,Dawson Creek & Brookwood,10061,N,FS,1,6,7,0,Fall2018
7423,Shute Rd & Dawson Creek Dr,10063,S,NS,1,1,2,0,Fall2018
3209,NW 31st & Guam,10071,S,NS,1,23,24,3,Fall2018
436,3300 Block NW Guam,10072,W,AT,0,3,3,2,Fall2018
3407,NW Guam & 35th,10073,W,NS,1,17,18,0,Fall2018
434,3300 Block NW 35th,10074,N,AT,1,10,11,1,Fall2018
3409,NW Kaiser & Snowlily Dr,10076,N,NS,2,5,7,0,Fall2018
3410,NW Kaiser & Two Ponds Dr,10077,N,FS,4,15,19,0,Fall2018
180,15500 Block NW Springville,10078,W,AT,0,1,1,0,Fall2018
3467,NW Springville & 160th,10079,W,FS,4,11,15,1,Fall2018
3480,NW Springville & Sickle Terrace,10080,W,FS,0,6,6,0,Fall2018
3474,NW Springville & Joss,10081,W,NS,1,6,7,9,Fall2018
3478,NW Springville & Samuel Drive,10082,W,OP,0,1,1,0,Fall2018
3469,NW Springville & 173rd,10083,W,OP,0,3,3,0,Fall2018
3223,NW Bethany & Cornell,10084,N,FS,27,21,48,9,Fall2018
3221,NW Bethany & Bronson,10085,N,FS,7,15,22,4,Fall2018
3235,NW Bethany & Oak Hills Dr,10086,N,NS,4,8,12,0,Fall2018
3241,NW Bethany & Telshire Terrace,10087,N,NS,0,1,1,0,Fall2018
3237,NW Bethany & Ridgetop Lane,10088,N,NS,1,2,3,0,Fall2018
3243,NW Bethany & West Union,10089,N,FS,2,7,9,0,Fall2018
3239,NW Bethany & Saint Andrews,10090,N,FS,0,2,2,1,Fall2018
3234,NW Bethany & Mitchell,10091,N,NS,2,3,5,0,Fall2018
511,4700 Block NW Bethany,10092,N,AT,8,43,51,3,Fall2018
3226,NW Bethany & Laidlaw,10093,N,NS,5,23,28,0,Fall2018
3225,NW Bethany & Kaiser Rd,10094,N,NS,6,9,15,0,Fall2018
3643,Pier Park,10095,E,AT,87,76,163,24,Fall2018
3475,NW Springville & Kaiser Rd,10098,E,NS,5,2,7,0,Fall2018
3476,NW Springville & Oats Terrace,10099,E,NS,11,2,13,0,Fall2018
3481,NW Springville & Sickle Terrace,10100,E,NS,6,2,8,0,Fall2018
3468,NW Springville & 165th Terrace,10101,E,OP,6,1,7,0,Fall2018
3479,NW Springville & Samuel Drive,10102,E,NS,1,0,1,0,Fall2018
3470,NW Springville & 173rd,10103,E,NS,5,1,6,0,Fall2018
3411,NW Kaiser & Westbrook,10104,S,NS,5,4,9,0,Fall2018
3408,NW Kaiser & Graf St,10105,S,NS,13,2,15,0,Fall2018
3245,NW Bethany & Wismer,10106,S,FS,8,6,14,0,Fall2018
3233,NW Bethany & Laidlaw,10107,S,NS,53,18,71,2,Fall2018
512,4700 Block NW Bethany,10108,S,OP,31,5,36,4,Fall2018
3222,NW Bethany & Claremont Dr,10109,S,NS,5,2,7,0,Fall2018
3240,NW Bethany & Saint Andrews,10110,S,NS,2,0,2,0,Fall2018
3244,NW Bethany & West Union,10111,S,NS,9,3,12,0,Fall2018
3238,NW Bethany & Ridgetop Lane,10112,S,FS,2,0,2,0,Fall2018
3242,NW Bethany & Telshire Terrace,10113,S,FS,1,0,1,0,Fall2018
3236,NW Bethany & Oak Hills Dr,10114,S,FS,11,4,15,0,Fall2018
3224,NW Bethany & Cornell,10115,S,NS,14,18,32,3,Fall2018
1063,Goose Hollow/SW Jefferson St MAX Station,10117,W,AT,885,434,1319,0,Fall2018
1064,Goose Hollow/SW Jefferson St MAX Station,10118,E,AT,444,1375,1819,0,Fall2018
7568,Washington Park MAX Station,10120,E,AT,507,287,794,0,Fall2018
7569,Washington Park MAX Station,10121,W,AT,240,682,922,0,Fall2018
302,20700 Block NE Halsey,10125,E,OP,4,14,18,1,Fall2018
6064,SW Baseline & Main,10129,W,FS,15,25,40,13,Fall2018
6840,SW Murray & Nike,10132,N,OP,9,9,18,0,Fall2018
6841,SW Murray & Nike,10133,S,NS,11,8,19,0,Fall2018
5529,SE Sunnyside & 122nd,10135,W,NS,26,6,32,1,Fall2018
5531,SE Sunnyside & 128th,10136,E,FS,1,4,5,2,Fall2018
5532,SE Sunnyside & 128th,10137,W,FS,3,1,4,2,Fall2018
5533,SE Sunnyside & 132nd,10138,E,FS,3,9,12,0,Fall2018
5534,SE Sunnyside & 132nd,10139,W,NS,8,2,10,0,Fall2018
5535,SE Sunnyside & 139th,10140,E,FS,1,4,5,0,Fall2018
5536,SE Sunnyside & 140th,10141,W,FS,2,0,2,0,Fall2018
5537,SE Sunnyside & 142nd,10142,E,FS,2,12,14,1,Fall2018
5538,SE Sunnyside & 142nd,10143,W,NS,10,2,12,1,Fall2018
172,14600 Block SE 147th,10146,S,AT,2,3,5,0,Fall2018
5176,SE Oregon Trail Dr & Hines,10148,E,NS,4,2,6,3,Fall2018
4984,SE Lake & Freeman Way,10149,W,FS,5,1,6,0,Fall2018
3366,NW Evergreen Pkwy & NE Stucki,10150,N,FS,21,9,30,5,Fall2018
3257,NW Cedar Hills & Leahy,10152,S,FS,3,1,4,0,Fall2018
2290,NE Century (NW 231st) & Oelrich,10153,S,NS,0,2,2,0,Fall2018
2291,NE Century (NW 231st) & Oelrich,10154,N,NS,1,0,1,0,Fall2018
2283,NE Century (NW 229th) & Walbridge,10155,N,NS,3,2,5,0,Fall2018
5577,SE Tualatin Valley Hwy & 44th,10157,E,OP,20,32,52,117,Fall2018
1524,N Lombard & Terminal 5 Access Rd,10162,S,NS,0,0,0,0,Fall2018
1525,N Lombard & Terminal 5 Access Rd,10163,N,OP,0,0,0,0,Fall2018
3477,NW Springville & PCC Drive,10165,W,NS,0,5,5,1,Fall2018
6442,SW Farmington & 185th,10166,E,FS,107,118,225,13,Fall2018
6322,SW Columbia & 18th,10168,E,NS,242,201,443,13,Fall2018
3379,NW Glencoe & Cody Ct,10169,N,FS,1,1,2,0,Fall2018
481,400 Block SW 257th,10170,N,AT,0,3,3,0,Fall2018
482,400 Block SW 257th,10171,S,OP,2,0,2,0,Fall2018
7431,South Shore & Cedar Rd,10175,E,FS,2,1,3,19,Fall2018
619,700 SW Campus Dr at Doernbecher,10176,E,AT,98,11,109,4,Fall2018
1436,N Ivanhoe & Leavitt,10177,W,FS,20,1,21,0,Fall2018
7465,Tigard Transit Center,10180,S,AT,159,92,251,28,Fall2018
661,800 Block SW 158th,10182,S,AT,0,1,1,0,Fall2018
2239,NE Alberta & 7th,10184,W,NS,10,21,31,5,Fall2018
328,22600 Block SE Hwy 224,10185,W,OP,0,0,0,0,Fall2018
329,22600 Block SE Hwy 224,10186,E,AT,0,1,1,0,Fall2018
3951,SE 28th & Carlton,10189,S,OP,2,0,2,0,Fall2018
5574,SE Tualatin Valley Hwy & 30th,10190,W,NS,5,12,17,3,Fall2018
2335,NE Cornell & Elam Young East,10192,W,OP,3,4,7,3,Fall2018
2322,NE Cornell & Brookwood Pkwy,10193,E,NS,1,2,3,0,Fall2018
239,17600 Block NE Sandy,10194,W,AT,20,8,28,0,Fall2018
4590,SE Foster & 63rd,10196,E,NS,9,31,40,8,Fall2018
2323,NE Cornell & Brookwood Pkwy,10197,W,NS,1,2,3,2,Fall2018
321,2200 Block NE Griffin Oaks,10198,W,OP,2,2,4,0,Fall2018
5530,SE Sunnyside & 122nd,10203,E,FS,6,27,33,5,Fall2018
5044,SE Mather & Cedar Park Dr,10204,W,NS,1,0,1,0,Fall2018
27,10500 Block SE Mather,10205,E,OP,1,5,6,0,Fall2018
5043,SE Mather & Bliss,10206,E,FS,0,0,0,0,Fall2018
5038,SE Mather & 116th Ct,10208,E,NS,0,1,1,0,Fall2018
5040,SE Mather & 119th Ct,10209,E,OP,0,0,0,0,Fall2018
5042,SE Mather & 122nd,10210,E,NS,1,2,3,0,Fall2018
6658,SW Hart & Forest Drive,10211,E,OP,2,8,10,0,Fall2018
5552,SE Sunnyside & Valley View Terr,10214,W,FS,18,2,20,1,Fall2018
5528,SE Sunnyside & 119th,10216,W,OP,18,5,23,2,Fall2018
5175,SE Oregon Trail Dr & 152nd,10219,E,NS,1,0,1,0,Fall2018
3822,SE 152nd & Territory Dr,10221,S,FS,1,0,1,0,Fall2018
3816,SE 152nd & Bollam Dr,10222,N,NS,1,2,3,0,Fall2018
3817,SE 152nd & Morning Way,10223,S,NS,1,0,1,0,Fall2018
3818,SE 152nd & Morning Way,10224,N,OP,0,1,1,0,Fall2018
126,13300 Block SE Hubbard,10225,W,OP,6,0,6,0,Fall2018
127,13300 Block SE Hubbard,10226,E,AT,0,2,2,0,Fall2018
4833,SE Hubbard & 125th ,10227,W,OP,5,0,5,0,Fall2018
4834,SE Hubbard & 125th ,10228,E,FS,0,2,2,0,Fall2018
3769,SE 122nd & Mountain Sun Dr,10229,N,NS,4,0,4,0,Fall2018
3770,SE 122nd & Mountain Sun Dr,10230,S,FS,0,1,1,0,Fall2018
3749,SE 122nd & Echo Valley,10231,N,OP,1,0,1,0,Fall2018
3750,SE 122nd & Echo Valley,10232,S,FS,0,0,0,0,Fall2018
4222,SE 97th & Lawnfield,10234,S,NS,1,6,7,0,Fall2018
4225,SE 97th & Talbert Dr,10235,S,OP,1,3,4,0,Fall2018
5710,SW 170th & Timberland Dr,10273,S,OP,2,2,4,0,Fall2018
5711,SW 170th & Timberland Dr,10274,N,NS,3,2,5,0,Fall2018
373,27500 Block SE Eagle Creek Rd,10275,N,AT,0,0,0,0,Fall2018
1872,NE 15th & Edgefield,10277,S,NS,2,1,3,0,Fall2018
1873,NE 15th & Edgefield,10278,N,OP,2,1,3,0,Fall2018
1896,NE 15th & Prahl Pkwy,10279,S,NS,3,1,4,0,Fall2018
1897,NE 15th & Prahl Pkwy,10280,N,OP,3,2,5,0,Fall2018
3194,NW 23rd & Overton,10287,S,NS,86,6,92,7,Fall2018
115,1300 Block NE 25th,10288,N,AT,0,0,0,0,Fall2018
78,1200 Block NE 25th,10289,S,AT,0,1,1,0,Fall2018
5601,SE Washington & 2nd,10290,E,NS,22,105,127,38,Fall2018
3509,NW St Helens & Marina Way,10291,N,FS,0,1,1,0,Fall2018
3609,PSU South/SW 6th & College MAX Stn,10293,N,NS,974,438,1412,0,Fall2018
3821,SE 152nd & Sedona Drive,10297,S,FS,2,0,2,0,Fall2018
1195,MAX Station/Oregon Zoo,10299,W,AT,45,43,88,2,Fall2018
3870,SE 17th & Spokane,10302,N,NS,28,5,33,1,Fall2018
4948,SE King & Home,10303,W,FS,11,8,19,2,Fall2018
1148,Kerr & Touchstone,10305,W,NS,13,7,20,14,Fall2018
4565,SE Flavel & 92nd (MAX Stn),10307,W,NS,30,11,41,34,Fall2018
3820,SE 152nd & Ranger Drive,10308,N,NS,0,1,1,0,Fall2018
2973,NE Sandy & 154th,10309,E,NS,4,13,17,0,Fall2018
6969,SW Patton & Humphrey,10310,S,NS,0,20,20,0,Fall2018
3274,NW Cornell & 169th Pl,10313,W,OP,3,5,8,0,Fall2018
340,2400 Block NW Westover,10314,N,OP,0,0,0,0,Fall2018
2984,NE Sandy & 181st/Airport Way,10315,E,FS,22,29,51,6,Fall2018
3049,NE Sandy & Airport Way/181st,10318,W,FS,46,17,63,9,Fall2018
3275,NW Cornell & 169th Pl,10319,E,NS,3,6,9,0,Fall2018
5057,SE McLoughlin & Glen Echo,10323,S,FS,24,38,62,28,Fall2018
1202,McLoughlin & Gloucester,10324,S,FS,12,41,53,25,Fall2018
1204,McLoughlin & River Rd,10325,S,NS,26,63,89,26,Fall2018
5058,SE McLoughlin & Glen Echo,10326,N,FS,44,26,70,17,Fall2018
5092,SE McLoughlin & W Gloucester,10327,N,FS,39,15,54,37,Fall2018
1205,McLoughlin & W Arlington,10328,N,FS,83,27,110,19,Fall2018
272,19300 Block McLoughlin,10421,N,AT,4,3,7,5,Fall2018
273,19300 Block McLoughlin,10422,S,AT,4,10,14,9,Fall2018
3104,NE Weidler & 15th,10425,E,NS,33,57,90,22,Fall2018
6646,SW Hart & 149th,10436,W,OP,1,3,4,0,Fall2018
6647,SW Hart & 149th,10437,E,FS,2,0,2,0,Fall2018
3428,NW Leahy & Alpenglow Way,10442,E,NS,0,0,0,0,Fall2018
5703,SW 170th & Division,10443,S,OP,4,3,7,0,Fall2018
6394,SW Dosch & Patton,10445,S,FS,0,0,0,0,Fall2018
4179,SE 82nd & Sunnybrook,10446,S,NS,6,9,15,3,Fall2018
3590,Oregon City Transit Center,10447,S,AT,70,73,143,47,Fall2018
672,8300 Block SW Apple Way,10448,E,AT,0,0,0,0,Fall2018
4266,SE Belmont & 51st,10449,W,FS,11,7,18,0,Fall2018
675,8400 Block NE 33rd Dr,10450,S,OP,6,0,6,0,Fall2018
676,8400 Block NE 33rd Dr,10452,N,AT,0,16,16,0,Fall2018
2974,NE Sandy & 154th,10453,W,FS,11,2,13,0,Fall2018
3085,NE Shaver & 141st,10454,E,NS,6,16,22,1,Fall2018
3211,NW 35th & Yeon,10455,N,NS,0,19,19,0,Fall2018
3367,NW Evergreen Pkwy & NE Venetian (NW 196th),10457,W,NS,9,4,13,1,Fall2018
3368,NW Evergreen Pkwy & NE Venetian (NW 196th),10458,E,NS,5,8,13,2,Fall2018
1721,N Williams & Emerson,10463,N,NS,3,39,42,5,Fall2018
7488,W Baseline & SW 185th,10464,E,NS,0,11,11,0,Fall2018
5854,SW 45th & Vermont,10466,S,FS,2,2,4,1,Fall2018
479,400 Block Beavercreek Rd,10469,E,AT,4,47,51,29,Fall2018
354,2600 Block N Marine,10477,E,AT,0,0,0,0,Fall2018
4067,SE 52nd & Woodstock,10481,S,NS,18,60,78,15,Fall2018
2408,NE Evergreen & Evergreen Middle School,10482,E,AT,1,1,2,0,Fall2018
5652,SE Woodstock & 51st,10484,E,FS,7,41,48,5,Fall2018
4894,SE International Way & Criterion Ct,10489,S,OP,2,3,5,21,Fall2018
4895,SE International Way & Criterion Ct,10490,N,NS,4,6,10,24,Fall2018
5872,SW 5th & Hall,10491,S,NS,597,255,852,66,Fall2018
2831,NE M L King & Morgan,10494,S,NS,24,11,35,2,Fall2018
5955,SW Allen & 107th,10499,W,NS,1,4,5,0,Fall2018
359,26300 Block SE Hwy 224,10500,E,OP,1,0,1,0,Fall2018
360,26300 Block SE Hwy 224,10501,W,AT,0,1,1,0,Fall2018
2187,NE 92nd & Hill,10505,N,FS,3,4,7,0,Fall2018
3594,Ostman & Willamette Falls,10523,S,NS,1,0,1,0,Fall2018
811,Blankenship & Debok,10548,W,NS,4,5,9,4,Fall2018
2985,NE Sandy & 185th Dr,10569,E,NS,9,18,27,1,Fall2018
2456,NE Fremont & 51st,10571,E,NS,2,1,3,0,Fall2018
3641,Parkrose/Sumner TC MAX Station,10572,N,AT,190,855,1045,0,Fall2018
3642,Parkrose/Sumner TC MAX Station,10573,S,AT,911,209,1120,0,Fall2018
850,Cascades MAX Station,10574,W,AT,55,519,574,0,Fall2018
851,Cascades MAX Station,10575,E,AT,518,78,596,0,Fall2018
1263,Mt Hood Ave MAX Station,10576,N,AT,61,324,385,0,Fall2018
1264,Mt Hood Ave MAX Station,10577,S,AT,311,75,386,0,Fall2018
5525,SE Sunnyside & 117th,10580,E,NS,2,13,15,6,Fall2018
6947,SW Park Pl & Wright,10589,E,NS,2,1,3,0,Fall2018
1677,N Vancouver Way & NE Walker St,10590,S,NS,27,6,33,16,Fall2018
1678,N Vancouver Way & NE Walker St,10591,N,FS,5,13,18,17,Fall2018
5526,SE Sunnyside & 117th,10592,W,NS,9,1,10,2,Fall2018
4816,SE Holgate & 85th,10593,W,NS,75,104,179,144,Fall2018
2451,NE Fremont & 45th,10594,W,FS,9,3,12,1,Fall2018
2452,NE Fremont & 45th,10596,E,OP,5,6,11,1,Fall2018
2467,NE Fremont & 68th,10597,E,FS,7,7,14,17,Fall2018
6599,SW Halsey & Edgefield Meadows,10598,E,NS,1,8,9,0,Fall2018
6838,SW Murray & Millikan Way,10599,N,NS,4,12,16,0,Fall2018
2781,NE Killingsworth & Cully ,10600,E,FS,155,76,231,14,Fall2018
2782,NE Killingsworth & Cully ,10601,W,NS,155,273,428,16,Fall2018
413,300 Block NE Division,10602,W,AT,33,4,37,3,Fall2018
1736,N Willis & Chautauqua,10611,W,NS,10,38,48,2,Fall2018
451,3515 SW US Veterans Rd,10612,W,OP,69,97,166,1,Fall2018
1371,N Fessenden & Tioga,10614,E,NS,17,5,22,3,Fall2018
6948,SW Park Way & 134th,10615,W,OP,0,0,0,0,Fall2018
6600,SW Halsey & Edgefield Meadows,10630,W,OP,7,0,7,0,Fall2018
6547,SW Hall & Avon,10631,S,NS,7,36,43,0,Fall2018
6227,SW Canyon & Camelot Ct,10632,W,FS,14,51,65,31,Fall2018
6228,SW Canyon & Canyon Crest,10633,W,OP,3,10,13,1,Fall2018
6229,SW Canyon & Canyon Crest,10634,E,NS,10,5,15,19,Fall2018
66,11600 Block SW Pacific Hwy,10639,W,AT,35,154,189,8,Fall2018
7285,SW Tualatin Valley Hwy & Hocken ,10641,W,FS,64,37,101,10,Fall2018
4987,SE Lake & Hwy 224,10644,W,FS,2,1,3,0,Fall2018
332,2300 Block SW 257th,10645,N,AT,1,2,3,0,Fall2018
5809,SW 257th & 24th,10646,S,FS,1,0,1,0,Fall2018
327,22000 Block SE Hwy 224,10647,W,OP,1,0,1,0,Fall2018
1384,N Fremont & Kerby,10649,E,FS,66,21,87,4,Fall2018
1385,N Fremont & Kerby,10650,W,NS,15,29,44,1,Fall2018
4988,SE Lake & Hwy 224,10653,E,NS,1,1,2,0,Fall2018
2729,NE Hood & 5th,10654,N,NS,0,3,3,1,Fall2018
2727,NE Hood & 2nd,10657,N,NS,0,13,13,5,Fall2018
3186,NW 21st & Savier,10694,N,FS,1,24,25,2,Fall2018
4867,SE Hwy 224 & Eilers Circle224 & Eilers Circle,10695,W,OP,0,0,0,0,Fall2018
4868,SE Hwy 224 & Eilers Circle224 & Eilers Circle,10696,E,FS,0,0,0,0,Fall2018
3644,Pier Park,10697,E,AT,156,155,311,101,Fall2018
37,10900 Block SW 121st,10698,S,OP,2,1,3,0,Fall2018
396,2900 Block NE 181st,10699,S,AT,17,7,24,2,Fall2018
3571,Oatfield & E Exeter,10700,N,OP,11,4,15,1,Fall2018
6640,SW Harbor & Harrison,10712,S,FS,34,3,37,2,Fall2018
6643,SW Harbor & River Pkwy,10713,N,FS,2,42,44,5,Fall2018
3339,NW Division & Norman,10714,W,NS,31,4,35,8,Fall2018
2941,NE Sandy & 102nd,10715,E,NS,23,12,35,6,Fall2018
2217,NE Airport Way & Win Sivers Drive,10716,E,NS,9,27,36,8,Fall2018
119,13100 Block NE Airport Way,10717,E,AT,3,10,13,0,Fall2018
2205,NE Airport Way & 148th,10718,E,FS,5,5,10,0,Fall2018
2207,NE Airport Way & 152nd Pl,10719,E,OP,4,2,6,0,Fall2018
198,16400 Block NE Airport Way,10720,E,AT,2,4,6,0,Fall2018
2216,NE Airport Way & Sandy Blvd,10721,S,NS,13,11,24,4,Fall2018
1942,NE 181st & Sandy,10723,N,NS,6,40,46,9,Fall2018
197,16300 Block NE Airport Way,10724,W,AT,2,3,5,0,Fall2018
179,15300 Block NE Airport Way,10725,W,AT,3,5,8,0,Fall2018
2206,NE Airport Way & 148th,10726,W,NS,7,9,16,1,Fall2018
2204,NE Airport Way & 138th,10727,W,NS,9,5,14,1,Fall2018
109,12900 Block NE Airport Way,10728,W,AT,7,5,12,1,Fall2018
2202,NE Airport Way & 122nd,10729,W,NS,13,12,25,6,Fall2018
2211,NE Airport Way & Glenn Widing,10730,W,FS,32,17,49,11,Fall2018
45,11000 Block NE Holman,10731,W,OP,11,4,15,2,Fall2018
1792,NE 105th & Simpson,10732,S,FS,1,6,7,0,Fall2018
1790,NE 105th & Marx,10733,S,NS,2,1,3,0,Fall2018
1788,NE 105th & Killingsworth,10734,S,FS,0,1,1,0,Fall2018
3101,NE Weidler & 103rd Pl,10746,W,FS,47,58,105,52,Fall2018
2619,NE Halsey & 102nd,10747,E,NS,129,84,213,85,Fall2018
6290,SW Cedar Hills & Celeste,10749,S,NS,13,2,15,0,Fall2018
3403,NW Graham/257th & North Frontage Rd,10758,N,NS,2,15,17,0,Fall2018
6291,SW Cedar Hills & Celeste,10761,N,FS,3,10,13,0,Fall2018
2943,NE Sandy & 105th,10779,E,NS,13,16,29,1,Fall2018
2944,NE Sandy & 107th,10780,E,NS,13,11,24,4,Fall2018
2946,NE Sandy & 109th,10781,E,NS,8,9,17,4,Fall2018
2948,NE Sandy & 112th,10782,E,NS,5,19,24,4,Fall2018
2950,NE Sandy & 115th,10783,E,NS,8,16,24,11,Fall2018
2952,NE Sandy & 118th,10784,E,FS,14,10,24,2,Fall2018
2954,NE Sandy & 125th Pl,10785,E,NS,18,13,31,1,Fall2018
2956,NE Sandy & 131st Pl,10786,E,NS,9,13,22,2,Fall2018
2958,NE Sandy & 133rd,10787,E,FS,7,17,24,16,Fall2018
2960,NE Sandy & 138th,10788,E,FS,28,55,83,13,Fall2018
164,14300 Block NE Sandy,10789,E,AT,3,2,5,0,Fall2018
2968,NE Sandy & 148th,10790,E,NS,14,21,35,1,Fall2018
7497,W Burnside & NW 10th,10791,W,FS,126,189,315,55,Fall2018
7515,W Burnside & SW 10th,10792,E,NS,242,103,345,57,Fall2018
3006,NE Sandy & 38th,10793,E,OP,11,59,70,18,Fall2018
3037,NE Sandy & 74th,10795,E,FS,11,36,47,3,Fall2018
640,7500 Block SW 45th,10801,S,AT,0,0,0,0,Fall2018
3527,NW Thurman & 24th,10808,E,NS,11,1,12,0,Fall2018
7499,W Burnside & NW 17th,10809,W,NS,15,54,69,10,Fall2018
2902,NE Prescott & 89th,10820,W,NS,5,2,7,2,Fall2018
3347,NW Eastman & Burnside,10821,N,FS,20,7,27,11,Fall2018
2969,NE Sandy & 148th,10822,W,NS,16,9,25,3,Fall2018
2961,NE Sandy & 138th,10823,W,NS,63,26,89,21,Fall2018
165,14300 Block NE Sandy,10824,W,OP,2,3,5,0,Fall2018
2959,NE Sandy & 133rd,10825,W,OP,7,4,11,0,Fall2018
2957,NE Sandy & 131st Pl,10826,W,FS,10,7,17,1,Fall2018
2955,NE Sandy & 125th Pl,10827,W,OP,11,13,24,1,Fall2018
2953,NE Sandy & 118th,10828,W,FS,8,9,17,2,Fall2018
2951,NE Sandy & 115th,10829,W,OP,12,6,18,9,Fall2018
2949,NE Sandy & 112th,10830,W,NS,16,9,25,7,Fall2018
2947,NE Sandy & 109th,10831,W,FS,6,10,16,2,Fall2018
2945,NE Sandy & 107th,10832,W,OP,10,12,22,3,Fall2018
3010,NE Sandy & 44th,10834,W,FS,49,46,95,33,Fall2018
4517,SE Eagle Creek Rd & Duus Rd,10835,S,OP,0,0,0,0,Fall2018
4518,SE Eagle Creek Rd & Duus Rd,10836,N,FS,1,1,2,0,Fall2018
1778,NE 102nd & Prescott,10838,S,NS,23,7,30,5,Fall2018
1782,NE 102nd & Shaver,10840,S,NS,2,1,3,1,Fall2018
1779,NE 102nd & Prescott,10842,N,NS,9,19,28,4,Fall2018
6025,SW Barbur & Spring Garden ,10844,W,OP,7,34,41,2,Fall2018
6013,SW Barbur & Huber ,10845,W,NS,28,46,74,4,Fall2018
2732,NE Jonesmore & 82nd,10846,W,NS,70,344,414,57,Fall2018
6004,SW Barbur & Bertha ,10848,E,NS,105,43,148,15,Fall2018
5994,SW Barbur & 26th Way,10849,E,AT,15,3,18,3,Fall2018
3637,Parkrose/ Sumner Transit Center,10850,W,AT,465,459,924,199,Fall2018
3638,Parkrose/ Sumner Transit Center,10853,E,AT,14,251,265,63,Fall2018
3639,Parkrose/ Sumner Transit Center,10854,E,AT,386,44,430,53,Fall2018
3640,Parkrose/ Sumner Transit Center,10855,E,AT,395,7,402,63,Fall2018
1073,Gresham Transit Center,10858,E,AT,442,408,850,72,Fall2018
1074,Gresham Transit Center,10859,W,AT,177,151,328,20,Fall2018
1047,Gateway Transit Center,10860,S,AT,184,17,201,66,Fall2018
1048,Gateway Transit Center,10861,S,AT,190,14,204,89,Fall2018
1049,Gateway Transit Center,10862,S,AT,209,36,245,38,Fall2018
1050,Gateway Transit Center,10863,S,AT,181,125,306,37,Fall2018
5844,SW 36th & Capitol Hwy,10865,S,NS,4,3,7,0,Fall2018
2198,NE 9th & Halsey,10866,N,NS,17,41,58,14,Fall2018
2200,NE 9th & Weidler,10867,S,NS,21,29,50,14,Fall2018
1095,Hollywood Transit Center,10868,E,AT,355,356,711,82,Fall2018
1096,Hollywood Transit Center,10869,E,AT,112,85,197,39,Fall2018
1097,Hollywood Transit Center,10870,E,AT,95,117,212,41,Fall2018
1098,Hollywood Transit Center,10871,E,AT,45,40,85,1,Fall2018
1099,Hollywood Transit Center,10872,N,AT,380,359,739,84,Fall2018
6917,SW Pacific Hwy & Main ,10873,E,FS,17,9,26,4,Fall2018
2986,NE Sandy & 185th Dr,10874,W,FS,11,16,27,0,Fall2018
2871,NE Multnomah & 9th ,10876,W,FS,79,45,124,19,Fall2018
922,E Burnside & NE 102nd,10877,W,FS,97,143,240,83,Fall2018
2739,NE Kane & 29th (MHCC),10878,S,FS,97,125,222,33,Fall2018
2740,"NE Kane & 29th, MHCC",10879,N,NS,147,100,247,36,Fall2018
3721,SE 103rd Dr & Stark,10910,N,FS,82,115,197,69,Fall2018
7399,SW Walnut & 121st,10913,E,FS,6,7,13,0,Fall2018
6245,SW Capitol & 40th ,10932,S,NS,0,1,1,0,Fall2018
6268,SW Capitol & Garden Home,10933,S,FS,12,25,37,0,Fall2018
6283,SW Capitol & Taylors Ferry,10935,N,FS,40,11,51,20,Fall2018
552,5600 Block SE International Way,10939,N,AT,4,5,9,0,Fall2018
2421,NE Evergreen Pkwy & Imbrie Dr,10940,N,NS,25,9,34,1,Fall2018
2422,NE Evergreen Pkwy & Imbrie Dr,10941,S,NS,6,37,43,1,Fall2018
6269,SW Capitol & Huber,10952,S,NS,32,55,87,5,Fall2018
2614,NE Grand & Wasco,10953,N,NS,155,42,197,42,Fall2018
2784,NE Killingsworth & Garfield ,10957,W,NS,139,99,238,47,Fall2018
1684,N Willamette & Burr,10975,S,OP,8,1,9,0,Fall2018
2208,NE Airport Way & 158th,10994,E,FS,4,10,14,0,Fall2018
2209,NE Airport Way & 158th,10995,W,NS,4,5,9,0,Fall2018
6641,SW Harbor & Montgomery,11001,S,OP,17,1,18,0,Fall2018
6642,SW Harbor & Montgomery,11002,N,NS,1,17,18,0,Fall2018
7265,SW Tualatin Valley Hwy & 153rd,11003,W,NS,3,3,6,0,Fall2018
3722,SE 103rd Dr & Washington,11005,N,NS,25,34,59,27,Fall2018
1567,N Marine & Portland Rd,11006,W,FS,0,1,1,0,Fall2018
1369,N Fessenden & Seneca,11007,E,FS,77,19,96,14,Fall2018
2314,NE Columbia Blvd & 52nd (NAYA),11009,W,OP,28,34,62,4,Fall2018
7223,SW Terwilliger & Campus ,11010,S,NS,3,190,193,5,Fall2018
6034,SW Barnes & 117th,11012,W,OP,1,7,8,0,Fall2018
2214,NE Airport Way & Riverside,11014,E,NS,12,15,27,0,Fall2018
2215,NE Airport Way & Riverside,11015,W,NS,4,18,22,1,Fall2018
3515,NW St Helens & Riverview Drive,11016,N,OP,0,0,0,0,Fall2018
3380,NW Glencoe & Cody Ct,11024,S,FS,2,1,3,0,Fall2018
25,10500 Block SE Cherry Blossom,11026,E,AT,9,16,25,10,Fall2018
3723,SE 106th & Cherry Blossom,11027,N,NS,37,38,75,35,Fall2018
4671,SE Harold & 133rd,11029,E,NS,0,4,4,0,Fall2018
6913,SW Pacific Hwy & Garrett ,11030,E,FS,24,7,31,3,Fall2018
5992,SW Barbur & 22nd,11031,E,FS,17,8,25,1,Fall2018
7498,W Burnside & NW 12th,11032,W,FS,106,145,251,121,Fall2018
5422,SE Stark & 155th Pl,11071,W,NS,28,6,34,20,Fall2018
2976,NE Sandy & 158th,11072,W,NS,46,32,78,4,Fall2018
3886,SE 181st Ave & 180th Ave,11073,S,FS,19,20,39,7,Fall2018
7565,Washington & 14th,11111,S,NS,1,1,2,1,Fall2018
7002,SW Rose Garden Way & Sherwood,11151,S,NS,6,6,12,0,Fall2018
3093,NE Sunderland & 33rd Dr,11171,S,FS,2,4,6,0,Fall2018
6125,SW Bertha & Barbur ,11211,E,NS,11,8,19,1,Fall2018
1946,NE 181st & Wilkes,11231,S,OP,9,3,12,1,Fall2018
4180,SE 82nd & Sunnybrook,11251,N,FS,7,14,21,6,Fall2018
5990,SW Barbur & 13th,11271,N,OP,31,27,58,2,Fall2018
6931,SW Palatine Hill & Lewis & Clark Gate 3,11311,N,FS,18,0,18,2,Fall2018
6932,SW Palatine Hill & Lewis & Clark Gate 6,11312,W,NS,0,8,8,0,Fall2018
3052,NE Sandy & Cesar Chavez Blvd,11313,W,NS,99,37,136,28,Fall2018
408,2nd & Tumwater,11331,E,NS,3,6,9,0,Fall2018
3724,SE 106th & Cherry Blossom,11411,S,FS,43,28,71,39,Fall2018
9,10000 Block SE Stevens Rd,11453,S,OP,3,15,18,2,Fall2018
11,10100 Block SE Stevens Rd,11454,N,AT,12,4,16,3,Fall2018
2232,NE Alberta & 21st,11471,E,NS,43,42,85,5,Fall2018
2233,NE Alberta & 21st,11472,W,NS,41,48,89,7,Fall2018
143,1400 Block Molalla,11473,N,OP,11,2,13,3,Fall2018
780,Beavercreek & Fir St,11475,E,FS,1,5,6,0,Fall2018
2240,NE Alberta & 7th,11478,E,NS,19,14,33,3,Fall2018
3510,NW St Helens & Marina Way,11479,S,OP,0,0,0,0,Fall2018
1732,N Williams & NE Weidler,11480,N,NS,34,51,85,32,Fall2018
534,500 Block Molalla,11481,S,AT,3,6,9,0,Fall2018
535,500 Block Molalla,11482,N,OP,4,2,6,0,Fall2018
4638,SE Grand & Taylor,11483,N,NS,60,22,82,12,Fall2018
4633,SE Grand & Belmont,11484,N,FS,88,34,122,19,Fall2018
5903,SW 6th & Columbia,11486,N,NS,107,268,375,35,Fall2018
2297,NE Cesar Chavez Blvd & Halsey,11487,N,NS,1,23,24,5,Fall2018
3488,NW St Helens & 112th,11490,S,FS,2,0,2,0,Fall2018
2869,NE Multnomah & 3rd ,11492,W,FS,73,24,97,23,Fall2018
1039,Expo Center MAX Station,11498,S,AT,603,615,1218,0,Fall2018
883,Delta Park/Vanport MAX Station,11499,S,AT,1009,56,1065,0,Fall2018
1135,Kenton/N Denver Ave MAX Station,11500,S,AT,493,85,578,0,Fall2018
1547,N Lombard TC MAX Station,11501,S,AT,1177,235,1412,0,Fall2018
3673,Rosa Parks MAX Station,11502,S,AT,559,160,719,0,Fall2018
1458,N Killingsworth St MAX Station,11503,S,AT,685,303,988,0,Fall2018
1601,N Prescott St MAX Station,11504,S,AT,405,171,576,0,Fall2018
3595,Overlook Park MAX Station,11505,S,AT,436,130,566,0,Fall2018
759,Albina/Mississippi MAX Station,11506,S,AT,223,80,303,0,Fall2018
1114,Interstate/Rose Quarter MAX Station,11507,S,AT,248,1308,1556,0,Fall2018
1115,Interstate/Rose Quarter MAX Station,11508,N,AT,1248,490,1738,0,Fall2018
760,Albina/Mississippi MAX Station,11509,N,AT,107,218,325,0,Fall2018
3596,Overlook Park MAX Station,11510,N,AT,121,435,556,0,Fall2018
1602,N Prescott St MAX Station,11511,N,AT,164,454,618,0,Fall2018
1459,N Killingsworth St MAX Station,11512,N,AT,266,755,1021,0,Fall2018
3674,Rosa Parks MAX Station,11513,N,AT,143,592,735,0,Fall2018
1548,N Lombard TC MAX Station,11514,N,AT,212,1147,1359,0,Fall2018
1136,Kenton/N Denver Ave MAX Station,11515,N,AT,84,440,524,0,Fall2018
884,Delta Park/Vanport MAX Station,11516,N,AT,67,1040,1107,0,Fall2018
5548,SE Sunnyside & Stevens ,11520,E,FS,12,34,46,16,Fall2018
7071,SW Scholls Ferry & Murray,11521,W,NS,69,52,121,4,Fall2018
2238,NE Alberta & 30th,11722,E,NS,24,30,54,15,Fall2018
5205,SE Powell & 125th Pl,11742,E,FS,11,42,53,3,Fall2018
7637,Willamette Falls Dr & West A,11762,N,NS,0,2,2,0,Fall2018
7638,Willamette Falls Dr & West A,11763,S,FS,1,1,2,0,Fall2018
7635,Willamette Falls Dr & 6th St,11764,W,OP,0,0,0,0,Fall2018
7636,Willamette Falls Dr & 6th St,11765,E,FS,1,0,1,0,Fall2018
7624,Willamette Falls Dr & 11th St,11766,E,NS,1,0,1,1,Fall2018
1019,E Main (W Baseline) & NE 63rd,11770,E,OP,4,3,7,1,Fall2018
1020,E Main (W Baseline) & NE 63rd,11771,W,NS,2,3,5,1,Fall2018
3050,NE Sandy & Arborcrest Dr,11772,W,FS,3,6,9,1,Fall2018
3051,NE Sandy & Blossom Hill,11773,E,FS,5,2,7,0,Fall2018
820,Boones Ferry Rd & Mercantile Dr,11775,S,NS,1,2,3,0,Fall2018
822,Boones Ferry Rd & Oakridge,11776,S,NS,2,3,5,5,Fall2018
833,Boones Ferry Rd & Washington Ct,11777,S,NS,2,0,2,0,Fall2018
823,Boones Ferry Rd & Pilkington,11778,S,OP,1,1,2,0,Fall2018
817,Boones Ferry Rd & Jean,11779,S,NS,0,1,1,0,Fall2018
818,Boones Ferry Rd & Jean,11780,N,NS,1,1,2,1,Fall2018
824,Boones Ferry Rd & Pilkington,11781,N,NS,2,1,3,0,Fall2018
834,Boones Ferry Rd & Washington Ct,11782,N,OP,1,1,2,0,Fall2018
827,Boones Ferry Rd & Reese Rd,11783,N,FS,5,1,6,0,Fall2018
821,Boones Ferry Rd & Mercantile Dr,11784,N,OP,2,2,4,0,Fall2018
5228,SE Powell & 156th,11786,W,FS,15,7,22,27,Fall2018
7352,SW Vermont & Idaho Dr ,11789,E,FS,7,4,11,1,Fall2018
442,3400 Block McNary,11804,W,AT,0,2,2,0,Fall2018
7442,South Shore & Patton,11805,E,OP,0,1,1,0,Fall2018
6452,SW Farmington & Hall ,11810,E,FS,3,23,26,7,Fall2018
1422,N Interstate & Multnomah (Rose Quarter),11813,S,NS,24,113,137,6,Fall2018
1423,N Interstate & Rose Quarter TC,11814,N,AT,103,36,139,12,Fall2018
2982,NE Sandy & 172nd Pl,11815,W,FS,9,6,15,0,Fall2018
2983,NE Sandy & 172nd Pl,11816,E,NS,7,10,17,0,Fall2018
3679,Rose Quarter Transit Center,11817,E,NS,203,286,489,106,Fall2018
1551,N Macrum & Powers,11824,N,OP,2,0,2,0,Fall2018
1340,N Columbia Blvd & Oregonian,11825,W,NS,0,0,0,0,Fall2018
1336,N Columbia Blvd & Bank,11826,W,NS,0,0,0,0,Fall2018
1343,N Columbia Blvd & Upland Dr,11827,W,FS,0,0,0,0,Fall2018
1342,N Columbia Blvd & Swift,11828,W,FS,1,3,4,1,Fall2018
1565,N Marine & Pier 99 St,11829,S,OP,4,35,39,2,Fall2018
3099,NE Walker & N Vancouver Way,11830,W,NS,0,4,4,0,Fall2018
2586,NE Glisan & 74th,11831,W,NS,30,8,38,2,Fall2018
1566,N Marine & Pier 99 St,11832,N,NS,44,1,45,0,Fall2018
1344,N Columbia Blvd & Upland Dr,11833,E,NS,0,0,0,0,Fall2018
1337,N Columbia Blvd & Bank,11834,E,OP,0,0,0,0,Fall2018
1341,N Columbia Blvd & Oregonian,11835,E,FS,0,0,0,0,Fall2018
1552,N Macrum & Powers,11836,S,NS,0,1,1,0,Fall2018
1433,N Ivanhoe & Baltimore,11837,S,FS,3,12,15,3,Fall2018
1339,N Columbia Blvd & Hendricks,11838,E,NS,5,1,6,0,Fall2018
1417,N Interstate & Albina,11839,N,FS,15,6,21,2,Fall2018
1424,N Interstate & Tillamook,11840,N,FS,1,8,9,3,Fall2018
1431,N Interstate & Tillamook,11844,S,NS,5,1,6,0,Fall2018
1421,N Interstate & Larrabee,11845,S,NS,1,3,4,0,Fall2018
1240,Molalla & Garden Meadow,11846,S,FS,3,10,13,6,Fall2018
715,9500 Block N Columbia Blvd,11849,S,OP,1,0,1,0,Fall2018
716,9500 Block N Columbia Blvd,11850,N,AT,0,0,0,0,Fall2018
6668,SW Hocken & Cedar Hills Xing Entrance,11851,N,AT,25,41,66,32,Fall2018
6669,SW Hocken & Cedar Hills Xing Entrance,11852,S,OP,36,23,59,20,Fall2018
5270,SE Powell & 57th,11920,E,NS,27,30,57,2,Fall2018
5274,SE Powell & 62nd,11921,E,FS,11,29,40,3,Fall2018
5283,SE Powell & 75th,11922,E,OP,10,40,50,10,Fall2018
5284,SE Powell & 75th,11923,W,FS,42,10,52,29,Fall2018
5276,SE Powell & 65th,11924,W,FS,44,10,54,13,Fall2018
5269,SE Powell & 55th,11925,W,FS,36,55,91,5,Fall2018
4284,SE Bob Schumacher & Monterey,11926,S,FS,1,5,6,0,Fall2018
4285,SE Bob Schumacher & Monterey,11927,N,NS,2,1,3,0,Fall2018
5549,SE Sunnyside & Sunnybrook,11928,W,OP,0,0,0,0,Fall2018
5524,SE Sunnyside & 105th,11929,W,NS,8,4,12,2,Fall2018
106,12700 Block SE Hwy 212,11930,E,AT,0,1,1,0,Fall2018
107,12700 Block SE Hwy 212,11931,W,OP,1,0,1,0,Fall2018
1246,Molalla & Mountain View,11932,N,OP,9,4,13,1,Fall2018
1247,Molalla & Mountain View,11933,S,NS,5,9,14,2,Fall2018
1437,N Ivanhoe & New York,11934,N,FS,1,0,1,0,Fall2018
1435,N Ivanhoe & Chicago,11935,S,NS,0,1,1,0,Fall2018
1628,N St Louis & Central,11936,E,NS,10,1,11,14,Fall2018
7457,Sunset Transit Center,11939,W,AT,430,409,839,123,Fall2018
217,16800 Block SW 72nd,11944,N,AT,162,11,173,8,Fall2018
228,17000 Block SW 72nd,11945,S,AT,6,57,63,2,Fall2018
1345,N Cutter Circle & Leverman,11947,E,FS,6,29,35,0,Fall2018
585,6000 Block N Cutter Circle,11948,N,AT,13,14,27,0,Fall2018
595,6300 Block N Cutter Circle,11949,N,AT,3,2,5,0,Fall2018
1468,N Leverman & Cutter Circle,11950,S,NS,12,5,17,0,Fall2018
3784,SE 122nd & Summers Lane,11952,N,NS,19,2,21,0,Fall2018
3785,SE 122nd & Summers Lane,11953,S,FS,2,8,10,0,Fall2018
6774,SW Main & 2nd,11956,W,NS,90,1063,1153,41,Fall2018
4358,SE Clackamas Rd & Johnson,11958,W,NS,3,1,4,0,Fall2018
4901,SE Johnson & Cypress,11959,N,OP,1,2,3,0,Fall2018
4905,SE Johnson & Thiessen,11960,N,OP,3,0,3,0,Fall2018
166,14400 Block SE Johnson,11961,N,AT,7,1,8,0,Fall2018
4903,SE Johnson & Lake,11962,N,FS,21,5,26,1,Fall2018
4904,SE Johnson & Lake,11963,S,OP,7,22,29,2,Fall2018
167,14400 Block SE Johnson,11964,S,AT,2,1,3,0,Fall2018
4906,SE Johnson & Thiessen,11965,S,NS,1,1,2,0,Fall2018
4902,SE Johnson & Cypress,11966,S,NS,0,1,1,0,Fall2018
4359,SE Clackamas Rd & Johnson,11967,E,FS,1,2,3,0,Fall2018
5047,SE McKinley & Hood,11968,S,FS,2,2,4,0,Fall2018
5550,SE Sunnyside & Sunnybrook,11970,E,NS,0,2,2,0,Fall2018
7396,SW Walnut & 114th,11973,W,FS,2,1,3,0,Fall2018
1326,N Broadway & Benton,12374,W,NS,13,9,22,3,Fall2018
1467,N Leverman & Basin,12383,E,FS,2,6,8,1,Fall2018
7195,SW Taylors Ferry & Picasso Pl ,12387,W,FS,1,2,3,0,Fall2018
5442,SE Stark & 187th,12397,W,NS,59,136,195,50,Fall2018
5443,SE Stark & 187th,12398,E,FS,103,56,159,33,Fall2018
6563,SW Hall & Greenburg,12402,W,NS,2,4,6,1,Fall2018
6529,SW Greenburg & Washington Square Rd,12403,N,FS,53,33,86,4,Fall2018
6530,SW Greenburg & Washington Square Rd,12404,S,NS,28,54,82,3,Fall2018
6207,SW Canyon & 103rd,12405,E,NS,17,17,34,5,Fall2018
6219,SW Canyon & 91st,12406,W,OP,4,6,10,0,Fall2018
6450,SW Farmington & Erickson ,12451,W,NS,27,14,41,4,Fall2018
16,10200 Block SE Main,12462,N,AT,0,1,1,0,Fall2018
17,10200 Block SE Main,12463,S,OP,1,0,1,0,Fall2018
1568,N Marine & Portland Rd,12465,E,FS,0,0,0,0,Fall2018
557,5700 Block SW Hamilton,12466,W,AT,0,0,0,0,Fall2018
6316,SW Chestnut & 12th Dr,12467,N,NS,6,2,8,0,Fall2018
6596,SW Hall & Wall,12468,S,NS,4,18,22,7,Fall2018
2398,NE Division & Kelly,12707,E,FS,18,2,20,1,Fall2018
1360,N Fessenden & Haven,12725,W,NS,74,113,187,31,Fall2018
1361,N Fessenden & Haven,12726,E,NS,127,81,208,16,Fall2018
1651,N Trenton & Newman,12727,W,NS,94,165,259,76,Fall2018
10,10000 Block SW Terwilliger,12729,E,OP,0,10,10,0,Fall2018
6127,SW Bertha & Vermont ,12730,N,NS,5,4,9,1,Fall2018
6680,SW Huddleson & Palatine Hill,12731,E,FS,12,10,22,0,Fall2018
1159,L & C Campus & Templeton Student Center,12732,N,AT,12,2,14,0,Fall2018
3635,Pacific Hwy & Tualatin Rvr Refuge,12743,W,AT,0,0,0,0,Fall2018
6817,SW Murray & Brockman,12746,N,NS,10,0,10,1,Fall2018
1650,N Trenton & Dwight,12750,E,NS,175,109,284,74,Fall2018
495,4200 Block NW Yeon,12754,E,OP,1,0,1,0,Fall2018
4142,SE 82nd & Harrison,12755,N,NS,45,26,71,10,Fall2018
6798,SW Moody & Gibbs,12760,S,NS,104,94,198,13,Fall2018
968,E Burnside & SE 69th,12761,E,FS,5,11,16,1,Fall2018
5859,SW 4th & Caruthers,12762,N,NS,23,51,74,7,Fall2018
5860,SW 4th & Hall,12763,N,NS,109,357,466,21,Fall2018
5845,SW 3rd & Madison,12787,S,NS,14,130,144,14,Fall2018
6690,SW Jefferson & 1st,12789,W,FS,7,416,423,8,Fall2018
6696,SW Jefferson between 4th & 5th,12790,W,FS,181,166,347,55,Fall2018
6692,SW Jefferson & 5th,12791,W,NS,137,156,293,27,Fall2018
6321,SW Columbia & 16th,12792,E,OP,113,41,154,7,Fall2018
6326,SW Columbia between 6th & 5th,12793,E,FS,170,261,431,48,Fall2018
6325,SW Columbia between 5th & 4th,12794,E,FS,431,13,444,42,Fall2018
6323,SW Columbia & 1st,12795,E,NS,234,7,241,8,Fall2018
6863,SW Oak & 1st,12798,W,NS,26,72,98,10,Fall2018
3253,NW Broadway & Hoyt,12805,S,NS,39,88,127,65,Fall2018
981,E Columbia River Hwy & SE Harlow,12838,E,NS,0,0,0,0,Fall2018
5023,SE Main & Beta,12842,W,OP,0,3,3,0,Fall2018
196,16200 Block SW Langer,12849,E,AT,22,6,28,7,Fall2018
5582,SE Tualatin Valley Hwy & Brookwood,12851,W,FS,48,63,111,14,Fall2018
6750,SW Lower Boones Ferry & 65th,12852,W,NS,0,3,3,0,Fall2018
7538,W Powell & N Main,12862,W,FS,24,3,27,7,Fall2018
7546,W Powell & NW Wilson,12863,W,FS,11,7,18,5,Fall2018
7545,W Powell & NW Willowbrook,12864,W,NS,1,1,2,0,Fall2018
7547,W Powell & NW Wilson,12866,E,OP,7,5,12,3,Fall2018
7554,W Powell & SW Eastman Parkway,12867,E,FS,13,34,47,23,Fall2018
7541,W Powell & NW Eastman Parkway,12868,W,FS,34,10,44,21,Fall2018
376,"2800 Blk NE Brookwood Pkwy, Library",12875,N,AT,3,11,14,5,Fall2018
6797,SW Moody & Gaines,12880,S,FS,12,37,49,3,Fall2018
2266,NE Brookwood & Airport Rd,12884,N,FS,1,3,4,0,Fall2018
6423,SW Fairview & Kingston ,12886,W,FS,2,0,2,0,Fall2018
4734,SE Hawthorne & 34th,12892,W,NS,106,44,150,8,Fall2018
1226,Merlo Rd/SW 158th MAX Stn Turnaround,12899,E,AT,234,236,470,18,Fall2018
4825,SE Holgate & 97th ,12900,E,FS,2,21,23,2,Fall2018
5540,SE Sunnyside & 152nd,12901,E,FS,2,10,12,2,Fall2018
5542,SE Sunnyside & 157th,12902,W,NS,23,1,24,0,Fall2018
5541,SE Sunnyside & 152nd,12903,W,FS,7,2,9,0,Fall2018
4621,SE Foster & Cora,12904,W,NS,30,7,37,8,Fall2018
4223,SE 97th & Park Mountain Lane,12912,S,OP,1,5,6,0,Fall2018
4826,SE Holgate & 97th ,12914,W,OP,17,2,19,0,Fall2018
882,Delta Park/Vanport,12918,S,AT,87,95,182,49,Fall2018
857,Clackamas Town Center Mall,12921,E,AT,100,1259,1359,294,Fall2018
858,Clackamas Town Center Mall,12922,W,AT,1276,68,1344,277,Fall2018
5547,SE Sunnyside & Misty Dr,12923,W,FS,27,2,29,0,Fall2018
5539,SE Sunnyside & 147th,12924,E,NS,7,39,46,9,Fall2018
3819,SE 152nd & Oregon Trail,12925,N,NS,0,1,1,0,Fall2018
6314,SW Center & Lombard,12932,E,NS,2,11,13,5,Fall2018
6748,SW Lombard & Center,12933,N,NS,10,2,12,3,Fall2018
976,E Burnside & SE 99th,12934,E,NS,17,18,35,3,Fall2018
270,19000 Block SE Hwy 224,12936,N,AT,0,0,0,0,Fall2018
274,19300 Block SE Hwy 224,12937,S,AT,0,0,0,0,Fall2018
721,9600 N Ramsey Blvd,12942,W,AT,1,1,2,0,Fall2018
5409,SE Stark & 130th,12943,W,OP,66,25,91,11,Fall2018
6743,SW Lombard & Broadway,12944,N,NS,8,156,164,26,Fall2018
6744,SW Lombard & Broadway,12945,S,NS,140,11,151,17,Fall2018
4587,SE Foster & 56th,12946,E,FS,10,28,38,4,Fall2018
4589,SE Foster & 61st,12947,E,FS,8,39,47,4,Fall2018
4599,SE Foster & 74th,12948,W,NS,25,9,34,20,Fall2018
5414,SE Stark & 142nd,12949,W,OP,44,16,60,1,Fall2018
98,12600 Block SE Stark,12950,E,AT,18,53,71,8,Fall2018
5253,SE Powell & 28th Pl,12951,E,FS,109,119,228,15,Fall2018
2734,NE Kane & 15th,12952,S,OP,17,21,38,9,Fall2018
5460,SE Stark & 214th,12953,E,OP,11,21,32,7,Fall2018
5430,SE Stark & 169th,12954,E,FS,14,31,45,14,Fall2018
965,E Burnside & SE 57th,12955,E,FS,3,16,19,2,Fall2018
4943,SE King & Cook Ct,12956,W,FS,29,25,54,3,Fall2018
5474,SE Stark & Cherry Park ,12957,W,NS,71,37,108,46,Fall2018
643,7500 Block SW Hunziker,12958,E,AT,4,4,8,0,Fall2018
3605,PCC Lower Drive (G St) & H St,12959,W,OP,5,1,6,0,Fall2018
6044,SW Barnes & 84th,12960,E,NS,9,3,12,0,Fall2018
5468,SE Stark & 238th,12961,E,FS,11,35,46,30,Fall2018
627,7200 Block SW Durham,12962,N,OP,14,2,16,0,Fall2018
6881,SW Oleson & Skyhar Dr,12963,N,OP,6,1,7,0,Fall2018
6877,SW Oleson & Obrien,12964,N,OP,1,1,2,0,Fall2018
397,2900 Block NW Front,12965,S,AT,10,1,11,0,Fall2018
2900,NE Prescott & 87th,12992,W,NS,9,4,13,9,Fall2018
6294,SW Cedar Hills & Foothill Dr,12993,S,NS,1,6,7,0,Fall2018
6295,SW Cedar Hills & Foothill Dr,13018,N,NS,3,1,4,0,Fall2018
6930,SW Palater & Palatine Hill ,13022,E,OP,0,2,2,0,Fall2018
4549,SE Flavel & 69th,13024,W,NS,21,4,25,1,Fall2018
377,"2800 Blk NE Brookwood Pkwy, Library",13025,S,OP,5,0,5,3,Fall2018
2654,NE Halsey & 159th Ct,13026,W,NS,11,2,13,0,Fall2018
2748,NE Kane & SE Stark,13031,S,FS,58,121,179,83,Fall2018
4577,SE Foster & 120th,13032,W,NS,7,12,19,5,Fall2018
2728,NE Hood & 2nd,13033,S,FS,39,6,45,23,Fall2018
7402,SW Walnut & Grant,13034,N,NS,4,3,7,0,Fall2018
5754,SW 197th & Brookfield,13035,S,NS,4,4,8,0,Fall2018
5753,SW 197th & Alderwood Ct,13036,N,NS,2,2,4,0,Fall2018
4214,SE 90th & Causey,13037,S,FS,6,19,25,8,Fall2018
712,9400 Block NE Sunderland,13040,S,AT,2,14,16,34,Fall2018
6214,SW Canyon & 115th Ave,13042,E,FS,28,11,39,20,Fall2018
4252,SE Belmont & 26th Ave,13043,E,NS,66,130,196,35,Fall2018
840,Bryant & Lamont Way,13044,S,NS,1,1,2,0,Fall2018
7458,Tigard TC WES Station,13068,S,AT,85,176,261,0,Fall2018
2514,NE Glisan & 120th,13071,W,NS,3,1,4,0,Fall2018
7459,Tigard TC WES Station,13073,N,AT,196,72,268,0,Fall2018
2533,NE Glisan & 152nd,13075,E,OP,0,2,2,0,Fall2018
3889,SE 182nd & Bush Terrace,13076,S,FS,0,1,1,1,Fall2018
1134,Kaiser Sunnyside Medical Center,13077,W,AT,21,10,31,23,Fall2018
6169,SW Boones Ferry Rd & Martinazzi ,13078,W,FS,9,53,62,7,Fall2018
6173,SW Boones Ferry Rd & Nyberg ,13079,S,NS,48,53,101,5,Fall2018
7405,SW Warm Springs & Boones Ferry,13080,E,FS,6,28,34,2,Fall2018
7407,SW Warm Springs & Martinazzi,13081,E,NS,12,26,38,7,Fall2018
7408,SW Warm Springs & Martinazzi,13082,W,FS,18,10,28,1,Fall2018
7406,SW Warm Springs & Boones Ferry,13083,W,NS,26,6,32,0,Fall2018
6175,SW Boones Ferry Rd & Seneca ,13084,N,NS,53,14,67,2,Fall2018
6170,SW Boones Ferry Rd & Martinazzi ,13085,E,NS,41,8,49,2,Fall2018
330,22800 Block NE Sandy,13086,E,AT,5,1,6,0,Fall2018
335,23500 Block NE Sandy,13088,E,AT,95,68,163,49,Fall2018
1961,NE 223rd & Arata,13089,S,OP,30,10,40,8,Fall2018
336,23500 Block NE Sandy,13090,W,AT,58,92,150,43,Fall2018
331,22800 Block NE Sandy,13092,W,AT,1,7,8,0,Fall2018
225,1700 Block NW Naito Parkway,13098,N,AT,0,1,1,0,Fall2018
449,3500 Block Willamette Falls Dr,13108,E,AT,0,0,0,0,Fall2018
236,17500 Block SE Hwy 224,13113,W,AT,0,0,0,0,Fall2018
2267,NE Brookwood Pkwy & 49th Pl,13115,W,NS,2,0,2,0,Fall2018
3078,NE Shaver & 115th,13116,W,NS,9,1,10,0,Fall2018
1828,NE 125th Pl & Shaver,13117,S,NS,5,0,5,0,Fall2018
491,4200 Block NE 125th Pl,13118,W,NS,8,0,8,0,Fall2018
4647,SE Harold & 104th,13122,W,NS,15,1,16,0,Fall2018
5906,SW 6th & Madison MAX Station,13123,N,NS,1111,764,1875,0,Fall2018
5036,SE Main St MAX Station,13124,S,NS,333,494,827,0,Fall2018
4491,SE Division St MAX Station,13125,S,FS,235,457,692,0,Fall2018
5315,SE Powell Blvd MAX Station,13126,S,FS,161,819,980,0,Fall2018
4831, SE Holgate Blvd MAX Station,13127,S,NS,131,471,602,0,Fall2018
1171,Lents/SE Foster Rd MAX Station,13128,S,NS,158,548,706,0,Fall2018
4566,SE Flavel St MAX Station,13129,S,FS,103,385,488,0,Fall2018
4629,SE Fuller Rd MAX Station,13130,S,AT,51,403,454,0,Fall2018
860,Clackamas Town Center TC MAX Station,13132,N,AT,2171,2416,4587,0,Fall2018
4630,SE Fuller Rd MAX Station,13133,N,AT,365,43,408,0,Fall2018
4567,SE Flavel St MAX Station,13134,N,NS,407,93,500,0,Fall2018
1172,Lents/SE Foster Rd MAX Station,13135,N,FS,538,168,706,0,Fall2018
4832, SE Holgate Blvd MAX Station,13136,N,FS,491,120,611,0,Fall2018
5316,SE Powell Blvd MAX Station,13137,N,NS,719,187,906,0,Fall2018
4492,SE Division St MAX Station,13138,N,NS,443,223,666,0,Fall2018
5037,SE Main St MAX Station,13139,N,FS,500,320,820,0,Fall2018
1857,NE 148th & Rose Parkway,13141,S,NS,4,2,6,3,Fall2018
1858,NE 148th & Rose Parkway,13142,N,NS,2,3,5,0,Fall2018
99,12700 Block NE San Rafael,13143,W,AT,0,0,0,0,Fall2018
1043,Flavel & I-205 Overpass,13145,E,FS,107,106,213,29,Fall2018
183,15700 Block SE McKinley,13146,N,AT,0,1,1,0,Fall2018
4974,SE Lake & 41st Ct,13147,E,OP,0,1,1,0,Fall2018
4995,SE Lake & Vernie/41st Ct,13148,W,OP,0,1,1,0,Fall2018
231,17100 Block SE Webster,13149,S,AT,4,2,6,1,Fall2018
2800,NE M L King & Columbia Blvd,13150,N,NS,10,50,60,7,Fall2018
7584,Webster & Cason,13153,S,NS,2,7,9,11,Fall2018
920,E Burnside & 63rd,13155,E,FS,5,14,19,0,Fall2018
4876,SE Hwy 224 & Goosehollow,13156,S,NS,0,6,6,0,Fall2018
288,200 Block NE Gertz Rd,13161,E,AT,5,21,26,0,Fall2018
2502,NE Gertz Rd & Vancouver Way,13162,E,NS,5,21,26,3,Fall2018
2280,NE Century (NW 229th) & Intel South Drwy,13163,N,OP,5,11,16,0,Fall2018
2281,NE Century (NW 229th) & Intel South Drwy,13164,S,NS,6,4,10,0,Fall2018
5870,SW 5th & Clay,13167,S,NS,260,133,393,40,Fall2018
6864,SW Oak & 6th,13168,W,NS,157,162,319,37,Fall2018
6775,SW Main & 6th,13169,W,NS,509,1103,1612,162,Fall2018
6186,SW Broadway & W Burnside ,13170,N,NS,57,122,179,36,Fall2018
7529,W Burnside & SW 5th,13171,E,NS,175,112,287,91,Fall2018
3453,NW Naito Parkway & Couch,13176,S,FS,3,49,52,6,Fall2018
3252,NW Broadway & Everett,13178,S,NS,43,100,143,37,Fall2018
6801,SW Moody & Thomas,13183,S,NS,14,40,54,3,Fall2018
6762,SW Macadam & Lowell,13184,N,NS,21,12,33,1,Fall2018
6771,SW Macadam & Tram Tower,13185,N,AT,30,187,217,5,Fall2018
137,13800 Block SE Oatfield,13186,N,AT,0,1,1,0,Fall2018
1241,Molalla & Harris,13187,N,FS,5,1,6,1,Fall2018
2557,NE Glisan & 24th,13193,E,FS,26,61,87,4,Fall2018
2558,NE Glisan & 24th,13194,W,NS,57,21,78,3,Fall2018
6754,SW Lower Boones Ferry & McEwan Rd,13195,E,FS,3,1,4,0,Fall2018
6551,SW Hall & Burnham,13196,N,NS,0,1,1,0,Fall2018
7420,SW Watson & 5th,13197,S,NS,35,32,67,39,Fall2018
6665,SW Highland & 14th Dr,13198,W,FS,1,0,1,0,Fall2018
447,3500 Block SE 182nd,13199,S,AT,1,17,18,1,Fall2018
2212,NE Airport Way & Mason Ct,13200,W,NS,2,3,5,0,Fall2018
2213,NE Airport Way & Mason Ct,13201,E,NS,2,5,7,1,Fall2018
5694,SW 158th & Greystone Ct,13202,N,NS,1,2,3,0,Fall2018
3271,NW Cornell & 158th,13205,E,NS,4,3,7,4,Fall2018
5894,SW 68th & Atlanta,13210,S,FS,6,1,7,0,Fall2018
2730,NE Hood & 5th,13211,S,NS,2,0,2,0,Fall2018
1605,N Richmond & Syracuse,13212,S,FS,28,5,33,6,Fall2018
3508,NW St Helens & Larson,13214,N,FS,0,2,2,0,Fall2018
250,18100 Block SE River Rd,13215,S,AT,0,0,0,0,Fall2018
4829, SE Holgate & SE Holgate Blvd MAX Stn,13218,E,OP,74,77,151,68,Fall2018
4830, SE Holgate & SE Holgate Blvd MAX Stn,13219,W,AT,84,118,202,74,Fall2018
4618,SE Foster & 94th,13236,W,FS,271,16,287,40,Fall2018
3212,NW 35th & Yeon,13237,S,OP,7,1,8,0,Fall2018
435,3300 Block NW 35th,13238,S,OP,6,0,6,0,Fall2018
3210,NW 35th & Guam,13239,S,NS,14,1,15,0,Fall2018
437,3300 Block NW Guam,13240,E,OP,5,3,8,2,Fall2018
3406,NW Guam & 31st,13241,E,NS,22,0,22,3,Fall2018
427,3100 Block NW 31st,13242,E,AT,17,3,20,1,Fall2018
3465,NW Saltzman & Thompson,13243,N,NS,4,5,9,0,Fall2018
4669,SE Harold & 130th,13244,E,NS,0,6,6,0,Fall2018
3795,SE 136th & Foster,13245,S,NS,6,11,17,0,Fall2018
859,Clackamas Town Center TC,13247,E,FS,15,771,786,137,Fall2018
861,Clackamas Town Center Transit Center,13248,S,AT,1178,343,1521,148,Fall2018
4073,SE 60th & Harrison,13249,N,NS,22,4,26,3,Fall2018
3573,Oatfield & E Hereford,13252,N,OP,7,1,8,0,Fall2018
3731,SE 10th & Washington,13255,S,NS,0,23,23,2,Fall2018
710,9300 Block SW Taylor,13256,W,OP,1,0,1,0,Fall2018
7131,SW Taylor & Morrison,13257,W,NS,4,0,4,0,Fall2018
7135,SW Taylor & Valeria View,13258,W,NS,17,0,17,0,Fall2018
6057,SW Barnes & Valeria View,13259,S,FS,0,0,0,0,Fall2018
7324,SW Valeria View & Barnes,13260,N,FS,0,0,0,0,Fall2018
7136,SW Taylor & Windwood Way,13261,E,NS,0,4,4,0,Fall2018
7132,SW Taylor & Morrison,13262,E,FS,0,1,1,0,Fall2018
711,9300 Block SW Taylor,13263,E,AT,0,1,1,0,Fall2018
7130,SW Taylor & 90th,13264,E,NS,0,1,1,0,Fall2018
3432,NW Leahy & Oak,13265,N,FS,0,0,0,0,Fall2018
3433,NW Leahy & Trillium Hollow,13266,W,AT,0,1,1,0,Fall2018
3462,NW Saltzman & Dogwood,13267,N,FS,2,4,6,0,Fall2018
3466,NW Saltzman & Westlawn Terrace,13268,N,FS,0,0,0,0,Fall2018
3464,NW Saltzman & Marshall,13269,N,NS,0,0,0,0,Fall2018
3460,NW Saltzman & Coleman,13270,N,NS,0,0,0,0,Fall2018
3457,NW Saltzman & 128th,13271,W,FS,0,1,1,0,Fall2018
3459,NW Saltzman & Burton,13272,N,FS,0,0,0,0,Fall2018
3458,NW Saltzman & Bauer Woods,13273,N,FS,1,0,1,0,Fall2018
3461,NW Saltzman & Creekside,13274,N,FS,0,0,0,0,Fall2018
3463,NW Saltzman & Hartford,13275,N,NS,1,0,1,0,Fall2018
3520,NW Thompson & 126th,13276,E,OP,0,0,0,0,Fall2018
3519,NW Thompson & 120th,13277,E,FS,1,1,2,0,Fall2018
3523,NW Thompson & Permian,13278,E,NS,1,1,2,0,Fall2018
3521,NW Thompson & Gerritz,13279,E,FS,0,0,0,0,Fall2018
3522,NW Thompson & McDaniel,13280,E,NS,1,1,2,0,Fall2018
3438,NW McDaniel & 111th Ct,13281,W,FS,0,0,0,0,Fall2018
3445,NW McDaniel & Blackhawk,13282,W,FS,0,0,0,0,Fall2018
71,11800 Block NW McDaniel,13283,W,OP,1,1,2,0,Fall2018
3118,NW 119th & Kathleen Dr,13284,S,FS,0,0,0,0,Fall2018
3127,NW 119th & Maple Hill,13285,S,FS,0,0,0,0,Fall2018
3128,NW 119th & Old Quarry,13286,S,FS,0,0,0,0,Fall2018
3130,NW 119th & Sunningdale,13287,S,FS,0,0,0,0,Fall2018
3117,NW 119th & Coleman,13288,S,FS,0,0,0,0,Fall2018
3131,NW 119th & Vallevue,13289,S,FS,0,0,0,0,Fall2018
3120,NW 119th & Lovejoy,13290,S,FS,0,0,0,0,Fall2018
3119,NW 119th & Kearney,13291,S,FS,0,0,0,0,Fall2018
3129,NW 119th & Reeves,13292,S,FS,1,0,1,0,Fall2018
3516,NW St Helens & Saltzman,13293,N,OP,0,5,5,0,Fall2018
3517,NW St Helens & Saltzman,13294,S,FS,4,1,5,0,Fall2018
4488,SE Division & SE Division St MAX Station,13297,E,AT,327,91,418,62,Fall2018
4489,SE Division & SE Division St MAX Station,13298,W,OP,85,307,392,48,Fall2018
6645,SW Harrison & 6th,13305,W,NS,56,442,498,99,Fall2018
3302,NW Cornell & Murray ,13309,E,NS,11,34,45,6,Fall2018
7133,SW Taylor & Selba Terrace,13310,W,OP,0,0,0,0,Fall2018
7134,SW Taylor & Selba Terrace,13311,E,NS,0,0,0,0,Fall2018
3344,NW Division & Wonderview,13312,W,NS,9,6,15,0,Fall2018
1062,Glenn Otto Park,13314,W,AT,4,3,7,0,Fall2018
984,E Columbia River Hwy & SE Kibling,13315,W,OP,2,0,2,0,Fall2018
3902,SE 185th Ave/Rockwood,13320,S,NS,1,3,4,3,Fall2018
390,2800 Block SW Hocken,13325,N,AT,4,12,16,1,Fall2018
980,E Burnside & SE Sandy,13327,E,FS,195,349,544,152,Fall2018
2352,NE Couch & 12th,13328,W,NS,287,241,528,120,Fall2018
2353,NE Couch & 7th,13329,W,NS,147,103,250,45,Fall2018
982,E Columbia River Hwy & SE Jackson Park,13331,S,NS,0,0,0,0,Fall2018
983,E Columbia River Hwy & SE Jackson Park,13332,N,OP,1,0,1,0,Fall2018
921,E Burnside & E 181st Ave Park & Ride,13345,E,AT,0,2,2,0,Fall2018
6259,SW Capitol & Carson,13347,N,FS,7,4,11,2,Fall2018
853,Civic Drive MAX Station,13449,W,AT,301,84,385,0,Fall2018
854,Civic Drive MAX Station,13450,E,AT,94,322,416,0,Fall2018
3446,NW McDaniel & Harding Ct,13455,W,FS,1,0,1,0,Fall2018
3582,Oatfield & Webster,13458,N,FS,6,1,7,0,Fall2018
7591,Webster & Oatfield,13459,N,FS,5,1,6,0,Fall2018
3262,NW Cornell & 118th,13465,E,FS,10,5,15,0,Fall2018
2746,NE Kane & SE 1st,13468,S,NS,5,2,7,1,Fall2018
4929,SE Kane & 5th St,13469,S,FS,0,0,0,1,Fall2018
4930,SE Kane & 5th St,13470,N,NS,0,1,1,1,Fall2018
4407,SE Division & 156th,13471,E,OP,35,87,122,39,Fall2018
2313,NE Columbia Blvd & 47th,13472,W,FS,18,44,62,2,Fall2018
1024,E Powell & NE Elliott,13473,W,NS,0,0,0,1,Fall2018
1025,E Powell & NE Elliott,13474,E,OP,0,0,0,1,Fall2018
3931,SE 257th/Kane & Powell Valley,13475,S,FS,0,2,2,0,Fall2018
4932,SE Kane & Powell Valley,13476,N,FS,8,12,20,0,Fall2018
4899,SE Jackson & Main,13477,E,FS,179,199,378,37,Fall2018
1362,N Fessenden & Iris Way,13479,W,FS,21,88,109,15,Fall2018
2518,NE Glisan & 127th,13480,W,FS,1,1,2,0,Fall2018
674,8300 Block SW Hall,13481,W,AT,43,26,69,9,Fall2018
3907,SE 21st & Jackson,13482,S,NS,94,272,366,57,Fall2018
13,10100 Block SW Commerce Circle,13493,E,AT,45,45,90,35,Fall2018
4863,SE Hwy 224 & Dowty Rd224 & Dowty Rd,13495,S,FS,0,1,1,0,Fall2018
4864,SE Hwy 224 & Dowty Rd224 & Dowty Rd,13496,N,OP,0,0,0,0,Fall2018
533,50 Block NE Gertz Rd,13497,E,OP,10,56,66,18,Fall2018
5786,SW 198th & Rock Rd,13498,N,NS,9,7,16,1,Fall2018
438,3300 Block SW 198th,13499,N,OP,17,47,64,7,Fall2018
6659,SW Heiney & 18th Terrace,13500,N,OP,0,2,2,0,Fall2018
6660,SW Heiney & 18th Terrace,13501,S,NS,3,1,4,0,Fall2018
7252,SW Towle & 17th Ct ,13502,N,NS,2,1,3,0,Fall2018
3663,Portland International Airport - Arrivals,13504,S,AT,4,5,9,2,Fall2018
2674,NE Halsey & 208th Pl,13505,W,FS,18,5,23,0,Fall2018
1075,Gresham Transit Center,13506,E,FS,1,18,19,3,Fall2018
5782,SW 198th & Oak Ct,13517,S,FS,3,4,7,0,Fall2018
275,19400 Block SE Stark,13523,W,AT,16,12,28,17,Fall2018
1338,N Columbia Blvd & Burgard,13526,N,NS,0,0,0,2,Fall2018
1474,N Lombard & Burgard,13527,S,NS,1,0,1,2,Fall2018
2409,NE Evergreen & Evergreen Middle School,13528,W,OP,0,1,1,0,Fall2018
2268,NE Century (NW 229th) & Brighton St,13529,S,FS,3,4,7,0,Fall2018
3287,NW Cornell & 188th,13530,E,FS,20,26,46,7,Fall2018
3405,NW Graham/257th & W Columbia River Hwy,13532,N,FS,10,68,78,7,Fall2018
5314,SE Powell & Powell Garage Dr,13542,E,NS,0,21,21,1,Fall2018
6711,SW Langer & Holland,13546,W,FS,3,18,21,4,Fall2018
5431,SE Stark & 169th,13547,W,NS,32,12,44,15,Fall2018
1012,E Main & SE 33rd,13548,E,NS,9,3,12,0,Fall2018
5324,SE Powell Valley & Ironwood Flag Stop,13551,E,AT,0,0,0,0,Fall2018
3946,SE 282nd & Salquist,13552,S,FS,0,0,0,0,Fall2018
3948,SE 282nd & Welch Rd,13553,S,NS,1,0,1,0,Fall2018
3929,SE 257th/Kane & 11th,13554,S,NS,0,1,1,0,Fall2018
5180,SE Orient Dr & Chase,13555,S,OP,0,2,2,0,Fall2018
5181,SE Orient Dr & Chase,13558,N,FS,1,0,1,0,Fall2018
3930,SE 257th/Kane & 11th,13559,N,NS,2,0,2,0,Fall2018
3949,SE 282nd & Welch Rd,13560,N,FS,2,2,4,0,Fall2018
3947,SE 282nd & Salquist,13561,N,FS,0,1,1,0,Fall2018
3664,Powell Valley & Old Woods Lp Flag Stop,13562,W,AT,0,1,1,0,Fall2018
3686,S Buxton & SW 2nd,13569,S,FS,5,1,6,0,Fall2018
2844,NE M L King & Winchell,13570,S,NS,50,16,66,12,Fall2018
6387,SW Dosch & Doschview,13571,N,NS,0,0,0,0,Fall2018
358,2600 Block SW Ravensview,13572,N,AT,4,0,4,0,Fall2018
350,2500 Block SW Vista,13573,W,OP,0,2,2,0,Fall2018
5046,SE Mather & Summers Ln,13576,N,FS,0,4,4,1,Fall2018
114,12900 Block SW Canyon,13577,E,AT,3,33,36,2,Fall2018
602,6500 Block SW Taylors Ferry,13578,W,OP,0,1,1,0,Fall2018
6466,SW Farmington & Rosa Rd ,13579,W,NS,12,21,33,2,Fall2018
730,9900 Block SW Hall,13581,S,AT,3,7,10,2,Fall2018
6132,SW Blum & Palmblad ,13582,W,FS,2,9,11,0,Fall2018
628,72nd & Cardinal,13583,S,FS,0,4,4,0,Fall2018
5012,SE M L King & Morrison,13584,S,FS,30,112,142,18,Fall2018
3263,NW Cornell & 118th,13586,W,OP,5,11,16,0,Fall2018
6615,SW Hamilton & 52nd,13587,W,FS,0,3,3,0,Fall2018
7103,SW Summit Dr & Greenburg,13588,E,NS,21,14,35,1,Fall2018
7104,SW Summit Dr & Palmblad,13589,W,NS,12,19,31,1,Fall2018
5922,SW 72nd & Cherry Dr,13590,S,NS,1,2,3,0,Fall2018
2942,NE Sandy & 104th,13591,W,OP,21,25,46,3,Fall2018
778,Beavercreek & Danielson Dr,13592,W,NS,75,13,88,41,Fall2018
1966,NE 238th & Halsey,13594,N,FS,17,20,37,5,Fall2018
5471,SE Stark & 85th,13596,W,NS,22,4,26,7,Fall2018
4637,SE Grand & Stark,13597,N,FS,117,43,160,66,Fall2018
658,800 Block NE 181st,13598,S,OP,9,6,15,2,Fall2018
6799,SW Moody & Meade South,13601,S,AT,86,31,117,16,Fall2018
7622,Willamette Dr & Webb,13603,N,NS,3,0,3,0,Fall2018
5013,SE M L King & Stark,13613,S,FS,38,98,136,54,Fall2018
617,700 Block NW Naito Parkway,13621,S,AT,4,6,10,12,Fall2018
1412,N Hayden Island Dr & Tomahawk Island Dr,13629,N,FS,5,47,52,4,Fall2018
3670,Relay Resources,13630,N,AT,9,14,23,0,Fall2018
1104,Hwy 224 & Paul Bunyan Ln,13631,E,NS,0,0,0,0,Fall2018
1103,Hwy 224  & Paul Bunyan Ln,13632,W,OP,0,0,0,0,Fall2018
2199,NE 9th & Hassalo,13633,S,NS,44,30,74,3,Fall2018
1674,N Vancouver Way & Jubitz,13635,N,OP,11,22,33,4,Fall2018
6785,SW Main & Commercial,13636,E,FS,83,94,177,13,Fall2018
3561,NW Yeon & 44th,13637,E,NS,36,58,94,6,Fall2018
1780,NE 102nd & Sandy,13639,N,NS,9,10,19,3,Fall2018
6703,SW Jenkins & Murray,13640,W,NS,2,1,3,0,Fall2018
1675,N Vancouver Way & Jubitz,13643,S,AT,28,14,42,2,Fall2018
1138,Kerr & Hidalgo,13645,S,FS,5,8,13,1,Fall2018
5847,SW 40th & Troy,13647,S,FS,1,3,4,0,Fall2018
1676,N Vancouver Way & NE Middlefield,13648,N,NS,2,20,22,0,Fall2018
701,900 Block Washington,13649,S,AT,2,3,5,8,Fall2018
5182,SE Orient Dr & Elsa St,13650,E,NS,0,0,0,0,Fall2018
3045,NE Sandy & 87th,13651,E,OP,3,17,20,22,Fall2018
298,20300 Block SE Hwy 224,13654,W,AT,0,0,0,0,Fall2018
296,20200 Block SE Hwy 224,13655,E,AT,0,0,0,0,Fall2018
4882,SE Hwy 224 & McPartland,13657,W,FS,0,0,0,0,Fall2018
4866,SE Hwy 224 & Eckert Ln224 & Eckert Ln,13662,N,NS,3,0,3,0,Fall2018
4877,SE Hwy 224 & Goosehollow,13663,N,NS,6,0,6,0,Fall2018
3419,NW Laidlaw & Preakness,13666,W,FS,7,3,10,1,Fall2018
3412,NW Laidlaw & 167th Pl,13667,W,OP,2,0,2,0,Fall2018
3415,NW Laidlaw & Cove,13668,S,OP,2,2,4,0,Fall2018
3421,NW Laidlaw & West Union,13669,S,FS,6,3,9,0,Fall2018
3417,NW Laidlaw & Emerald Canyon,13670,S,FS,3,2,5,1,Fall2018
3140,NW 174th & Lonerock,13671,S,FS,3,2,5,0,Fall2018
3138,NW 174th & Bethany Elem School,13672,S,AT,3,2,5,0,Fall2018
3142,NW 174th & Parkview,13673,S,FS,2,4,6,1,Fall2018
3255,NW Bronson & 179th,13674,W,FS,1,0,1,0,Fall2018
428,3100 Block NW Bronson,13675,W,AT,8,5,13,0,Fall2018
429,3100 Block NW Bronson,13676,E,OP,4,10,14,0,Fall2018
3139,NW 174th & Bethany Elem School,13678,N,OP,2,3,5,0,Fall2018
3141,NW 174th & Lonerock,13679,N,FS,2,3,5,0,Fall2018
3418,NW Laidlaw & Emerald Canyon,13680,N,FS,2,3,5,0,Fall2018
3416,NW Laidlaw & Cove,13681,N,FS,2,2,4,0,Fall2018
3413,NW Laidlaw & 167th Pl,13682,E,FS,0,1,1,0,Fall2018
3420,NW Laidlaw & Preakness,13683,E,OP,1,4,5,1,Fall2018
3414,NW Laidlaw & Bethany,13685,E,NS,4,21,25,4,Fall2018
1261,Morrison Bridge/Belmont & Grand,13689,E,NS,77,106,183,57,Fall2018
3422,NW Laidlaw & West Union,13691,N,NS,2,5,7,0,Fall2018
3143,NW 174th & Parkview,13692,N,NS,4,3,7,0,Fall2018
3860,SE 17th & Rhine,13693,N,FS,55,48,103,2,Fall2018
4443,SE Division & 42nd,13696,E,OP,29,57,86,25,Fall2018
7085,SW Shattuck & 59th Ct,13703,N,FS,3,4,7,0,Fall2018
3861,SE 17th & Rhine,13704,S,FS,46,50,96,2,Fall2018
439,3300 Block SW 198th,13705,S,AT,36,24,60,5,Fall2018
5756,SW 197th & Limestone Ct,13706,N,FS,6,4,10,41,Fall2018
4115,SE 82nd & Center,13707,S,NS,54,177,231,38,Fall2018
1174,Lincoln St/SW 3rd Ave MAX Station,13710,E,AT,331,234,565,0,Fall2018
7445,South Waterfront/SW Moody MAX Station,13711,E,AT,632,543,1175,0,Fall2018
3564,OMSI/SE Water MAX Station,13712,E,AT,162,153,315,0,Fall2018
863,Clinton St/SE 12th Ave MAX Station,13713,E,AT,138,324,462,0,Fall2018
3880,SE 17th Ave & Rhine St MAX Station,13714,S,AT,99,277,376,0,Fall2018
3878,SE 17th Ave & Holgate Blvd MAX Station,13715,S,AT,108,349,457,0,Fall2018
4304,SE Bybee Blvd MAX Station,13716,S,AT,48,470,518,0,Fall2018
5567,SE Tacoma/Johnson Creek MAX Station,13717,S,AT,64,688,752,0,Fall2018
1231,Milwaukie/Main St MAX Station,13718,S,AT,60,663,723,0,Fall2018
5185,SE Park Ave MAX Station,13720,N,AT,1714,1754,3468,0,Fall2018
1232,Milwaukie/Main St MAX Station,13721,N,AT,625,46,671,0,Fall2018
5568,SE Tacoma/Johnson Creek MAX Station,13722,N,AT,749,53,802,0,Fall2018
4305,SE Bybee Blvd MAX Station,13723,N,AT,465,49,514,0,Fall2018
3879,SE 17th Ave & Holgate Blvd MAX Station,13724,N,AT,370,94,464,0,Fall2018
3881,SE 17th Ave & Rhine St MAX Station,13725,N,AT,288,93,381,0,Fall2018
864,Clinton St/SE 12th Ave MAX Station,13726,W,AT,331,145,476,0,Fall2018
3565,OMSI/SE Water MAX Station,13727,W,AT,148,177,325,0,Fall2018
7446,South Waterfront/SW Moody MAX Station,13728,W,AT,515,671,1186,0,Fall2018
1175,Lincoln St/SW 3rd Ave MAX Station,13729,W,AT,270,389,659,0,Fall2018
7443,South Waterfront/SW Moody,13732,E,AT,388,120,508,39,Fall2018
7444,South Waterfront/SW Moody,13733,W,AT,177,391,568,52,Fall2018
6133,SW Boones Ferry & Orchard Hill ,13735,N,FS,5,0,5,0,Fall2018
6128,SW Beveland & 69th ,13736,W,FS,55,7,62,23,Fall2018
2568,NE Glisan & 45th,13737,E,NS,14,35,49,22,Fall2018
4427,SE Division & 23rd,13741,W,FS,25,21,46,1,Fall2018
7564,Washington & 12th,13743,S,NS,2,5,7,3,Fall2018
3965,SE 32nd & Furat Ct,13744,S,FS,2,17,19,11,Fall2018
82,12100 N Pavilion,13748,N,NS,108,4,112,44,Fall2018
372,27400 Block SE Eagle Creek Rd,13749,S,OP,0,0,0,0,Fall2018
4438,SE Division & 36th,13753,E,FS,33,92,125,9,Fall2018
5378,SE River Rd & Torbank,13756,S,NS,3,5,8,0,Fall2018
4535,SE Ellis & 89th,13757,W,NS,9,1,10,2,Fall2018
6712,SW Langer & Holland,13766,E,NS,23,2,25,5,Fall2018
178,1500 Block SW Sunset Blvd,13767,S,OP,0,0,0,0,Fall2018
7331,SW Vermont & 34th,13768,W,FS,2,34,36,1,Fall2018
7332,SW Vermont & 34th,13769,E,FS,36,5,41,0,Fall2018
5565,SE Tacoma Park & Ride,13770,S,AT,16,55,71,5,Fall2018
5566,SE Tacoma Park & Ride,13771,N,AT,42,21,63,6,Fall2018
3562,OMSI/SE Water,13772,E,AT,75,28,103,13,Fall2018
3563,OMSI/SE Water,13773,W,AT,42,82,124,13,Fall2018
3778,SE 122nd & Raymond,13775,S,FS,4,29,33,14,Fall2018
3904,SE 21st & Adams,13776,N,NS,9,35,44,1,Fall2018
4490,SE Division Pl & 8th ,13778,E,NS,14,27,41,3,Fall2018
6538,SW Hall & 5th,13780,W,NS,25,322,347,33,Fall2018
4300,SE Bybee & Bybee Blvd MAX Station,13781,E,AT,65,7,72,21,Fall2018
4301,SE Bybee & Bybee Blvd MAX Station,13782,W,AT,16,63,79,21,Fall2018
5003,SE Linwood & King,13783,N,FS,6,7,13,0,Fall2018
5004,SE Linwood & King,13784,S,NS,4,6,10,2,Fall2018
5009,SE Linwood & Needham Ct,13785,N,NS,3,1,4,0,Fall2018
722,9700 Block SE Linwood,13786,S,AT,1,2,3,0,Fall2018
4913,SE Johnson Creek & 58th Dr,13787,W,FS,5,1,6,1,Fall2018
4920,SE Johnson Creek & Wichita,13788,E,NS,1,3,4,0,Fall2018
4918,SE Johnson Creek & Stanley,13789,W,FS,2,1,3,0,Fall2018
4919,SE Johnson Creek & Stanley,13790,E,OP,2,3,5,0,Fall2018
5097,SE Milwaukie & Gideon,13791,S,FS,113,75,188,7,Fall2018
5208,SE Powell & 12th,13792,E,NS,238,196,434,74,Fall2018
461,3700 Block SW Huber,13794,E,AT,1,0,1,0,Fall2018
519,4900 Block SE Johnson Creek,13805,W,AT,3,1,4,0,Fall2018
520,4900 Block SE Johnson Creek,13806,E,OP,1,2,3,0,Fall2018
4908,SE Johnson Creek & 32nd,13807,E,FS,1,1,2,4,Fall2018
2725,NE Halsey & Wood Village,13809,W,FS,61,19,80,15,Fall2018
6705,SW Kelly & Gibbs,13815,S,FS,11,4,15,2,Fall2018
6769,SW Macadam & Sellwood Bridge,13816,S,NS,3,6,9,1,Fall2018
6770,SW Macadam & Sellwood Bridge,13817,N,FS,6,4,10,0,Fall2018
21,10400 Block NE 6th Dr,13818,S,OP,1,1,2,0,Fall2018
4105,SE 7th & Tilikum Way,13825,N,NS,25,24,49,3,Fall2018
7298,SW Tualatin-Sherwood Rd & 90th ,13827,W,NS,3,0,3,0,Fall2018
7300,SW Tualatin-Sherwood Rd & 95th ,13828,W,NS,1,3,4,0,Fall2018
7321,SW Tualatin-Sherwood Rd & Teton,13829,W,NS,1,7,8,0,Fall2018
7293,SW Tualatin-Sherwood Rd & 112th ,13830,W,NS,1,4,5,0,Fall2018
7294,SW Tualatin-Sherwood Rd & 115th ,13831,W,NS,0,9,9,0,Fall2018
7296,SW Tualatin-Sherwood Rd & 124th ,13832,W,NS,0,0,0,0,Fall2018
7305,SW Tualatin-Sherwood Rd & Cipole ,13833,W,NS,0,1,1,0,Fall2018
7317,SW Tualatin-Sherwood Rd & Oregon St,13834,W,OP,0,3,3,0,Fall2018
7307,SW Tualatin-Sherwood Rd & Gerda Ln ,13835,W,NS,0,1,1,2,Fall2018
7315,SW Tualatin-Sherwood Rd & Langer Farms,13836,W,OP,0,4,4,0,Fall2018
7316,SW Tualatin-Sherwood Rd & Langer Farms,13837,E,FS,4,0,4,0,Fall2018
7314,SW Tualatin-Sherwood Rd & Gerda Ln,13838,E,OP,1,0,1,0,Fall2018
7318,SW Tualatin-Sherwood Rd & Oregon St,13839,E,NS,3,1,4,0,Fall2018
7306,SW Tualatin-Sherwood Rd & Cipole ,13840,E,OP,1,0,1,0,Fall2018
7297,SW Tualatin-Sherwood Rd & 124th ,13841,E,OP,0,0,0,0,Fall2018
7295,SW Tualatin-Sherwood Rd & 115th ,13842,E,NS,8,0,8,0,Fall2018
7302,SW Tualatin-Sherwood Rd & Avery ,13843,E,NS,4,1,5,0,Fall2018
7322,SW Tualatin-Sherwood Rd & Teton,13844,E,NS,3,1,4,0,Fall2018
7301,SW Tualatin-Sherwood Rd & 95th ,13845,E,NS,1,0,1,0,Fall2018
7299,SW Tualatin-Sherwood Rd & 90th ,13846,E,NS,0,1,1,0,Fall2018
7304,SW Tualatin-Sherwood Rd & Boones Ferry ,13847,E,NS,0,18,18,0,Fall2018
1126,Jean Rd & Pilkington,13854,W,FS,3,2,5,0,Fall2018
1124,Jean Rd & Jean Way,13855,W,NS,1,0,1,0,Fall2018
1125,Jean Rd & Jean Way,13856,E,FS,0,1,1,0,Fall2018
1127,Jean Rd & Pilkington,13857,E,FS,2,0,2,0,Fall2018
2336,NE Cornell & Elam Young East,13858,E,FS,3,5,8,5,Fall2018
3945,SE 282nd & Powell Valley,13867,N,NS,1,2,3,5,Fall2018
145,1400 Block NW Naito Parkway,13868,S,OP,1,1,2,0,Fall2018
1647,N Syracuse & Chicago,13869,S,FS,9,27,36,50,Fall2018
6908,SW Pacific Hwy & Dartmouth ,13870,N,FS,51,45,96,27,Fall2018
5112,SE Monterey & Fuller,13871,E,FS,6,4,10,0,Fall2018
662,8000 Block SE Monterey,13872,E,OP,0,4,4,1,Fall2018
663,8000 Block SE Monterey,13873,W,AT,3,1,4,0,Fall2018
5113,SE Monterey & Fuller,13874,W,NS,8,4,12,0,Fall2018
1629,N St Louis & Lombard,13876,W,NS,3,92,95,21,Fall2018
1523,N Lombard & St Louis,13877,N,NS,84,107,191,59,Fall2018
4416,SE Division & 178th,13878,E,OP,22,67,89,11,Fall2018
349,2500 Block NW Division,13879,W,AT,15,9,24,5,Fall2018
355,2600 Block NW Division,13880,E,AT,12,16,28,5,Fall2018
163,14200 Block SE Division,13881,E,AT,19,50,69,8,Fall2018
2717,NE Halsey & 92nd,13883,W,FS,11,5,16,6,Fall2018
5543,SE Sunnyside & 157th,13884,E,NS,1,24,25,0,Fall2018
5544,SE Sunnyside & 162nd,13885,E,NS,2,12,14,1,Fall2018
3833,SE 169th & Misty,13887,N,NS,9,26,35,5,Fall2018
3834,SE 172nd & Sunnyside,13888,S,NS,18,14,32,6,Fall2018
5546,SE Sunnyside & 169th,13889,W,NS,10,1,11,1,Fall2018
5545,SE Sunnyside & 162nd,13890,W,FS,11,2,13,0,Fall2018
6134,SW Boones Ferry & Trillium ,13891,S,NS,0,2,2,0,Fall2018
2867,NE Multnomah & 21st ,13892,W,FS,6,4,10,0,Fall2018
3185,NW 21st & Pettygrove,13899,S,NS,91,3,94,6,Fall2018
6576,SW Hall & Langtree,13900,S,NS,1,6,7,1,Fall2018
4088,SE 72nd & Clatsop,13904,N,FS,19,8,27,13,Fall2018
1413,N Hayden Meadows Dr & Kerby,13905,E,NS,6,3,9,1,Fall2018
1652,N Union Ct & East Delta Park Entrance,13906,N,FS,6,3,9,1,Fall2018
1653,N Union Ct & East Delta Park Entrance,13907,S,AT,1,9,10,1,Fall2018
1414,N Hayden Meadows Dr & Kerby,13908,W,FS,2,8,10,1,Fall2018
42,1100 Block N Hayden Meadows Dr,13909,S,AT,22,70,92,65,Fall2018
723,9800 Block N Whitaker,13910,N,NS,19,21,40,7,Fall2018
725,9800 Block NE Prescott,13913,W,AT,2,6,8,0,Fall2018
2905,NE Prescott & 96th,13914,W,NS,0,12,12,5,Fall2018
6467,SW Farmington & Rose Ln ,13916,W,FS,17,36,53,12,Fall2018
6468,SW Farmington & Rose Ln ,13917,E,NS,40,18,58,13,Fall2018
6381,SW Denney & Queen,13924,E,FS,1,7,8,1,Fall2018
6378,SW Denney & 111th,13925,E,OP,2,5,7,0,Fall2018
6582,SW Hall & Oak,13927,S,NS,2,4,6,0,Fall2018
6585,SW Hall & Pfaffle,13928,S,NS,1,5,6,0,Fall2018
67,11700 Block SW Hall,13929,S,OP,0,8,8,2,Fall2018
6575,SW Hall & Hunziker/Scoffins,13930,S,NS,2,3,5,0,Fall2018
6745,SW Lombard & Bruce Ln,13931,S,NS,7,10,17,3,Fall2018
6593,SW Hall & Scoffins/Hunziker,13932,N,NS,2,2,4,3,Fall2018
68,11700 Block SW Hall,13933,N,AT,4,0,4,2,Fall2018
6586,SW Hall & Pfaffle,13934,N,FS,8,1,9,0,Fall2018
6583,SW Hall & Oak,13935,N,NS,4,1,5,0,Fall2018
6377,SW Denney & 103rd,13936,W,NS,10,6,16,1,Fall2018
6379,SW Denney & 111th,13937,W,NS,6,2,8,0,Fall2018
6749,SW Lombard & Cheshire,13938,N,FS,15,3,18,0,Fall2018
1929,NE 166th & Airport Way,13939,N,FS,2,2,4,0,Fall2018
194,16200 Block NE Cameron,13940,W,AT,4,4,8,0,Fall2018
1861,NE 158th & Airport Way,13941,S,NS,6,1,7,0,Fall2018
1862,NE 158th & Mason,13942,S,NS,3,0,3,0,Fall2018
1918,NE 162nd & Fargo,13943,S,NS,8,0,8,0,Fall2018
1927,NE 162nd & Thompson,13944,S,NS,3,0,3,1,Fall2018
1925,NE 162nd & San Rafael,13945,S,NS,1,0,1,0,Fall2018
1921,NE 162nd & Halsey,13946,S,NS,16,6,22,2,Fall2018
1923,NE 162nd & Holladay,13947,S,FS,2,1,3,1,Fall2018
1920,NE 162nd & Glisan,13948,S,FS,16,8,24,2,Fall2018
1916,NE 162nd & E Burnside,13949,S,NS,19,32,51,6,Fall2018
583,600 Block SE 162nd,13950,S,OP,41,18,59,13,Fall2018
3826,SE 162nd & Main,13951,S,FS,7,4,11,1,Fall2018
4454,SE Division & 49th,13952,E,FS,23,52,75,9,Fall2018
3828,SE 162nd & Mill,13953,S,FS,1,3,4,0,Fall2018
3825,SE 162nd & Grant,13954,S,NS,0,4,4,1,Fall2018
3823,SE 162nd & Division,13955,S,FS,14,48,62,19,Fall2018
3831,SE 162nd & Tibbets,13956,S,OP,0,2,2,0,Fall2018
5233,SE Powell & 162nd,13957,E,FS,9,48,57,5,Fall2018
460,3700 Block SE 162nd,13958,N,AT,11,1,12,1,Fall2018
3832,SE 162nd & Tibbets,13959,N,FS,6,1,7,1,Fall2018
3824,SE 162nd & Division,13960,N,FS,54,18,72,23,Fall2018
293,2000 Block SE162nd,13961,N,AT,4,0,4,0,Fall2018
3829,SE 162nd & Mill,13962,N,FS,10,3,13,0,Fall2018
3827,SE 162nd & Main,13963,N,FS,5,6,11,2,Fall2018
3830,SE 162nd & Stark,13964,N,FS,17,37,54,16,Fall2018
1917,NE 162nd & E Burnside,13965,N,FS,22,46,68,9,Fall2018
572,600 Block NE 162nd,13966,N,OP,7,19,26,2,Fall2018
1924,NE 162nd & Holladay,13967,N,NS,0,2,2,0,Fall2018
1922,NE 162nd & Halsey,13968,N,FS,6,19,25,3,Fall2018
1926,NE 162nd & San Rafael,13969,N,FS,0,1,1,0,Fall2018
1928,NE 162nd & Thompson,13970,N,OP,1,3,4,0,Fall2018
1919,NE 162nd & Fargo,13971,N,NS,0,8,8,1,Fall2018
1863,NE 158th & Mason,13972,N,FS,2,3,5,0,Fall2018
3903,SE 1st & 3rd,13973,S,NS,7,6,13,9,Fall2018
3996,SE 3rd & 1st,13974,N,NS,2,1,3,2,Fall2018
79,1200 Block NW Swigert Way,13975,E,AT,109,103,212,1,Fall2018
174,1500 Block NE Graham Rd,13976,S,FS,1,0,1,0,Fall2018
696,900 Block NE Graham Rd,13977,S,AT,9,0,9,0,Fall2018
4883,SE Hwy 224 & Oak,13978,E,NS,2,2,4,2,Fall2018
4640,SE Harmony & Fuller,13980,E,FS,1,0,1,1,Fall2018
647,7700 Blk SE Harmony (Clack. Comm. College),13981,E,AT,1,2,3,0,Fall2018
4641,SE Harmony & Fuller,13983,W,FS,6,4,10,4,Fall2018
4639,SE Harmony & Cedarcrest,13984,W,NS,7,11,18,0,Fall2018
4642,SE Harmony & International Way,13985,S,NS,1,5,6,1,Fall2018
4884,SE Hwy 224 & Oak,13986,N,FS,2,4,6,2,Fall2018
697,900 Block NE Graham Rd,13988,N,OP,3,10,13,0,Fall2018
175,1500 Block NE Graham Rd,13989,N,AT,0,0,0,0,Fall2018
3400,NW Graham & N Entrance Rd,13990,W,NS,0,1,1,0,Fall2018
3518,NW Sundial & Rogers Circle,13991,N,OP,8,24,32,0,Fall2018
6577,SW Hall & Locust,13992,N,NS,3,2,5,0,Fall2018
1254,Molalla & Warner-Milne,13993,N,FS,5,0,5,2,Fall2018
6800,SW Moody & River Pkwy,13994,S,FS,8,12,20,8,Fall2018
5611,SE Washington & Main,13999,E,NS,66,77,143,27,Fall2018
36,10800 SW Walnut,14000,E,AT,1,0,1,0,Fall2018
707,9200 Block SE Foster,14002,W,AT,129,196,325,26,Fall2018
6376,SW Denney & 100th Terr,14003,E,NS,6,10,16,1,Fall2018
5407,SE Stark & 127th,14004,W,NS,32,11,43,2,Fall2018
3447,NW McDaniel & Ridge,14005,S,FS,0,0,0,0,Fall2018
5954,SW Alder & 17th,14006,E,NS,61,151,212,23,Fall2018
7503,W Burnside & NW 24th Pl,14009,W,FS,15,37,52,2,Fall2018
2354,NE Couch & Grand,14015,W,FS,219,230,449,114,Fall2018
5302,SE Powell & 99th,14018,E,FS,4,6,10,0,Fall2018
856,Clackamas Community College,14019,N,AT,42,47,89,6,Fall2018
