,location,location_id,direction,position,ons,offs,total,lifts,period
0,A Ave & Second St,3,E,FS,22,10,32,4,Spring2019
1,A Ave & 8th St,6,E,NS,0,2,2,0,Spring2019
2,A Ave & 8th St,7,W,NS,1,0,1,0,Spring2019
3,900 Block Abernethy,8,E,AT,0,0,0,0,Spring2019
4,Abernethy & Barclay,9,N,NS,1,0,1,0,Spring2019
5,Abernethy & Barclay,10,S,OP,1,0,1,0,Spring2019
6,Abernethy & Beatrice,11,E,FS,1,1,2,0,Spring2019
7,Abernethy & Center,12,W,NS,1,1,2,0,Spring2019
8,Abernethy & Duniway,13,N,NS,1,0,1,0,Spring2019
9,Abernethy & Duniway,14,S,OP,0,1,1,1,Spring2019
10,Abernethy & Portland Ave,16,W,FS,3,3,6,3,Spring2019
11,Abernethy & Portland Ave,17,E,NS,4,3,7,1,Spring2019
12,2800 Block NE 92nd,20,N,AT,0,1,1,0,Spring2019
13,2800 Block NE 92nd,21,S,AT,3,1,4,2,Spring2019
14,3400 Block NE 92nd,25,N,AT,3,5,8,1,Spring2019
15,NE 92nd & Hill,26,S,NS,7,1,8,0,Spring2019
16,N Adair & 7th,27,W,FS,5,18,23,3,Spring2019
17,2200 Block Baseline,28,W,AT,51,74,125,36,Spring2019
18,N Adair & 10th,30,W,NS,32,59,91,18,Spring2019
19,N Adair & 12th,31,W,NS,19,62,81,10,Spring2019
20,N Adair & 14th,32,W,NS,28,54,82,9,Spring2019
21,N Adair & 17th,33,W,FS,9,15,24,4,Spring2019
22,N Adair & 20th,34,W,FS,21,40,61,10,Spring2019
23,N Adair & 4th,35,W,FS,56,141,197,52,Spring2019
24,N Trenton & Alaska,40,E,NS,49,17,66,28,Spring2019
25,N Alaska & Chautauqua,41,E,NS,39,8,47,13,Spring2019
26,N Alaska & Chautauqua Pl,42,E,OP,29,17,46,6,Spring2019
27,N Alaska & Chautauqua Pl,43,W,NS,14,28,42,3,Spring2019
28,N Alaska & Foss,44,E,OP,23,20,43,26,Spring2019
29,N Alaska & University Park,45,W,OP,12,32,44,18,Spring2019
30,NE Alberta & M L King,46,E,FS,122,44,166,29,Spring2019
31,NE Alberta & 11th,48,E,NS,13,16,29,8,Spring2019
32,NE Alberta & 11th,49,W,NS,11,12,23,8,Spring2019
33,NE Alberta & 13th,50,E,NS,25,12,37,6,Spring2019
34,NE Alberta & 13th,51,W,NS,12,19,31,6,Spring2019
35,NE Alberta & 15th,52,E,NS,78,81,159,38,Spring2019
36,NE Alberta & 15th,53,W,NS,96,104,200,43,Spring2019
37,NE Alberta & 18th,54,E,NS,27,30,57,8,Spring2019
38,NE Alberta & 18th,55,W,NS,1,5,6,0,Spring2019
39,NE Alberta & 24th,60,E,NS,25,25,50,2,Spring2019
40,NE Alberta & 24th,61,W,NS,26,27,53,5,Spring2019
41,NE Alberta & 27th,63,E,NS,45,38,83,6,Spring2019
42,NE Alberta & 27th,64,W,NS,43,44,87,9,Spring2019
43,SE Alberta & 70th,67,E,OP,6,10,16,4,Spring2019
44,SE Alberta & 70th,68,W,NS,9,5,14,3,Spring2019
45,NE Alberta & 9th,69,E,NS,45,39,84,30,Spring2019
46,NE Alberta & 9th,70,W,NS,38,39,77,27,Spring2019
53,N Albina & Ainsworth,71,N,FS,18,36,54,7,Spring2019
54,N Albina & Ainsworth,72,S,NS,39,22,61,9,Spring2019
55,N Albina & Alberta,73,N,NS,21,49,70,12,Spring2019
56,N Albina & Alberta,74,S,FS,52,23,75,10,Spring2019
57,N Albina & Blandena,76,N,FS,21,48,69,48,Spring2019
58,N Albina & Blandena,77,S,FS,54,19,73,56,Spring2019
59,N Albina & Bryant,78,N,NS,14,23,37,6,Spring2019
60,N Albina & Bryant,79,S,NS,31,11,42,1,Spring2019
61,N Albina & Buffalo,80,N,NS,3,12,15,0,Spring2019
62,N Albina & Buffalo,81,S,NS,13,4,17,1,Spring2019
63,N Albina & Dekum,82,N,NS,8,17,25,8,Spring2019
64,N Albina & Dekum,83,S,NS,23,12,35,27,Spring2019
65,N Albina & Holman,84,N,OP,2,8,10,1,Spring2019
66,N Albina & Killingsworth,88,N,FS,236,249,485,86,Spring2019
67,N Albina & Killingsworth,89,S,FS,257,222,479,84,Spring2019
68,N Albina & Lombard St,90,S,FS,69,23,92,5,Spring2019
69,N Albina & Rosa Parks Way,91,N,FS,21,24,45,10,Spring2019
70,N Albina & Rosa Parks Way,92,S,FS,31,18,49,16,Spring2019
71,N Albina & Lombard St,93,N,NS,8,57,65,3,Spring2019
72,N Albina & Sumner,94,N,NS,46,50,96,3,Spring2019
73,N Albina & Sumner,95,S,NS,49,55,104,1,Spring2019
74,SW Allen & Dale,99,E,NS,8,2,10,1,Spring2019
75,SW Allen & Erickson,100,E,NS,31,9,40,0,Spring2019
76,SW Allen & Erickson,101,W,FS,8,24,32,1,Spring2019
77,SW Allen & Hall,102,E,NS,9,41,50,6,Spring2019
78,SW Allen & Hall,103,W,NS,35,23,58,8,Spring2019
79,SW Allen & Menlo,104,E,NS,22,5,27,2,Spring2019
80,SW Allen & Menlo,105,W,NS,7,23,30,1,Spring2019
81,SW Allen & Murray,106,E,FS,23,3,26,4,Spring2019
82,SW Allen & Taralynn,108,W,FS,5,11,16,0,Spring2019
83,SW Allen & Wilson,111,E,NS,19,6,25,1,Spring2019
84,SW Allen & Wilson,112,W,OP,5,16,21,0,Spring2019
85,SW Allen & 141st,113,E,OP,17,2,19,0,Spring2019
86,SW Allen & 141st,114,W,NS,3,21,24,1,Spring2019
87,N Anchor & Channel,115,E,NS,248,185,433,24,Spring2019
88,NE 21st & Argyle,118,S,FS,16,0,16,0,Spring2019
89,W Arlington & Barton,121,E,NS,26,7,33,9,Spring2019
90,W Arlington & Barton,122,W,NS,0,4,4,2,Spring2019
91,W Arlington & Beatrice,123,E,NS,1,0,1,0,Spring2019
92,W Arlington & Beatrice,124,W,NS,1,1,2,1,Spring2019
93,W Arlington & Bellevue,125,E,NS,1,1,2,0,Spring2019
94,W Arlington & Bellevue,126,W,NS,0,1,1,0,Spring2019
95,E Arlington & Cornell,131,E,NS,3,2,5,0,Spring2019
96,E Arlington & Cornell,132,W,NS,2,1,3,0,Spring2019
97,E Arlington & Harvard,133,E,NS,1,1,2,0,Spring2019
98,E Arlington & Harvard,134,W,NS,2,1,3,0,Spring2019
99,W Arlington & McLoughlin,135,W,NS,3,21,24,8,Spring2019
106,W Arlington & Portland Ave,136,E,NS,6,5,11,2,Spring2019
107,E Arlington & Portland Ave,137,W,NS,4,3,7,0,Spring2019
108,E Arlington & 82nd Dr,140,E,NS,5,6,11,0,Spring2019
109,82nd Dr & E Berkeley,141,S,FS,3,3,6,1,Spring2019
110,SW Arthur & 1st,142,E,NS,29,46,75,16,Spring2019
111,SW Arthur & 1st,143,W,NS,73,58,131,22,Spring2019
112,19th & B St,146,E,FS,296,201,497,102,Spring2019
113,B Ave & Second St,147,W,NS,17,26,43,0,Spring2019
114,10100 Block SW Barbur,150,E,AT,14,19,33,6,Spring2019
115,10700 Block SW Barbur,152,S,AT,1,4,5,0,Spring2019
116,11100 Block SW Barbur,153,W,AT,1,1,2,0,Spring2019
117,11100 Block SW Barbur,154,E,OP,2,1,3,0,Spring2019
118,4900 Block SW Barbur,155,S,OP,59,68,127,2,Spring2019
119,4900 Block SW Barbur,156,N,AT,69,56,125,5,Spring2019
120,SW Barbur & 26th Ave,159,E,OP,42,10,52,4,Spring2019
121,9500 Block SW Barbur,160,E,AT,11,4,15,1,Spring2019
122,SW Barbur & Alice,162,E,FS,29,10,39,5,Spring2019
123,SW Barbur & Alice,163,W,NS,7,24,31,2,Spring2019
124,SW Barbur & Taylors Ferry,164,W,NS,5,13,18,2,Spring2019
125,SW Barbur & Barbur Ct,165,W,OP,7,35,42,5,Spring2019
126,SW Barbur & Capitol Hwy,168,E,NS,66,36,102,3,Spring2019
127,SW Barbur & Capitol Hill,170,S,FS,39,138,177,20,Spring2019
128,SW Barbur & Hamilton,172,N,FS,148,97,245,21,Spring2019
129,SW Barbur & Hamilton,173,W,NS,96,168,264,11,Spring2019
130,SW Barbur & Hooker,174,N,NS,31,19,50,1,Spring2019
131,SW Barbur & Hooker,175,S,NS,25,43,68,3,Spring2019
132,SW Barbur & Lane,176,S,NS,9,25,34,0,Spring2019
133,SW Barbur & Lane,177,N,OP,33,17,50,2,Spring2019
134,SW Barbur & Luradel,178,S,OP,19,54,73,6,Spring2019
135,SW Barbur & Luradel,179,N,FS,50,25,75,7,Spring2019
136,SW Barbur & Moss,180,N,NS,22,6,28,3,Spring2019
137,SW Barbur & Parkhill Dr,181,S,FS,1,4,5,0,Spring2019
138,SW Barbur & Parkhill,182,N,FS,4,2,6,0,Spring2019
139,11200 Block SW Barbur,183,E,AT,11,5,16,0,Spring2019
140,11200 Block SW Barbur,184,W,OP,3,11,14,0,Spring2019
141,SW Barbur & Pennoyer,185,S,OP,15,13,28,0,Spring2019
142,SW Barbur & Pennoyer,186,N,FS,11,7,18,0,Spring2019
143,SW Barbur & Primrose,187,W,NS,20,63,83,29,Spring2019
144,SW Barbur & Capitol Hwy,188,S,FS,3,6,9,0,Spring2019
145,SW Barbur & Slavin/Capitol Hwy,189,N,OP,4,3,7,0,Spring2019
146,SW Barbur & Terwilliger,191,W,FS,29,62,91,2,Spring2019
147,SW Barbur & Terwilliger,193,E,FS,68,17,85,4,Spring2019
148,8900 Block SW Barbur,194,W,AT,3,32,35,1,Spring2019
149,SW Barbur & Whitaker,195,N,FS,14,24,38,1,Spring2019
150,SW Barbur & Whitaker,196,S,OP,12,12,24,0,Spring2019
151,SW Barbur & Woods,197,N,NS,9,7,16,2,Spring2019
152,SW Barbur & Woods,198,S,OP,8,9,17,1,Spring2019
159,SW Barbur & Bertha,199,W,FS,116,199,315,27,Spring2019
160,SW Barbur & 13th,200,W,FS,16,25,41,3,Spring2019
161,SW Barbur & Evans,201,S,NS,3,22,25,0,Spring2019
162,SW Barbur & 19th,202,E,NS,106,33,139,14,Spring2019
163,SW Barbur & 2nd,203,N,NS,58,3,61,1,Spring2019
164,SW Barbur & 3rd,207,W,NS,11,65,76,1,Spring2019
165,SW Barbur & 30th,208,E,FS,94,20,114,29,Spring2019
166,SW Barbur & 53rd,209,W,NS,8,17,25,0,Spring2019
167,SW Barbur & 53rd,210,E,FS,21,11,32,1,Spring2019
168,SW Pacific Hwy & 64th,211,E,NS,42,24,66,2,Spring2019
169,Barbur Transit Center,212,E,AT,548,53,601,20,Spring2019
170,12200 Block NW Barnes,227,S,AT,45,8,53,1,Spring2019
171,NW Barnes & Saltzman,228,N,AT,10,15,25,4,Spring2019
172,7600 Block SW Barnes,229,E,FS,33,6,39,1,Spring2019
173,8200 Block SW Barnes (Art School),230,E,OP,6,8,14,0,Spring2019
174,8200 Block SW Barnes (Art School),231,W,AT,9,7,16,0,Spring2019
175,9300 Block SW Barnes,233,E,AT,7,8,15,5,Spring2019
176,12400 Block NW Barnes,234,N,OP,12,38,50,0,Spring2019
177,8800 Block SW Barnes (Catlin Gabel School),235,W,NS,3,16,19,1,Spring2019
178,SW Barnes & Leahy,236,E,NS,89,25,114,1,Spring2019
179,SW Barnes & Leahy,237,W,NS,19,85,104,2,Spring2019
180,SW Barnes & Miller,238,E,FS,31,25,56,2,Spring2019
181,SW Barnes & Miller,239,W,FS,20,55,75,2,Spring2019
182,SW Barnes & Monterey/St Vincent Hosp Dr,240,W,NS,3,6,9,1,Spring2019
183,SW Barnes & Monterey,241,E,NS,8,3,11,2,Spring2019
184,SW Barnes & W Stark,247,E,FS,24,8,32,0,Spring2019
185,SW Barnes & 70th,251,E,OP,4,1,5,1,Spring2019
186,SW Barnes & 70th,252,W,FS,1,9,10,1,Spring2019
187,SW Barnes & 84th,253,W,FS,4,6,10,0,Spring2019
188,SW Barnes & 88th,255,E,NS,18,3,21,0,Spring2019
189,E Baseline & Valley View,256,E,OP,5,1,6,1,Spring2019
190,SE Tualatin Valley Hwy & 44th,257,W,NS,40,30,70,119,Spring2019
191,700 Block Baseline,258,E,AT,13,5,18,2,Spring2019
192,SW Baseline & Adams,259,W,NS,80,13,93,25,Spring2019
193,E Main & NE Brookwood,260,W,FS,4,13,17,1,Spring2019
194,E Main & SE Brookwood,261,E,NS,14,4,18,1,Spring2019
195,Baseline St & S 26th,263,E,NS,39,15,54,6,Spring2019
196,SW Baseline St & 17th,264,W,OP,31,42,73,19,Spring2019
197,W Baseline Rd & SW Lisa,265,W,FS,6,1,7,0,Spring2019
198,2200 Block Baseline,267,E,AT,50,30,80,22,Spring2019
199,1000 Block SW Baseline St,268,W,AT,26,52,78,18,Spring2019
200,W Baseline Rd & SW Willow Creek Dr,269,E,NS,1,16,17,0,Spring2019
201,Baseline St & S 1st,270,E,FS,20,20,40,13,Spring2019
202,Baseline St & S 10th,271,E,NS,60,27,87,25,Spring2019
203,Baseline St & S 12th,272,E,FS,77,30,107,13,Spring2019
204,Baseline St & S 14th,273,E,NS,47,29,76,6,Spring2019
205,W Baseline Rd & SW 185th,275,W,FS,0,0,0,0,Spring2019
212,Baseline & S 20th,277,E,NS,49,35,84,13,Spring2019
213,W Baseline Rd & SW 194th,278,E,FS,1,1,2,0,Spring2019
214,W Baseline Rd & SW 195th,279,W,NS,1,1,2,0,Spring2019
215,SE Baseline St & 2nd,280,W,NS,110,165,275,43,Spring2019
216,Baseline St & N 26th,284,W,FS,9,32,41,6,Spring2019
217,Baseline St & N 29th/Hobbs,285,E,OP,9,5,14,0,Spring2019
218,Baseline St & N 29th/Hobbs,286,W,FS,7,15,22,0,Spring2019
219,Baseline St & N 31st,287,W,FS,5,7,12,0,Spring2019
220,E Main & NE 32nd,288,W,NS,3,9,12,1,Spring2019
221,SW Baseline & 331st,290,W,OP,0,2,2,0,Spring2019
222,SW Baseline & 331st,291,E,FS,3,1,4,0,Spring2019
223,SW Baseline & NW 334th,292,W,FS,2,8,10,2,Spring2019
224,SW Baseline & NW 334th,293,E,OP,6,2,8,0,Spring2019
225,Baseline & NW 338th,296,W,FS,1,4,5,1,Spring2019
226,Baseline & NW 338th,297,E,OP,3,3,6,2,Spring2019
227,Baseline St & Valley View,298,W,AT,2,10,12,1,Spring2019
228,SW Baseline & 345th,300,E,NS,11,7,18,3,Spring2019
229,E Main & NE 37th,301,W,NS,6,4,10,0,Spring2019
230,E Main & SE 37th,302,E,NS,4,6,10,0,Spring2019
231,Baseline St & S 4th,303,E,NS,110,33,143,37,Spring2019
232,SE Baseline St & 3rd,304,W,NS,64,104,168,11,Spring2019
233,E Main & NE 40th,305,W,NS,1,1,2,0,Spring2019
234,E Main & NE 40th,306,E,OP,4,4,8,0,Spring2019
235,SE Baseline St & 5th,307,W,NS,11,42,53,21,Spring2019
236,SE Baseline St & 7th,308,W,NS,32,69,101,26,Spring2019
237,SE Baseline St & 9th,310,W,NS,73,124,197,30,Spring2019
238,6200 Block N Basin,313,E,AT,1,1,2,1,Spring2019
239,6300 Block N Basin,314,N,AT,0,4,4,0,Spring2019
240,N Basin & Fathom,315,S,FS,3,0,3,0,Spring2019
241,6700 Block N Basin (Coast Guard),316,E,AT,6,4,10,0,Spring2019
242,N Basin & Emerson,317,S,OP,16,0,16,0,Spring2019
243,N Basin & Emerson,318,N,FS,2,15,17,1,Spring2019
244,N Basin & Ensign,319,S,NS,11,2,13,0,Spring2019
245,N Basin & Ensign,320,N,FS,18,44,62,1,Spring2019
246,N Basin & Fathom,321,N,NS,14,23,37,0,Spring2019
247,N Basin & Leverman,322,S,OP,4,0,4,0,Spring2019
248,N Basin & Pacific Pride,324,N,AT,0,7,7,0,Spring2019
249,2600 Block SW Beaverton-Hillsdale,325,E,AT,14,5,19,3,Spring2019
250,3600 Block SW Beaverton-Hillsdale,326,E,AT,5,3,8,0,Spring2019
251,3600 Block SW Beaverton-Hillsdale,327,W,OP,2,5,7,0,Spring2019
252,SW Beaverton-Hillsdale & 59th,328,E,OP,51,12,63,53,Spring2019
253,6100 Block SW Beaverton-Hillsdale,329,W,AT,26,40,66,24,Spring2019
254,7300 Block SW Beaverton-Hillsdale,331,E,OP,7,12,19,7,Spring2019
255,7400 Block SW Beaverton-Hillsdale,332,W,AT,7,17,24,2,Spring2019
256,7700 Block SW Beaverton-Hillsdale,333,E,AT,28,33,61,20,Spring2019
257,SW Beaverton-Hillsdale & Apple Way,335,E,NS,5,6,11,0,Spring2019
258,SW Beaverton-Hillsdale & Bertha,336,E,NS,12,3,15,6,Spring2019
265,SW Beaverton-Hillsdale & Dosch,340,W,NS,20,100,120,3,Spring2019
266,SW Beaverton-Hillsdale & Griffith,341,W,FS,21,54,75,28,Spring2019
267,SW Beaverton-Hillsdale & Griffith,342,E,NS,52,21,73,28,Spring2019
268,SW Beaverton-Hillsdale & Jamieson,343,W,OP,34,28,62,5,Spring2019
269,SW Beaverton-Hillsdale & Jamieson,344,E,FS,30,36,66,5,Spring2019
270,SW Beaverton-Hillsdale & White Pine Ln,345,E,FS,19,8,27,0,Spring2019
271,SW Beaverton-Hillsdale & Laurelwood,346,W,NS,12,23,35,3,Spring2019
272,SW Beaverton-Hillsdale & Laurelwood,347,E,NS,24,12,36,2,Spring2019
273,SW Beaverton-Hillsdale & Oleson,348,E,NS,133,41,174,27,Spring2019
274,SW Beaverton-Hillsdale & Poplar Ln,349,W,NS,4,3,7,0,Spring2019
275,SW Beaverton-Hillsdale & Oleson,350,W,NS,24,69,93,14,Spring2019
276,SW Beaverton-Hillsdale & Shattuck,351,E,NS,73,24,97,11,Spring2019
277,SW Beaverton-Hillsdale & Shattuck,352,W,FS,26,95,121,28,Spring2019
278,SW Beaverton-Hillsdale & Western,354,E,NS,23,36,59,22,Spring2019
279,SW Beaverton-Hillsdale & Western,355,W,OP,41,35,76,23,Spring2019
280,SW Beaverton-Hillsdale & White Pine Ln,356,W,NS,8,12,20,0,Spring2019
281,SW Beaverton-Hillsdale & 101st,357,E,FS,5,8,13,3,Spring2019
282,SW Beaverton-Hillsdale & 101st,358,W,NS,3,4,7,1,Spring2019
283,SW Beaverton-Hillsdale & 107th,360,E,NS,23,42,65,20,Spring2019
284,SW Beaverton-Hillsdale & 110th,361,W,NS,40,27,67,14,Spring2019
285,SW Beaverton-Hillsdale & 110th,362,E,OP,11,19,30,5,Spring2019
286,SW Beaverton-Hillsdale & 18th Dr,363,W,NS,52,64,116,29,Spring2019
287,SW Beaverton-Hillsdale & 25th,364,E,FS,18,5,23,0,Spring2019
288,SW Beaverton-Hillsdale & 25th,365,W,NS,8,31,39,0,Spring2019
289,2600 Block SW Beaverton-Hillsdale,366,W,FS,4,7,11,3,Spring2019
290,SW Beaverton-Hillsdale & 30th,367,E,NS,80,17,97,2,Spring2019
291,SW Beaverton-Hillsdale & 33rd,368,E,NS,34,13,47,8,Spring2019
292,SW Beaverton-Hillsdale & 35th,369,E,FS,29,10,39,0,Spring2019
293,SW Beaverton-Hillsdale & 35th,370,W,OP,19,29,48,5,Spring2019
294,SW Beaverton-Hillsdale & 39th Dr,371,E,OP,32,5,37,7,Spring2019
295,SW Beaverton-Hillsdale & 39th Dr,372,W,NS,5,37,42,1,Spring2019
296,SW Beaverton-Hillsdale & 42nd,373,E,FS,33,9,42,4,Spring2019
297,SW Beaverton-Hillsdale & 42nd,374,W,NS,8,33,41,8,Spring2019
298,SW Beaverton-Hillsdale & 45th,375,E,FS,63,24,87,4,Spring2019
299,SW Beaverton-Hillsdale & 45th,376,W,NS,24,70,94,4,Spring2019
300,SW Beaverton-Hillsdale & 50th,377,E,NS,16,3,19,0,Spring2019
301,SW Beaverton-Hillsdale & 50th,378,W,OP,3,12,15,0,Spring2019
302,SW Beaverton-Hillsdale & 56th,379,E,OP,31,12,43,3,Spring2019
303,SW Beaverton-Hillsdale & 56th,380,W,FS,12,35,47,6,Spring2019
304,SW Beaverton-Hillsdale & 59th,381,W,NS,14,38,52,71,Spring2019
305,SW Beaverton-Hillsdale & 62nd,382,E,FS,46,25,71,40,Spring2019
306,6500 Block SW Beaverton-Hillsdale,383,E,AT,24,15,39,7,Spring2019
307,SW Beaverton-Hillsdale & 65th,384,W,OP,22,41,63,6,Spring2019
308,SW Beaverton-Hillsdale & 78th,385,W,NS,45,31,76,9,Spring2019
309,SW Beaverton-Hillsdale & 78th,386,E,NS,18,27,45,1,Spring2019
310,SW Beaverton-Hillsdale & 91st,387,W,FS,22,25,47,23,Spring2019
311,SW Beaverton-Hillsdale & 91st,388,E,OP,25,15,40,18,Spring2019
318,SW Beaverton-Hillsdale & 99th,389,W,NS,11,10,21,2,Spring2019
319,SW Beaverton-Hillsdale & 99th,390,E,OP,8,7,15,6,Spring2019
320,SE Bell & Our Ct ,394,N,NS,9,13,22,36,Spring2019
321,SE Bell & Johnson Creek,395,N,NS,17,13,30,2,Spring2019
322,SE Bell & Johnson Creek,396,S,FS,13,22,35,1,Spring2019
323,SE Bell & Pierce ,397,N,NS,5,6,11,1,Spring2019
324,SE Bell & Jordan ,398,S,NS,5,7,12,0,Spring2019
325,SE Belmont & 11th,400,E,FS,134,156,290,61,Spring2019
326,SE Belmont & 14th,402,E,NS,36,78,114,32,Spring2019
327,SE Belmont & 17th,404,E,NS,17,64,81,14,Spring2019
328,SE Belmont & 20th,406,E,NS,33,115,148,5,Spring2019
329,SE Belmont & 23rd,408,E,NS,15,45,60,4,Spring2019
330,SE Belmont & 26th,410,W,NS,127,63,190,36,Spring2019
331,SE Belmont & 30th,417,W,FS,185,45,230,21,Spring2019
332,SE Belmont & 30th,418,E,FS,52,156,208,28,Spring2019
333,SE Belmont & 34th,422,E,FS,62,199,261,41,Spring2019
334,SE Belmont & 34th,423,W,FS,198,58,256,52,Spring2019
335,SE Belmont & 37th,425,E,FS,14,67,81,20,Spring2019
336,SE Belmont & 38th,426,W,FS,74,16,90,26,Spring2019
337,SE Belmont & Cesar Chavez Blvd,427,E,FS,99,177,276,76,Spring2019
338,SE Belmont & Cesar Chavez Blvd,428,W,NS,155,77,232,54,Spring2019
339,SE Belmont & 42nd,429,E,NS,17,84,101,4,Spring2019
340,SE Belmont & 42nd,430,W,FS,114,25,139,16,Spring2019
341,SE Belmont & 46th,435,W,NS,102,32,134,43,Spring2019
342,SE Belmont & 46th,436,E,OP,38,106,144,53,Spring2019
343,SE Belmont & 49th,439,E,NS,14,32,46,13,Spring2019
344,SE Belmont & 49th,440,W,NS,48,13,61,12,Spring2019
345,SE Belmont & 50th,442,E,FS,6,21,27,1,Spring2019
346,SE Belmont & 53rd,443,E,FS,5,28,33,2,Spring2019
347,SE Belmont & 53rd,444,W,NS,30,4,34,4,Spring2019
348,SE Belmont & 55th,445,E,NS,5,27,32,9,Spring2019
349,SE Belmont & 55th,446,W,NS,22,6,28,3,Spring2019
350,SE Belmont & 58th,448,E,OP,3,17,20,8,Spring2019
351,SE Belmont & 58th,449,W,NS,17,3,20,14,Spring2019
352,SE Belmont & 60th,450,E,FS,51,132,183,33,Spring2019
353,SE Belmont & 60th,451,W,NS,106,34,140,32,Spring2019
354,SE Belmont & 62nd,453,E,OP,2,3,5,1,Spring2019
355,SE Belmont & 62nd,454,W,FS,6,6,12,2,Spring2019
356,SE Belmont & 65th,456,E,OP,0,3,3,0,Spring2019
357,SE Belmont & 65th,457,W,NS,3,0,3,0,Spring2019
358,SE Belmont & 67th,459,E,NS,2,11,13,0,Spring2019
359,SE Belmont & 68th,460,W,NS,27,4,31,0,Spring2019
360,SE Belmont & 9th,465,E,NS,60,92,152,22,Spring2019
361,1400 Block SW Bertha ,467,E,AT,1,1,2,0,Spring2019
362,SW Binford Lake & Heiney,469,W,NS,1,4,5,0,Spring2019
363,SW Binford Lake & Towle,470,E,NS,7,2,9,0,Spring2019
364,SW Binford Lake & Towle,471,W,FS,0,4,4,0,Spring2019
371,11200 Block SW Boones Ferry Rd,492,N,AT,1,1,2,0,Spring2019
372,18200 Block SW Boones Ferry Rd,495,S,AT,3,24,27,1,Spring2019
373,18400 Block SW Boones Ferry Rd,496,N,AT,36,6,42,5,Spring2019
374,SW Boones Ferry Rd & Alsea,500,S,NS,0,7,7,2,Spring2019
375,SW Boones Ferry Rd & Apache,501,S,NS,0,5,5,0,Spring2019
376,SW Boones Ferry Rd & Apache,502,N,OP,1,0,1,0,Spring2019
377,SW Boones Ferry Rd & Arapaho,503,N,NS,3,0,3,0,Spring2019
378,SW Boones Ferry Rd & Arnold,506,S,FS,0,2,2,0,Spring2019
379,SW Boones Ferry Rd & Arnold,507,N,OP,1,0,1,0,Spring2019
380,SW Boones Ferry Rd & Blake,510,N,NS,9,0,9,3,Spring2019
381,Boones Ferry Rd & Bryant,512,N,FS,2,4,6,0,Spring2019
382,SW Lower Boones Ferry & Childs Rd,513,E,FS,4,2,6,0,Spring2019
383,SW Lower Boones Ferry & Childs Rd,514,W,OP,1,5,6,1,Spring2019
384,SW Boones Ferry Rd & Clara Ln,515,W,FS,0,2,2,0,Spring2019
385,SW Boones Ferry Rd & Colony Dr,516,S,OP,0,1,1,0,Spring2019
386,SW Boones Ferry Rd & Colony Dr,517,N,FS,2,0,2,0,Spring2019
387,SW Boones Ferry Rd & Coronado,520,S,FS,0,1,1,0,Spring2019
388,SW Boones Ferry Rd & Day,521,N,OP,2,0,2,0,Spring2019
389,SW Boones Ferry Rd & Day,522,S,FS,0,3,3,0,Spring2019
390,Boones Ferry Rd & Firwood,529,S,NS,3,3,6,0,Spring2019
391,SW Boones Ferry Rd & Ibach,530,S,FS,1,11,12,0,Spring2019
392,SW Boones Ferry Rd & Ibach,531,N,NS,7,0,7,0,Spring2019
393,SW Boones Ferry Rd & Greenhill Ln,533,S,OP,0,0,0,0,Spring2019
394,SW Boones Ferry Rd & Greenhill Ln,534,N,NS,0,0,0,0,Spring2019
395,SW Boones Ferry Rd & Killarney,535,S,NS,0,3,3,0,Spring2019
396,Boones Ferry Rd & Kruse Way Pl,536,S,FS,1,3,4,1,Spring2019
397,18000 Block SW Lower Boones Ferry,537,E,AT,19,2,21,2,Spring2019
398,Boones Ferry Rd & SW Madrona,538,N,OP,1,1,2,0,Spring2019
399,Boones Ferry Rd & SW Madrona,539,S,NS,1,1,2,0,Spring2019
400,SW Boones Ferry Rd & Norwood,542,S,OP,0,4,4,0,Spring2019
401,SW Boones Ferry Rd & Norwood,543,N,NS,4,0,4,0,Spring2019
402,SW Boones Ferry Rd & Palatine,545,N,FS,1,0,1,0,Spring2019
403,Boones Ferry Rd & Rainbow,553,S,OP,0,3,3,0,Spring2019
404,Boones Ferry Rd & Rainbow,554,N,FS,1,0,1,0,Spring2019
405,18000 Block SW Lower Boones Ferry,558,W,AT,3,20,23,3,Spring2019
406,SW Boones Ferry Rd & Siletz,562,N,NS,3,0,3,0,Spring2019
407,SW Boones Ferry Rd & Siletz,563,S,NS,0,3,3,0,Spring2019
408,Boones Ferry Rd & Spring Lane,564,N,NS,9,2,11,0,Spring2019
409,SW Boones Ferry Rd & Stephenson,565,N,FS,3,0,3,0,Spring2019
410,SW Boones Ferry Rd & Stephenson,566,W,FS,0,4,4,0,Spring2019
411,Boones Ferry Rd & Twin Fir,568,S,OP,1,4,5,0,Spring2019
412,Boones Ferry Rd & Twin Fir,569,N,FS,3,0,3,0,Spring2019
413,SW Lower Boones Ferry & Boones Ferry,570,E,FS,2,1,3,0,Spring2019
414,Boones Ferry Rd & West Sunset Dr,576,S,NS,0,0,0,0,Spring2019
415,Boones Ferry Rd & West Sunset Dr,577,N,OP,1,0,1,0,Spring2019
416,SW Boones Ferry Rd & 19th,580,E,FS,1,0,1,0,Spring2019
417,SW Boones Ferry Rd & 22nd,581,S,OP,0,4,4,0,Spring2019
424,SW Boones Ferry Rd & 4th,583,W,OP,0,1,1,0,Spring2019
425,SW Boones Ferry Rd & 4th,584,E,FS,0,0,0,0,Spring2019
426,SW Laurelwood & Brentwood,593,N,NS,0,0,0,0,Spring2019
427,SW Brentwood & 78th,595,E,NS,2,0,2,0,Spring2019
428,NW Bridge Ave & St Helens,596,N,NS,0,3,3,0,Spring2019
429,NW Bridge Ave & Germantown,597,N,OP,0,0,0,0,Spring2019
430,NW Bridge Ave & Germantown,598,S,NS,0,0,0,0,Spring2019
431,NW Bridge Ave & Springville,599,N,OP,0,2,2,0,Spring2019
432,NW Bridge Ave & Springville,600,S,NS,4,0,4,0,Spring2019
433,NE Broadway & Grand,605,W,NS,6,23,29,18,Spring2019
434,SW Broadway & Hall,607,S,FS,7,8,15,1,Spring2019
435,N Broadway & Benton,611,E,FS,8,18,26,4,Spring2019
436,SW Broadway & Lincoln,614,S,NS,1,2,3,0,Spring2019
437,SW Broadway & Market,616,S,FS,3,18,21,0,Spring2019
438,NE Broadway & M L King,622,W,FS,40,20,60,44,Spring2019
439,NW Broadway & Irving,625,N,NS,81,71,152,73,Spring2019
440,N Broadway & Vancouver,627,W,NS,21,29,50,15,Spring2019
441,NE Broadway & 12th,629,W,NS,176,110,286,237,Spring2019
442,NE Broadway & 16th,631,W,FS,103,66,169,33,Spring2019
443,NE Broadway & 2nd,633,W,NS,14,9,23,41,Spring2019
444,NE Broadway & 21st,634,W,FS,127,33,160,37,Spring2019
445,NE Broadway & 24th,635,W,FS,112,56,168,42,Spring2019
446,NE Broadway & 26th,636,E,FS,16,30,46,24,Spring2019
447,NE Broadway & 26th,637,W,FS,29,14,43,21,Spring2019
448,NE Broadway & 28th,638,E,FS,54,75,129,63,Spring2019
449,NE Broadway & 28th,639,W,NS,76,61,137,41,Spring2019
450,NE Broadway & 32nd,642,E,FS,70,72,142,44,Spring2019
451,NE Broadway & 33rd,644,W,FS,73,66,139,39,Spring2019
452,NE Broadway & 35th,646,E,FS,5,10,15,4,Spring2019
453,NE Broadway & 35th,647,W,NS,5,2,7,3,Spring2019
454,NE Broadway & 37th,648,E,NS,6,24,30,16,Spring2019
455,NE Broadway & 37th,649,W,NS,20,5,25,5,Spring2019
456,NE Broadway & 44th,650,W,NS,39,28,67,76,Spring2019
457,NE Broadway & 44th,651,E,FS,29,43,72,104,Spring2019
458,NE Broadway & 47th,653,E,NS,5,10,15,1,Spring2019
459,SW Broadway & 5th,654,W,NS,13,135,148,10,Spring2019
460,NE Broadway & 7th,655,W,NS,30,10,40,15,Spring2019
461,NE Broadway & 9th,656,W,NS,49,15,64,55,Spring2019
462,Bryant & Black Forest Ct,663,N,OP,0,0,0,0,Spring2019
463,Bryant & Chapman Way,664,N,FS,0,0,0,0,Spring2019
464,Bryant & Lakeview,665,N,NS,4,1,5,0,Spring2019
465,17500 Block Bryant,667,S,AT,0,1,1,0,Spring2019
466,Bryant & Lords Ln,668,N,NS,0,0,0,0,Spring2019
467,Bryant & Wildwood,669,S,FS,0,0,0,0,Spring2019
468,Kerr & Jefferson Pkwy,672,S,NS,4,7,11,0,Spring2019
469,4600 Block W Burnside,682,W,AT,0,2,2,0,Spring2019
470,W Burnside & SW Fischer Ln,685,E,NS,2,0,2,0,Spring2019
477,W Burnside & NW Barnes,686,N,OP,11,1,12,2,Spring2019
478,W Burnside & NW Barnes,687,W,FS,2,16,18,2,Spring2019
479,W Burnside & Mt. Calvary Cemetery,690,E,AT,5,1,6,1,Spring2019
480,W Burnside & Mt Calvary Cemetery,691,W,AT,1,9,10,1,Spring2019
481,9100 Block E Burnside,696,E,OP,11,17,28,2,Spring2019
482,9100 Block E Burnside,697,W,AT,17,12,29,5,Spring2019
483,E Burnside & SE Floral,701,E,NS,3,10,13,0,Spring2019
484,E Burnside & NE Floral,702,W,NS,7,4,11,1,Spring2019
485,E Burnside & NE Grand,704,E,NS,340,391,731,145,Spring2019
486,W Burnside & NW Hermosa,706,E,OP,2,0,2,0,Spring2019
487,W Burnside & NW Hermosa,707,W,FS,1,3,4,0,Spring2019
488,E Burnside & SE Laurelhurst,710,E,NS,2,5,7,1,Spring2019
489,E Burnside & NE Laurelhurst,711,W,NS,5,2,7,1,Spring2019
490,W Burnside & SW Tichner,712,E,FS,13,2,15,0,Spring2019
491,W Burnside & NW Macleay,713,W,FS,1,14,15,1,Spring2019
492,W Burnside & SW 8th,715,E,NS,65,84,149,54,Spring2019
493,W Burnside & NW Park,716,W,NS,124,79,203,83,Spring2019
494,W Burnside & SW St Clair,718,E,NS,303,107,410,61,Spring2019
495,W Burnside & SW 13th,723,E,NS,147,80,227,89,Spring2019
496,W Burnside & SW 15th,725,E,NS,98,18,116,26,Spring2019
497,E Burnside & SE 16th,726,E,FS,32,59,91,13,Spring2019
498,E Burnside & NE 18th,730,W,NS,31,18,49,13,Spring2019
499,W Burnside & NW 19th,735,W,NS,69,118,187,44,Spring2019
500,E Burnside & SE 20th,740,E,NS,57,117,174,33,Spring2019
501,W Burnside & NW 20th Pl,742,W,NS,202,409,611,216,Spring2019
502,W Burnside & NW King,747,W,NS,41,119,160,40,Spring2019
503,W Burnside & NW 23rd,755,W,NS,76,325,401,86,Spring2019
504,E Burnside & SE 24th,759,E,FS,56,87,143,5,Spring2019
505,E Burnside & NE 24th,760,W,FS,91,35,126,5,Spring2019
506,E Burnside & SE 28th,763,E,NS,107,157,264,18,Spring2019
507,E Burnside & NE 28th,764,W,FS,164,94,258,18,Spring2019
508,E Burnside & NE 32nd,768,W,FS,47,24,71,5,Spring2019
509,E Burnside & SE 32nd,769,E,NS,25,59,84,8,Spring2019
510,E Burnside & SE Cesar Chavez Blvd,770,E,NS,88,115,203,37,Spring2019
511,E Burnside & NE Cesar Chavez Blvd,771,W,NS,87,98,185,41,Spring2019
512,E Burnside & SE 41st,774,E,NS,4,12,16,1,Spring2019
513,E Burnside & NE 41st,775,W,NS,5,4,9,0,Spring2019
514,E Burnside & SE 44th,776,E,NS,5,12,17,1,Spring2019
515,E Burnside & NE 44th,777,W,NS,13,3,16,1,Spring2019
516,E Burnside & NE 47th,778,W,NS,33,19,52,15,Spring2019
517,E Burnside & SE 47th,779,E,FS,16,37,53,15,Spring2019
518,W Burnside & NW 48th Ave,780,W,NS,0,4,4,0,Spring2019
519,W Burnside & SW 48th Dr,781,E,FS,3,0,3,0,Spring2019
520,W Burnside & NW 5th,782,W,FS,363,360,723,155,Spring2019
521,E Burnside & NE 52nd,785,W,NS,53,12,65,6,Spring2019
522,E Burnside & SE 52nd,786,E,FS,13,46,59,3,Spring2019
523,E Burnside & SE 55th,787,E,FS,30,57,87,39,Spring2019
530,E Burnside & NE 55th,788,W,NS,47,23,70,25,Spring2019
531,E Burnside & NE 58th,791,W,NS,21,3,24,4,Spring2019
532,W Burnside & SW 6th,792,E,NS,751,448,1199,294,Spring2019
533,E Burnside & SE 60th,793,E,NS,48,76,124,26,Spring2019
534,E Burnside & NE 60th,794,W,NS,78,49,127,14,Spring2019
535,E Burnside & NE 62nd,796,W,NS,11,4,15,1,Spring2019
536,E Burnside & SE 67th,799,E,OP,4,13,17,1,Spring2019
537,E Burnside & NE 67th,800,W,NS,11,7,18,1,Spring2019
538,E Burnside & NE 69th,801,W,NS,10,4,14,0,Spring2019
539,E Burnside & SE 72nd,806,E,NS,4,19,23,1,Spring2019
540,E Burnside & NE 72nd,807,W,NS,19,5,24,3,Spring2019
541,E Burnside & SE 74th,808,E,NS,7,21,28,1,Spring2019
542,E Burnside & NE 74th,809,W,NS,23,11,34,2,Spring2019
543,E Burnside & NE 79th,811,W,NS,49,14,63,8,Spring2019
544,E Burnside & SE 79th,812,E,NS,12,35,47,3,Spring2019
545,E Burnside & SE 82nd,813,E,NS,234,157,391,72,Spring2019
546,E Burnside & NE 82nd,814,W,NS,129,249,378,91,Spring2019
547,E Burnside & SE 87th,817,E,NS,8,22,30,4,Spring2019
548,E Burnside & NE 87th,818,W,NS,15,6,21,4,Spring2019
549,E Burnside & SE 8th,820,E,NS,115,163,278,25,Spring2019
550,E Burnside & SE 94th,822,E,FS,7,10,17,5,Spring2019
551,E Burnside & NE 94th,823,W,NS,10,11,21,4,Spring2019
552,S Buxton & SW Cherry Park,830,N,FS,0,2,2,0,Spring2019
553,S Buxton & SW Cherry Park,831,S,NS,3,0,3,1,Spring2019
554,Buxton & E Columbia River Hwy,832,N,NS,3,12,15,2,Spring2019
555,S Buxton & SW Martine,833,S,NS,1,0,1,0,Spring2019
556,S Buxton & SE 6th,836,N,NS,1,0,1,0,Spring2019
557,S Buxton & SE 8th,837,N,NS,1,0,1,0,Spring2019
558,SE Bybee & Milwaukie,838,W,NS,99,66,165,22,Spring2019
559,SE Bybee & Milwaukie,839,E,NS,11,21,32,3,Spring2019
560,SE Bybee & 14th,843,W,NS,1,2,3,1,Spring2019
561,SE Bybee & 14th,844,E,FS,2,2,4,0,Spring2019
562,SE Bybee & 17th,845,E,NS,64,62,126,21,Spring2019
563,SE Bybee & 22nd,852,E,FS,7,12,19,12,Spring2019
564,SE Bybee & 22nd,853,W,NS,11,4,15,15,Spring2019
565,SE Bybee & 23rd,855,W,NS,2,8,10,24,Spring2019
566,SE Bybee & 27th,858,E,FS,3,6,9,1,Spring2019
567,2400 Block SE Bybee,859,W,AT,2,3,5,0,Spring2019
568,SE Bybee & 28th,860,S,NS,0,1,1,0,Spring2019
569,4600 Block SW Cameron,861,E,AT,2,1,3,0,Spring2019
570,SW Cameron & Fairvale Ct,862,E,NS,3,4,7,0,Spring2019
571,SW Cameron & Shattuck,863,E,FS,4,4,8,0,Spring2019
572,SW Cameron & 53rd,865,E,NS,7,5,12,0,Spring2019
573,SW Campus Dr & OHSU Garage F,868,E,OP,29,9,38,4,Spring2019
574,SW Campus Dr & Terwilliger,870,E,NS,31,3,34,2,Spring2019
575,SW Campus Dr & Loading Dock 5,871,W,AT,109,8,117,1,Spring2019
576,7500 Block SW Canyon,882,W,AT,1,8,9,0,Spring2019
583,SW Canyon & Canyon Dr,883,W,OP,1,29,30,0,Spring2019
584,SW Canyon & Benz Park,885,W,NS,1,3,4,0,Spring2019
585,SW Canyon & Copel,890,W,NS,1,5,6,0,Spring2019
586,SW Canyon & Jade,892,N,FS,4,1,5,0,Spring2019
587,SW Canyon & Linden,893,E,OP,2,1,3,0,Spring2019
588,Hwy 26 On Ramp & SW Skyline,894,E,FS,49,13,62,8,Spring2019
589,Hwy 26/Canyon Rd Ramp & SW Skyline,895,W,FS,14,50,64,7,Spring2019
590,SW Canyon & Walker,898,W,FS,20,23,43,3,Spring2019
591,SW Canyon & Walker,899,E,OP,14,27,41,7,Spring2019
592,SW Canyon & 104th,904,W,NS,11,11,22,2,Spring2019
593,SW Canyon & 107th,906,E,NS,33,25,58,8,Spring2019
594,SW Canyon & 107th,907,W,NS,22,29,51,5,Spring2019
595,SW Canyon & 110th,908,E,NS,9,8,17,3,Spring2019
596,SW Canyon & 110th,909,W,FS,8,9,17,2,Spring2019
597,SW Canyon & 115th,910,W,NS,5,23,28,7,Spring2019
598,SW Canyon & 73rd,912,E,NS,5,0,5,0,Spring2019
599,SW Canyon & 87th,913,E,FS,58,23,81,2,Spring2019
600,SW Canyon & 87th,914,W,FS,21,23,44,0,Spring2019
601,SW Canyon & 91st,915,E,NS,9,8,17,1,Spring2019
602,SW Canyon & 93rd,917,W,OP,2,2,4,0,Spring2019
603,SW Canyon & 93rd,918,E,NS,2,2,4,0,Spring2019
604,SW Canyon & 96th,919,W,OP,1,2,3,0,Spring2019
605,SW Canyon & 96th,920,E,NS,4,1,5,0,Spring2019
606,SW Capitol & Alice,921,S,NS,2,10,12,0,Spring2019
607,SW Capitol & Alice,922,N,NS,9,2,11,0,Spring2019
608,SW Capitol & Barbur,923,N,NS,73,35,108,8,Spring2019
609,SW Capitol & Bertha Ct,925,E,FS,115,104,219,34,Spring2019
610,9500 Block SW Capitol,926,S,OP,2,11,13,1,Spring2019
611,SW Capitol & Carson,927,S,NS,3,11,14,2,Spring2019
612,SW Capitol & Sunset,929,E,OP,305,374,679,19,Spring2019
613,SW Capitol & Taylors Ferry,930,S,NS,9,50,59,21,Spring2019
614,SW Capitol & Dickinson,931,S,FS,2,27,29,5,Spring2019
615,SW Capitol & Dickinson,932,N,NS,29,3,32,2,Spring2019
616,SW Capitol & Dolph,933,S,OP,2,13,15,0,Spring2019
617,SW Capitol & Dolph,934,N,FS,13,2,15,0,Spring2019
618,SW Capitol & Florida,935,S,FS,6,28,34,4,Spring2019
619,SW Capitol & Galeburn,936,S,OP,9,57,66,1,Spring2019
620,SW Capitol & Galeburn,937,N,NS,40,8,48,1,Spring2019
621,SW Capitol & Garden Home,939,N,OP,22,8,30,0,Spring2019
622,SW Capitol & Idaho,942,N,NS,34,3,37,0,Spring2019
623,SW Capitol & Idaho,943,W,FS,4,27,31,0,Spring2019
624,SW Capitol & Marigold,946,N,FS,16,2,18,0,Spring2019
625,SW Capitol & Marigold,947,S,FS,2,10,12,0,Spring2019
626,SW Capitol & Miles,948,N,NS,30,5,35,0,Spring2019
627,SW Capitol & Miles,949,S,FS,3,36,39,1,Spring2019
628,SW Capitol & Pomona,951,S,FS,2,42,44,1,Spring2019
629,SW Capitol & Pomona,952,N,NS,41,4,45,5,Spring2019
636,SW Capitol & Sunset,955,W,NS,369,337,706,17,Spring2019
637,SW Capitol & Terwilliger,956,E,NS,15,17,32,1,Spring2019
638,SW Capitol & Terwilliger,957,W,FS,13,17,30,1,Spring2019
639,SW Capitol & Texas,958,S,FS,2,11,13,2,Spring2019
640,SW Capitol & California,959,N,NS,15,10,25,2,Spring2019
641,SW Capitol & Nebraska,963,E,FS,23,5,28,1,Spring2019
642,SW Capitol & Nebraska,964,W,OP,18,33,51,7,Spring2019
643,SW Capitol & 26th,965,E,FS,104,24,128,6,Spring2019
644,SW Capitol & 26th,966,W,FS,32,117,149,15,Spring2019
645,SW Capitol & 33rd,970,W,NS,18,99,117,6,Spring2019
646,SW Capitol & 33rd,971,E,OP,98,14,112,6,Spring2019
647,SW Capitol & 35th,972,E,NS,119,42,161,21,Spring2019
648,SW Capitol & Brugger,975,E,NS,10,2,12,0,Spring2019
649,8600 Block SE Causey,984,W,AT,21,11,32,6,Spring2019
650,8800 Block SE Causey,987,E,OP,8,16,24,5,Spring2019
651,SE Causey & 82nd,989,W,NS,14,10,24,6,Spring2019
652,SW Cedar Hills & Butner,993,S,FS,14,20,34,1,Spring2019
653,3300 Block SW Cedar Hills,995,N,AT,6,16,22,7,Spring2019
654,SW Cedar Hills & Butner,996,N,NS,4,4,8,0,Spring2019
655,SW Cedar Hills & Fairfield,1002,N,NS,37,77,114,52,Spring2019
656,SW Cedar Hills & Fairfield,1003,S,OP,102,38,140,53,Spring2019
657,SW Cedar Hills & Huntington,1010,E,OP,6,6,12,10,Spring2019
658,SW Cedar Hills & Huntington,1011,W,NS,5,8,13,14,Spring2019
659,SW Cedar Hills & Jenkins,1013,N,NS,14,43,57,19,Spring2019
660,SW Cedar Hills & Jenkins,1014,S,FS,18,26,44,15,Spring2019
661,SW Cedar Hills & Lynnridge,1017,E,FS,3,2,5,0,Spring2019
662,SW Cedar Hills & Lynnridge,1018,W,FS,1,2,3,0,Spring2019
663,SW Cedar Hills & Park Way,1019,N,NS,15,15,30,5,Spring2019
664,SW Cedar Hills & Park Way,1020,S,FS,19,8,27,6,Spring2019
665,SW Cedar Hills & Walker,1021,N,NS,22,42,64,18,Spring2019
666,SW Cedar Hills & Walker,1022,S,FS,40,34,74,21,Spring2019
667,Jantzen Beach Main Stop,1026,S,OP,321,344,665,136,Spring2019
668,SW Center & 125th,1034,E,FS,13,18,31,4,Spring2019
669,SW Center & 125th,1035,W,FS,19,20,39,4,Spring2019
670,N Channel Ave & Anchor,1041,E,FS,33,30,63,3,Spring2019
671,N Channel Ave & Ballast,1042,E,OP,0,0,0,0,Spring2019
672,N Channel Ave & Commerce,1043,S,OP,0,1,1,0,Spring2019
673,N Channel Ave & Dolphin,1044,S,OP,1,0,1,0,Spring2019
674,N Chautauqua & Washburne,1045,N,NS,2,5,7,0,Spring2019
675,N Chautauqua & Washburne,1046,S,OP,4,1,5,1,Spring2019
676,N Chautauqua & Alaska,1047,N,NS,11,33,44,12,Spring2019
677,N Chautauqua & Willis,1050,S,NS,11,9,20,3,Spring2019
678,SW Chestnut & Bertha,1051,W,NS,7,1,8,0,Spring2019
679,SW Chestnut & 12th,1053,S,NS,1,1,2,0,Spring2019
680,SW Chestnut & 14th,1056,N,NS,3,2,5,0,Spring2019
681,Clackamas Community College,1068,N,AT,278,273,551,79,Spring2019
682,SE Clinton & 21st,1092,W,NS,12,11,23,0,Spring2019
689,SE Clinton & 23rd,1093,E,NS,3,3,6,1,Spring2019
690,SE Clinton & 23rd,1094,W,FS,5,2,7,0,Spring2019
691,SE Clinton & 26th,1095,E,NS,28,12,40,0,Spring2019
692,Rose Quarter Transit Center,1097,N,AT,874,111,985,138,Spring2019
693,3500 Block NE Columbia Blvd,1099,W,AT,2,8,10,0,Spring2019
694,3500 Block NE Columbia Blvd,1100,E,OP,3,2,5,0,Spring2019
695,3800 Block NE Columbia Blvd,1101,W,AT,4,6,10,0,Spring2019
696,3800 Block NE Columbia Blvd,1102,E,AT,7,4,11,0,Spring2019
697,SW Columbia & Park Ave,1108,E,NS,149,98,247,8,Spring2019
698,SW Columbia & 12th,1111,E,NS,91,68,159,107,Spring2019
699,SW 18th & Goose Hollow MAX Station,1114,E,AT,390,202,592,94,Spring2019
700,NE Columbia Blvd & 27th,1115,W,OP,0,2,2,0,Spring2019
701,NE Columbia Blvd & 42nd,1116,W,FS,1,6,7,0,Spring2019
702,NE Columbia Blvd & 42nd,1117,E,FS,6,1,7,0,Spring2019
703,NE Columbia Blvd & 47th,1118,E,NS,45,21,66,2,Spring2019
704,SW Commercial & Hall,1122,N,FS,2,10,12,0,Spring2019
705,SW Commercial & Hall,1123,S,NS,6,6,12,0,Spring2019
706,SW Corbett & Abernethy,1125,S,NS,0,1,1,0,Spring2019
707,SW Corbett & Abernethy,1126,N,NS,0,0,0,0,Spring2019
708,SW Corbett & Bancroft,1127,S,NS,0,1,1,0,Spring2019
709,SW Corbett & Bancroft,1128,N,NS,0,1,1,0,Spring2019
710,SW Corbett & Boundary St,1129,N,NS,6,2,8,0,Spring2019
711,SW Corbett & Carolina,1130,N,NS,2,0,2,0,Spring2019
712,SW Corbett & Carolina,1131,S,NS,0,2,2,0,Spring2019
713,SW Corbett & Curry,1132,S,NS,1,1,2,0,Spring2019
714,SW Corbett & Curry,1133,N,NS,1,1,2,0,Spring2019
715,SW Corbett & Flower,1134,S,NS,0,1,1,0,Spring2019
716,SW Corbett & Flower,1135,N,NS,2,0,2,0,Spring2019
717,SW Corbett & Gaines,1136,N,NS,4,1,5,0,Spring2019
718,SW Corbett & Gaines,1137,S,NS,2,4,6,0,Spring2019
719,SW Corbett & Gibbs,1138,S,NS,9,1,10,0,Spring2019
720,SW Corbett & Gibbs,1139,N,NS,2,13,15,0,Spring2019
721,SW Corbett & Hamilton,1140,S,NS,3,2,5,0,Spring2019
722,SW Corbett & Hamilton,1141,N,NS,1,4,5,0,Spring2019
723,SW Corbett & Mitchell,1146,N,FS,1,0,1,0,Spring2019
724,SW Corbett & Mitchell,1147,S,NS,1,4,5,3,Spring2019
725,SW Corbett & Nebraska,1148,S,OP,0,2,2,0,Spring2019
726,SW Corbett & Pendleton,1149,N,NS,4,1,5,0,Spring2019
727,SW Corbett & Pendleton,1150,S,NS,1,2,3,0,Spring2019
728,SW Corbett & Richardson,1151,S,FS,1,2,3,0,Spring2019
729,SW Corbett & Richardson,1152,N,NS,3,0,3,0,Spring2019
730,SW Corbett & Sweeney,1155,S,OP,2,2,4,0,Spring2019
731,NE Evergreen Pkwy & Cornelius Pass Rd,1158,W,FS,6,1,7,0,Spring2019
732,NE Evergreen Pkwy & 106th (NW 188th),1159,W,NS,28,15,43,4,Spring2019
733,12200 Block NW Cornell,1160,E,AT,12,6,18,9,Spring2019
734,12200 Block NW Cornell,1161,W,OP,2,9,11,5,Spring2019
735,12900 Block NW Cornell,1162,W,AT,8,7,15,0,Spring2019
742,NW Cornell & Dale,1163,E,NS,24,11,35,41,Spring2019
743,13900 Block NW Cornell,1165,W,AT,2,2,4,0,Spring2019
744,14100 Block NW Cornell,1166,E,OP,0,0,0,0,Spring2019
745,14100 Block NW Cornell,1167,W,AT,3,8,11,0,Spring2019
746,NW Cornell & Barnes,1171,E,NS,13,17,30,2,Spring2019
747,NW Cornell & Dale,1172,W,NS,12,12,24,7,Spring2019
748,NW Cornell & Murray,1174,W,FS,33,31,64,28,Spring2019
749,NW Cornell & Saltzman,1182,W,FS,45,49,94,18,Spring2019
750,NW Cornell & Saltzman,1183,E,NS,41,32,73,17,Spring2019
751,NW Cornell & Science Park Dr,1184,W,OP,8,32,40,0,Spring2019
752,13800 Block NW Cornell (Sunset HS),1186,E,AT,2,4,6,0,Spring2019
753,NW Cornell & Trail,1187,W,FS,14,20,34,6,Spring2019
754,NW Cornell & Trail,1188,E,OP,21,11,32,9,Spring2019
755,14600 Block NW Cornell,1189,E,AT,30,14,44,0,Spring2019
756,NW Cornell & Cornell Woods,1190,W,OP,12,19,31,0,Spring2019
757,NW Cornell & 110th,1194,E,FS,1,0,1,0,Spring2019
758,NW Cornell & 110th,1195,W,NS,0,0,0,0,Spring2019
759,NW Cornell & Cedar Hills Blvd,1196,E,NS,6,3,9,0,Spring2019
760,NW Cornell & 113th,1199,W,FS,3,8,11,2,Spring2019
761,NW Cornell & 119th,1200,E,OP,9,3,12,0,Spring2019
762,NW Cornell & 119th,1201,W,NS,6,9,15,1,Spring2019
763,NW Cornell & 123rd,1203,W,FS,3,12,15,3,Spring2019
764,NW Cornell & 143rd,1204,E,OP,31,10,41,1,Spring2019
765,NW Cornell & 153rd,1205,E,FS,9,8,17,3,Spring2019
766,4100 Block SW Council Crest,1207,E,AT,0,1,1,0,Spring2019
767,SW Council Crest & Chehalem,1211,N,FS,1,0,1,0,Spring2019
768,SW Council Crest & Chehalem,1212,E,NS,1,2,3,0,Spring2019
769,SW Council Crest & Chehalem,1213,W,OP,2,0,2,0,Spring2019
770,SW Council Crest & Chehalem (south leg),1214,S,NS,1,0,1,0,Spring2019
771,SW Council Crest & Greenway,1215,E,FS,1,2,3,0,Spring2019
772,SW Council Crest & Tualatin,1217,S,OP,0,1,1,0,Spring2019
773,SW Council Crest & Tualatin,1218,W,NS,2,1,3,0,Spring2019
774,700 Block Country Club,1219,W,AT,0,0,0,0,Spring2019
775,Country Club & Boones Ferry Rd,1220,W,NS,1,2,3,0,Spring2019
776,Country Club & Iron Mtn,1221,W,FS,2,1,3,0,Spring2019
777,Country Club & Iron Mtn,1222,E,NS,0,2,2,0,Spring2019
778,Country Club & Knaus Rd,1223,W,NS,1,1,2,0,Spring2019
779,Country Club & Knaus Rd,1224,E,OP,0,0,0,0,Spring2019
780,2500 Block Country Club,1225,E,AT,12,13,25,0,Spring2019
781,Country Club & Hazel Road,1226,W,FS,15,14,29,0,Spring2019
782,Country Club & Redwood,1227,W,NS,0,0,0,0,Spring2019
783,Country Club & Bridge,1228,E,NS,0,0,0,0,Spring2019
784,Country Club & Sundeleaf,1229,W,OP,1,0,1,0,Spring2019
785,Country Club & Sundeleaf,1230,E,NS,0,3,3,0,Spring2019
786,Country Club & Uplands,1231,W,OP,0,0,0,0,Spring2019
787,Country Club & Uplands,1232,E,NS,0,0,0,0,Spring2019
788,Country Club & Wembley Park,1233,W,OP,0,0,0,0,Spring2019
795,Country Club & Wembley Park,1234,E,NS,0,0,0,0,Spring2019
796,NE Cully & Shaver,1239,S,FS,5,1,6,0,Spring2019
797,NE Cully & Prescott,1240,N,NS,38,102,140,60,Spring2019
798,NE Cully & Prescott,1241,S,FS,118,40,158,53,Spring2019
799,NE Cully & Killingsworth,1243,N,FS,14,7,21,1,Spring2019
800,NE Cully & Mason,1244,N,FS,7,29,36,7,Spring2019
801,NE Cully & Mason,1245,S,NS,16,6,22,1,Spring2019
802,SE Currin & Hwy 211-224,1252,S,NS,0,0,0,0,Spring2019
803,E Dartmouth & Cornell,1255,E,NS,3,1,4,0,Spring2019
804,E Dartmouth & Cornell,1256,W,NS,1,4,5,1,Spring2019
805,E Dartmouth & Harvard,1257,E,NS,3,2,5,4,Spring2019
806,E Dartmouth & Harvard,1258,W,NS,1,4,5,1,Spring2019
807,E Dartmouth & Portland Ave,1259,W,NS,2,14,16,14,Spring2019
808,NE Dekum & Dean,1264,E,NS,46,16,62,6,Spring2019
809,NE Dekum & Durham,1265,E,FS,64,18,82,15,Spring2019
810,NE Dekum & Durham,1267,W,NS,27,54,81,13,Spring2019
811,NE Dekum & Saratoga,1271,W,NS,9,9,18,11,Spring2019
812,NE Dekum & M L King,1273,W,NS,28,98,126,17,Spring2019
813,NE Dekum & Claremont,1275,W,FS,18,47,65,3,Spring2019
814,NE Dekum & 15th,1277,W,NS,26,20,46,3,Spring2019
815,NE Dekum & 15th,1278,E,NS,21,22,43,5,Spring2019
816,NE Dekum & 18th,1280,W,FS,18,16,34,2,Spring2019
817,NE Dekum & 18th,1281,E,NS,14,17,31,3,Spring2019
818,NE Dekum & 22nd,1282,W,NS,13,7,20,1,Spring2019
819,NE Dekum & 22nd,1283,E,FS,7,13,20,1,Spring2019
820,NE Dekum & 24th,1284,E,NS,7,10,17,11,Spring2019
821,NE Dekum & 27th,1285,W,NS,26,18,44,12,Spring2019
822,NE Dekum & 27th,1286,E,NS,39,27,66,10,Spring2019
823,NE Dekum & 29th,1287,W,FS,27,20,47,2,Spring2019
824,NE Dekum & 29th,1288,E,FS,20,38,58,1,Spring2019
825,NE Dekum & 32nd Pl,1289,W,OP,29,13,42,3,Spring2019
826,NE Dekum & 33rd,1290,E,NS,22,34,56,3,Spring2019
827,NE Dekum & 6th,1292,W,NS,12,40,52,7,Spring2019
828,NE Dekum & 6th,1293,E,NS,134,52,186,38,Spring2019
829,N Denver & Russet,1299,S,OP,5,15,20,7,Spring2019
830,N Denver & Terry,1300,N,NS,2,15,17,1,Spring2019
831,N Denver & Terry,1301,S,NS,10,2,12,0,Spring2019
832,N Denver & Watts,1303,N,FS,2,11,13,0,Spring2019
833,N Denver & Watts,1304,S,NS,7,2,9,0,Spring2019
834,13100 Block SE Division,1309,W,AT,24,10,34,4,Spring2019
835,16900 Block SE Division,1310,W,AT,70,18,88,47,Spring2019
836,3100 Block NW Division,1312,E,AT,5,17,22,3,Spring2019
837,SE Division & 68th,1313,W,FS,64,28,92,24,Spring2019
838,7300 Block SE Division,1314,E,AT,12,33,45,14,Spring2019
839,NW Division & Civic Dr,1315,E,FS,4,34,38,9,Spring2019
840,NW Division & Civic Dr,1316,W,FS,37,7,44,6,Spring2019
841,NE Division & Hogan Pl,1317,W,FS,33,49,82,34,Spring2019
848,NE Division & Palmblad Dr,1320,E,FS,7,15,22,17,Spring2019
849,NW Division & Birdsdale,1321,E,NS,11,13,24,3,Spring2019
850,Division & Buchanan,1323,E,OP,4,1,5,0,Spring2019
851,NE Division & Burnside,1324,E,FS,44,32,76,37,Spring2019
852,NE Division & Burnside,1325,W,FS,7,14,21,12,Spring2019
853,19200 Block SE Division,1326,W,AT,10,7,17,2,Spring2019
854,NE Division & Cleveland,1327,W,FS,3,13,16,7,Spring2019
855,NE Division & Cleveland,1328,E,NS,14,5,19,10,Spring2019
856,NW Division & Eastman Parkway,1331,E,FS,10,96,106,37,Spring2019
857,NW Division & Eastman Parkway,1332,W,NS,60,6,66,17,Spring2019
858,NW Division & Eastwood,1334,W,NS,18,7,25,7,Spring2019
859,NE Division & Fleming,1335,E,NS,7,6,13,2,Spring2019
860,NE Division & Fleming,1336,W,OP,5,4,9,3,Spring2019
861,NE Division & Francis,1338,W,OP,6,16,22,13,Spring2019
862,NE Division & Hogan,1339,E,FS,40,24,64,23,Spring2019
863,NE Division & Kelly,1340,W,NS,2,23,25,5,Spring2019
864,SE Division & Ladd,1341,W,FS,73,74,147,48,Spring2019
865,NW Division & Miller,1342,W,FS,18,2,20,4,Spring2019
866,Division & Morton,1343,N,NS,4,6,10,1,Spring2019
867,NW Division & Norman,1344,E,FS,3,17,20,8,Spring2019
868,NW Division & Riverview,1346,E,NS,5,3,8,2,Spring2019
869,NW Division & Riverview,1347,W,FS,6,7,13,2,Spring2019
870,NE Division & Main,1348,E,FS,3,52,55,8,Spring2019
871,SE Division & 165th,1350,W,OP,16,20,36,13,Spring2019
872,Division & Selma,1351,E,NS,1,0,1,0,Spring2019
873,NE Division & Village Squire Ct,1355,E,OP,11,12,23,20,Spring2019
874,NE Division & Village Squire Ct,1356,W,NS,16,13,29,33,Spring2019
875,NW Division & Wallula,1357,E,FS,5,24,29,5,Spring2019
876,NW Division & Wallula,1358,W,FS,21,8,29,2,Spring2019
877,SE Division & 101st,1359,E,NS,18,38,56,30,Spring2019
878,SE Division & 101st,1360,W,NS,23,18,41,20,Spring2019
879,SE Division & 103rd,1361,E,NS,11,21,32,26,Spring2019
880,SE Division & 104th Dr,1362,W,NS,21,8,29,8,Spring2019
881,SE Division & 105th,1363,E,FS,5,16,21,5,Spring2019
882,SE Division & 106th,1364,W,NS,11,6,17,4,Spring2019
883,SE Division & 109th,1365,E,NS,12,40,52,18,Spring2019
884,SE Division & 110th,1367,W,NS,21,5,26,4,Spring2019
885,SE Division & 112th,1368,E,FS,29,70,99,25,Spring2019
886,SE Division & 112th,1369,W,NS,65,35,100,25,Spring2019
887,SE Division & 116th,1370,E,OP,12,27,39,11,Spring2019
888,SE Division & 115th,1371,W,FS,21,9,30,6,Spring2019
889,SE Division & 119th,1373,E,FS,30,111,141,31,Spring2019
890,SE Division & 119th,1374,W,OP,45,19,64,11,Spring2019
891,SE Division & 12th,1375,E,NS,171,90,261,32,Spring2019
892,SE Division & 12th,1376,W,FS,74,154,228,29,Spring2019
893,Division & 12th,1377,S,NS,6,3,9,0,Spring2019
894,SE Division & 122nd,1379,E,FS,194,181,375,147,Spring2019
901,SE Division & 122nd ,1381,W,FS,212,153,365,133,Spring2019
902,SE Division & 124th ,1382,W,NS,62,77,139,69,Spring2019
903,SE Division & 125th ,1383,E,NS,30,77,107,24,Spring2019
904,Division & 13th ,1385,N,OP,5,3,8,0,Spring2019
905,SE Division & 130th ,1386,E,NS,47,97,144,31,Spring2019
906,SE Division & 130th ,1387,W,FS,122,46,168,31,Spring2019
907,SE Division & 131st ,1388,E,FS,12,35,47,3,Spring2019
908,SE Division & 136th ,1389,E,FS,46,114,160,45,Spring2019
909,SE Division & 135th ,1390,W,NS,96,34,130,34,Spring2019
910,SE Division & 138th ,1391,E,NS,16,34,50,25,Spring2019
911,SE Division & 139th ,1392,W,FS,56,25,81,31,Spring2019
912,Division & 13th ,1393,S,NS,2,5,7,2,Spring2019
913,SE Division & 142nd ,1396,W,NS,54,15,69,13,Spring2019
914,SE Division & 145th ,1398,E,FS,57,150,207,82,Spring2019
915,SE Division & 145th ,1399,W,NS,95,33,128,60,Spring2019
916,SE Division & 148th ,1400,E,FS,68,59,127,31,Spring2019
917,Division & 15th ,1403,S,FS,4,8,12,6,Spring2019
918,Division & 15th ,1404,N,NS,13,4,17,5,Spring2019
919,SE Division & 151st,1405,E,FS,7,24,31,16,Spring2019
920,SE Division & 152nd,1407,W,NS,34,12,46,15,Spring2019
921,SE Division & 156th,1408,W,NS,92,31,123,37,Spring2019
922,SE Division & 162nd,1415,E,FS,69,200,269,54,Spring2019
923,SE Division & 162nd,1416,W,NS,182,67,249,51,Spring2019
924,SE Division & 165th,1417,E,FS,13,18,31,29,Spring2019
925,SE Division & 168th,1418,E,NS,20,65,85,66,Spring2019
926,SE Division & 17th,1419,E,NS,23,39,62,6,Spring2019
927,SE Division & 17th,1420,W,OP,47,19,66,7,Spring2019
928,SE Division & 174th,1422,E,NS,39,104,143,25,Spring2019
929,SE Division & 174th,1423,W,NS,102,39,141,23,Spring2019
930,SE Division & 176th Pl,1425,W,OP,60,18,78,7,Spring2019
931,SE Division & 182nd,1427,E,FS,61,134,195,49,Spring2019
932,SE Division & 182nd,1428,W,FS,141,52,193,58,Spring2019
933,SE Division & 185th,1429,E,FS,5,12,17,10,Spring2019
934,SE Division & 185th,1430,W,NS,18,18,36,10,Spring2019
935,SE Division & 190th,1433,E,NS,6,18,24,6,Spring2019
936,SE Division & 190th,1434,W,FS,12,6,18,9,Spring2019
937,SE Division & 20th,1435,E,NS,97,122,219,29,Spring2019
938,SE Division & 23rd,1439,E,NS,33,30,63,5,Spring2019
939,SE Division & 26th,1441,E,NS,57,64,121,10,Spring2019
940,SE Division & 26th,1442,W,FS,59,51,110,11,Spring2019
941,SE Division & 28th Pl,1444,W,NS,38,25,63,4,Spring2019
942,SE Division & 28th Pl,1445,E,NS,27,40,67,5,Spring2019
943,SE Division & 30th,1447,E,NS,18,56,74,5,Spring2019
944,SE Division & 30th,1448,W,NS,45,15,60,6,Spring2019
945,SE Division & 32nd,1449,E,NS,23,67,90,3,Spring2019
946,SE Division & 32nd,1450,W,NS,65,22,87,5,Spring2019
947,SE Division & 34th,1451,E,NS,24,86,110,7,Spring2019
954,SE Division & 34th,1452,W,NS,79,28,107,11,Spring2019
955,SE Division & 37th,1457,W,NS,99,30,129,13,Spring2019
956,SE Division & Cesar Chavez Blvd,1458,E,NS,147,152,299,89,Spring2019
957,SE Division & Cesar Chavez Blvd,1459,W,NS,118,172,290,117,Spring2019
958,SE Division & 41st,1461,W,NS,40,21,61,11,Spring2019
959,SE Division & 41st,1462,E,NS,30,41,71,15,Spring2019
960,SE Division & 45th,1465,E,FS,15,36,51,5,Spring2019
961,SE Division & 45th,1466,W,NS,44,11,55,3,Spring2019
962,SE Division & 48th,1467,E,NS,21,50,71,27,Spring2019
963,SE Division & 48th,1468,W,NS,52,10,62,5,Spring2019
964,SE Division & 50th,1470,W,NS,71,67,138,30,Spring2019
965,SE Division & 52nd,1471,E,FS,102,64,166,22,Spring2019
966,SE Division & 52nd,1472,W,NS,66,56,122,13,Spring2019
967,SE Division & 55th,1475,E,FS,87,50,137,10,Spring2019
968,SE Division & 58th,1476,W,FS,39,78,117,18,Spring2019
969,SE Division & 60th,1477,E,OP,22,66,88,19,Spring2019
970,SE Division & 60th,1478,W,FS,47,16,63,19,Spring2019
971,SE Division & 64th,1480,E,NS,15,37,52,5,Spring2019
972,SE Division & 64th,1481,W,OP,28,10,38,3,Spring2019
973,SE Division & 67th,1483,E,FS,31,60,91,23,Spring2019
974,SE Division & 71st,1486,E,FS,11,37,48,4,Spring2019
975,SE Division & 71st,1487,W,OP,37,11,48,8,Spring2019
976,SE Division & 74th,1488,W,OP,49,16,65,10,Spring2019
977,SE Division & 76th,1489,E,OP,13,76,89,6,Spring2019
978,SE Division & 76th,1490,W,NS,26,9,35,6,Spring2019
979,SE Division & 77th,1492,W,NS,54,6,60,6,Spring2019
980,SE Division & 79th,1493,E,NS,5,51,56,2,Spring2019
981,SE Division & 8th,1496,W,FS,6,23,29,6,Spring2019
982,SE Division & 82nd,1497,E,FS,389,283,672,103,Spring2019
983,SE Division & 82nd,1499,W,FS,277,373,650,105,Spring2019
984,SE Division & 85th,1500,E,NS,19,39,58,6,Spring2019
985,SE Division & 85th,1501,W,NS,31,20,51,3,Spring2019
986,SE Division & 89th,1502,W,NS,22,14,36,3,Spring2019
987,SE Division & 89th,1503,E,FS,14,18,32,2,Spring2019
988,Division & 9th ,1504,W,FS,0,2,2,0,Spring2019
989,SE Division & 92nd ,1505,E,NS,23,36,59,24,Spring2019
990,SE Division & 92nd ,1506,W,FS,43,23,66,24,Spring2019
991,SE Division & 98th ,1508,W,FS,42,14,56,17,Spring2019
992,3100 Block SW Dosch ,1510,S,AT,0,0,0,0,Spring2019
993,SW Dosch & Doschview,1511,S,OP,0,0,0,0,Spring2019
994,3500 Block SW Dosch ,1513,S,AT,0,0,0,0,Spring2019
995,SW Dosch & Bridlemile,1515,E,NS,0,2,2,0,Spring2019
996,SW Dosch & Bridlemile,1516,W,OP,3,0,3,0,Spring2019
997,SW Dosch & Dosch Ct ,1517,S,FS,0,8,8,0,Spring2019
998,SW Dosch & Dosch Ct ,1518,N,OP,6,0,6,0,Spring2019
999,SW Dosch & Hamilton ,1519,N,NS,0,1,1,0,Spring2019
1000,SW Dosch & Martins ,1520,S,OP,0,0,0,0,Spring2019
1007,SW Dosch & Martins,1521,N,FS,0,0,0,0,Spring2019
1008,SW Dosch & Newby,1522,S,OP,0,0,0,0,Spring2019
1009,SW Dosch & Newby,1523,N,FS,1,0,1,0,Spring2019
1010,SW Dosch & Patton,1524,N,NS,12,0,12,0,Spring2019
1011,5400 Block SE Duke,1528,E,AT,5,13,18,4,Spring2019
1012,SE Duke & 78th,1529,W,OP,34,3,37,2,Spring2019
1013,SE Duke & 52nd,1530,W,NS,12,6,18,1,Spring2019
1014,SE Duke & 57th,1531,E,FS,2,13,15,1,Spring2019
1015,SE Duke & 57th,1532,W,FS,16,2,18,1,Spring2019
1016,SE Duke & 60th,1534,W,NS,49,19,68,19,Spring2019
1017,SE Duke & 64th,1537,E,NS,8,28,36,6,Spring2019
1018,SE Duke & 65th,1538,W,NS,26,6,32,1,Spring2019
1019,SE Duke & 67th,1539,E,NS,9,38,47,30,Spring2019
1020,SE Duke & 60th,1540,E,NS,23,46,69,28,Spring2019
1021,SE Duke & 67th,1541,W,NS,41,8,49,43,Spring2019
1022,SE Duke & 72nd,1544,E,NS,18,69,87,12,Spring2019
1023,SE Duke & 72nd,1545,W,FS,64,17,81,8,Spring2019
1024,SE Duke & 75th,1546,E,NS,4,21,25,16,Spring2019
1025,SE Duke & 74th,1547,W,NS,30,5,35,17,Spring2019
1026,SE Duke & 78th,1548,E,NS,1,28,29,1,Spring2019
1027,SE Duke & 82nd,1550,E,NS,5,104,109,44,Spring2019
1028,SE Duke & 81st,1551,W,NS,88,6,94,15,Spring2019
1029,SE Eagle Creek Rd & Currin,1555,N,FS,0,0,0,0,Spring2019
1030,28200 Block SE Eagle Creek Rd,1556,S,AT,2,3,5,0,Spring2019
1031,28400 Block SE Eagle Creek Rd,1557,N,AT,4,1,5,1,Spring2019
1032,25800 Block SE Eagle Creek Rd,1558,N,AT,5,6,11,2,Spring2019
1033,SE Eagle Creek Rd & Riverside Way,1559,S,FS,4,5,9,1,Spring2019
1034,SE Eagle Creek Rd & Folsom,1560,S,NS,0,0,0,0,Spring2019
1035,SE Eagle Creek Rd & Heiple Rd,1561,N,OP,1,0,1,0,Spring2019
1036,SE Eagle Creek Rd & Heiple Rd,1562,S,FS,0,1,1,0,Spring2019
1037,SE Eagle Creek Rd & Hwy 211,1563,S,FS,2,2,4,0,Spring2019
1038,SE Eagle Creek Rd & Hwy 211,1564,N,NS,1,2,3,1,Spring2019
1039,SE Eagle Creek Rd & Risberg,1565,N,OP,1,2,3,0,Spring2019
1040,SE Eagle Creek Rd & Risberg,1566,S,NS,1,1,2,0,Spring2019
1041,SE Eagle Creek Rd & Wildcat Mtn,1567,S,NS,1,3,4,0,Spring2019
1042,SE Eagle Creek Rd & Wildcat Mtn,1568,N,FS,3,1,4,0,Spring2019
1043,SW Eastman & Birdsdale,1569,N,OP,4,1,5,0,Spring2019
1044,SW Eastman & Birdsdale,1570,S,FS,0,2,2,0,Spring2019
1045,1500 Block NW Eastman,1571,S,AT,3,12,15,17,Spring2019
1046,NW Eastman & Division,1572,N,FS,96,5,101,30,Spring2019
1047,SE 223rd & NW 20th,1576,S,NS,2,10,12,7,Spring2019
1048,SW Eastman & Florence,1577,E,OP,1,0,1,0,Spring2019
1049,SW Eastman & Florence,1578,W,FS,0,1,1,0,Spring2019
1050,1300 Block NW Eastman,1579,S,AT,2,95,97,23,Spring2019
1051,SW Eastman & W Powell,1580,N,NS,2,4,6,2,Spring2019
1052,NW Eastman & W Powell,1581,S,NS,1,2,3,0,Spring2019
1053,600 Block NW Eastman (Townfair),1582,N,AT,0,0,0,1,Spring2019
1060,600 Block NW Eastman (Townfair),1583,S,OP,1,0,1,0,Spring2019
1061,NW Eastman & 3rd,1585,N,FS,2,2,4,1,Spring2019
1062,NW Eastman & 3rd,1586,S,OP,1,1,2,0,Spring2019
1063,SW Eastman & 4th,1587,E,OP,2,0,2,0,Spring2019
1064,SW Eastman & 4th,1588,S,FS,0,0,0,0,Spring2019
1065,SE Ellis & Foster,1596,W,NS,2,22,24,3,Spring2019
1066,SE Ellis & Foster,1597,E,FS,8,7,15,1,Spring2019
1067,SE Ellis & 86th Ave,1598,W,NS,8,2,10,1,Spring2019
1068,SE Ellis & 86th Ct,1600,E,OP,1,6,7,0,Spring2019
1069,SE Ellis & 89th,1602,E,OP,1,5,6,5,Spring2019
1070,SE Ellis & 92nd,1604,E,NS,2,11,13,0,Spring2019
1071,NW Everett & Broadway,1606,E,NS,23,46,69,24,Spring2019
1072,NW Everett & 11th,1607,E,FS,75,35,110,21,Spring2019
1073,NW Everett & 14th,1608,E,NS,43,17,60,3,Spring2019
1074,NW Everett & 19th,1611,E,NS,89,23,112,63,Spring2019
1075,NW Everett & 2nd,1612,E,NS,310,141,451,86,Spring2019
1076,NW Everett & 21st,1615,E,FS,116,36,152,49,Spring2019
1077,2700 Block SW Fairview,1618,E,AT,0,0,0,0,Spring2019
1078,2700 Block SW Fairview,1619,W,OP,0,0,0,0,Spring2019
1079,2800 Block SW Fairview,1620,W,AT,0,0,0,0,Spring2019
1080,2800 Block SW Fairview,1622,S,OP,1,0,1,0,Spring2019
1081,2800 Block SW Fairview,1623,N,AT,0,1,1,0,Spring2019
1082,4000 Block SW Fairview (Arboretum),1624,N,AT,3,2,5,0,Spring2019
1083,4000 Block SW Fairview (Arboretum),1625,S,OP,1,2,3,0,Spring2019
1084,SW Fairview & Bennington,1626,E,OP,0,1,1,0,Spring2019
1085,SW Fairview & Bennington,1627,S,FS,4,0,4,0,Spring2019
1086,SW Fairview & Canterbury,1628,N,NS,1,1,2,0,Spring2019
1087,SW Fairview & Cascade,1629,S,NS,1,0,1,0,Spring2019
1088,SW Fairview & Champlain,1632,E,OP,1,0,1,0,Spring2019
1089,SW Fairview & Kingston,1633,E,NS,10,20,30,1,Spring2019
1090,2900 Block SW Fairview,1635,W,AT,0,2,2,0,Spring2019
1091,2900 Block SW Fairview,1636,E,OP,2,0,2,0,Spring2019
1092,SW Fairview & View Place,1637,S,FS,0,1,1,0,Spring2019
1093,SW Fairview & Wildwood Trail,1638,N,AT,0,0,0,0,Spring2019
1094,SW Fairview & Wildwood Trail,1639,S,AT,0,0,0,0,Spring2019
1095,SW Farmington & 156th,1640,E,OP,53,26,79,2,Spring2019
1096,SW Farmington & 157th Pl,1641,W,OP,34,48,82,3,Spring2019
1097,18200 Block SW Farmington,1642,E,AT,0,0,0,0,Spring2019
1098,SW Farmington & Erickson,1646,E,FS,7,27,34,4,Spring2019
1099,SW Farmington & Hall,1648,W,NS,42,8,50,8,Spring2019
1100,SW Farmington & Hocken,1649,W,NS,9,3,12,0,Spring2019
1101,SW Farmington & Hocken,1650,E,FS,3,11,14,3,Spring2019
1102,SW Farmington & Kinnaman,1651,W,FS,21,58,79,2,Spring2019
1103,SW Farmington & Kinnaman,1652,E,NS,34,17,51,10,Spring2019
1104,17500 Block SW Farmington,1657,W,OP,78,67,145,40,Spring2019
1105,SW Farmington & Remington Dr,1658,E,FS,82,78,160,32,Spring2019
1106,SW Farmington & Murray,1660,W,FS,46,57,103,10,Spring2019
1113,SW Farmington & Murray,1661,E,NS,71,62,133,19,Spring2019
1114,SW Farmington & Watson,1665,E,NS,7,66,73,8,Spring2019
1115,SW Farmington & 142nd,1668,W,FS,11,29,40,5,Spring2019
1116,SW Farmington & 142nd,1669,E,FS,20,12,32,4,Spring2019
1117,SW Farmington & St Marys Dr,1670,W,FS,19,31,50,39,Spring2019
1118,SW Farmington & 149th,1671,E,NS,35,18,53,29,Spring2019
1119,SW Farmington & 153rd,1672,E,FS,18,5,23,0,Spring2019
1120,SW Farmington & 153rd,1673,W,NS,7,19,26,0,Spring2019
1121,SW Farmington & 160th,1674,W,FS,20,20,40,16,Spring2019
1122,SW Farmington & 160th,1675,E,FS,19,21,40,17,Spring2019
1123,SW Farmington & 165th,1678,W,FS,6,10,16,1,Spring2019
1124,SW Farmington & 165th,1679,E,FS,10,6,16,0,Spring2019
1125,SW Farmington & 170th,1682,W,FS,12,19,31,1,Spring2019
1126,SW Farmington & 170th,1683,E,FS,18,13,31,1,Spring2019
1127,SW Farmington & 179th,1688,E,NS,15,11,26,0,Spring2019
1128,SW Farmington & 188th Ct,1689,W,FS,13,10,23,0,Spring2019
1129,SW Farmington & 188th Ct,1690,E,NS,8,7,15,0,Spring2019
1130,SW Farmington & 192nd,1691,W,FS,5,6,11,0,Spring2019
1131,SW Farmington & 192nd,1692,E,FS,6,5,11,1,Spring2019
1132,SW Farmington & 195th,1693,E,NS,22,8,30,1,Spring2019
1133,SW Farmington & 196th,1694,W,NS,9,18,27,1,Spring2019
1134,N Fessenden & Allegheny,1698,W,NS,6,31,37,7,Spring2019
1135,N Fessenden & Allegheny,1699,E,FS,29,7,36,4,Spring2019
1136,N Fessenden & Berkeley,1700,W,FS,9,29,38,3,Spring2019
1137,N Fessenden & Burr,1703,E,NS,144,47,191,9,Spring2019
1138,N Fessenden & Burr,1704,W,NS,50,141,191,8,Spring2019
1139,N Fessenden & Columbia Way,1707,E,FS,141,23,164,13,Spring2019
1140,N Fessenden & Columbia Way,1708,W,NS,22,125,147,20,Spring2019
1141,N Fessenden & Geneva,1709,E,FS,64,23,87,8,Spring2019
1142,N Fessenden & Midway,1712,E,FS,65,19,84,16,Spring2019
1143,N Fessenden & Midway,1713,W,NS,14,65,79,15,Spring2019
1144,N Fessenden & Richmond,1714,E,FS,59,16,75,15,Spring2019
1145,N Fessenden & Richmond,1715,W,OP,13,51,64,14,Spring2019
1146,N Fessenden & Tioga,1718,W,NS,5,14,19,1,Spring2019
1147,N Fessenden & Portsmouth,1719,W,NS,8,19,27,3,Spring2019
1148,N Fessenden & Portsmouth,1720,E,NS,18,9,27,4,Spring2019
1149,N Fessenden & Van Houten,1721,W,NS,12,34,46,4,Spring2019
1150,N Fessenden & Van Houten,1722,E,NS,39,13,52,1,Spring2019
1151,N Fessenden & Wall,1723,W,OP,11,31,42,4,Spring2019
1152,8900 Block SE Flavel,1728,E,OP,1,10,11,0,Spring2019
1153,8800 Block SE Flavel,1729,W,OP,12,0,12,0,Spring2019
1154,SE Flavel & 52nd,1731,W,NS,45,14,59,11,Spring2019
1155,SE Flavel & 52nd,1732,E,FS,10,40,50,17,Spring2019
1156,SE Flavel & 57th,1737,W,NS,23,5,28,0,Spring2019
1157,SE Flavel & 57th,1738,E,FS,5,22,27,0,Spring2019
1158,SE Flavel & 60th,1739,E,NS,21,54,75,19,Spring2019
1159,SE Flavel & 60th,1740,W,NS,34,17,51,17,Spring2019
1166,SE Flavel & 62nd,1743,W,NS,25,8,33,7,Spring2019
1167,SE Flavel & 64th,1745,E,NS,7,28,35,18,Spring2019
1168,SE Flavel & 66th Place,1748,E,NS,6,28,34,2,Spring2019
1169,SE Flavel & 66th,1749,W,NS,31,7,38,1,Spring2019
1170,SE Flavel & 70th,1754,E,NS,3,12,15,1,Spring2019
1171,SE Flavel & 72nd,1755,W,FS,57,18,75,15,Spring2019
1172,SE Flavel & 82nd,1759,E,FS,12,25,37,20,Spring2019
1173,SE Flavel & 83rd,1760,W,NS,20,12,32,23,Spring2019
1174,SE Flavel & 85th,1761,E,OP,2,5,7,1,Spring2019
1175,SE Flavel & 86th,1762,W,FS,15,1,16,0,Spring2019
1176,SE Flavel & 87th,1763,E,NS,1,9,10,0,Spring2019
1177,SE Flavel & 92nd,1764,E,FS,1,39,40,15,Spring2019
1178,SE Flavel & 92nd,1765,W,FS,30,1,31,7,Spring2019
1179,SE Foster & 120th,1766,E,OP,16,13,29,10,Spring2019
1180,13100 Block SE Foster,1769,W,AT,5,8,13,4,Spring2019
1181,SE Foster & 131st,1770,E,OP,8,7,15,17,Spring2019
1182,SE Foster & 103rd,1772,E,OP,5,4,9,1,Spring2019
1183,11600 Block SE Foster,1773,E,OP,17,13,30,1,Spring2019
1184,11600 Block SE Foster,1774,W,AT,14,23,37,1,Spring2019
1185,SE Foster & Gladstone,1775,E,FS,11,34,45,2,Spring2019
1186,SE Foster & Holgate,1778,W,NS,48,19,67,8,Spring2019
1187,SE Foster & 101st,1779,E,NS,23,2,25,1,Spring2019
1188,SE Foster & 101st,1780,W,NS,4,15,19,1,Spring2019
1189,SE Foster & 103rd,1781,W,NS,4,5,9,3,Spring2019
1190,SE Foster & 107th,1782,E,OP,1,1,2,0,Spring2019
1191,SE Foster & 107th,1783,W,FS,1,1,2,0,Spring2019
1192,SE Foster & 110th Dr,1784,E,FS,13,11,24,2,Spring2019
1193,SE Foster & 111th,1785,W,NS,11,13,24,2,Spring2019
1194,12300 Block SE Foster,1786,E,AT,5,4,9,0,Spring2019
1195,SE Foster & 122nd,1787,W,FS,28,93,121,29,Spring2019
1196,SE Foster & 128th,1788,E,FS,13,12,25,3,Spring2019
1197,SE Foster & 128th,1789,W,FS,15,12,27,1,Spring2019
1198,SE Foster & 134th,1790,E,FS,10,7,17,0,Spring2019
1199,SE Foster & 134th,1791,W,FS,5,8,13,0,Spring2019
1200,SE Foster & Powell,1792,S,FS,50,85,135,18,Spring2019
1201,SE Foster & 52nd,1793,W,NS,71,54,125,25,Spring2019
1202,SE Foster & 52nd,1794,E,FS,52,56,108,34,Spring2019
1203,SE Foster & 56th,1798,W,NS,22,9,31,2,Spring2019
1204,SE Foster & 58th,1799,W,NS,39,6,45,1,Spring2019
1205,SE Foster & 65th,1802,E,FS,41,98,139,29,Spring2019
1206,SE Foster & 65th,1803,W,NS,54,22,76,18,Spring2019
1207,SE Foster & 67th,1804,E,FS,18,51,69,17,Spring2019
1208,SE Foster & 67th,1805,W,FS,43,13,56,8,Spring2019
1209,SE Foster & 69th,1807,W,FS,28,14,42,10,Spring2019
1210,SE Foster & 70th,1808,E,NS,8,15,23,2,Spring2019
1211,SE Foster & 72nd,1810,E,FS,24,95,119,33,Spring2019
1212,SE Foster & 72nd,1811,W,FS,79,25,104,20,Spring2019
1219,SE Foster & 75th,1812,E,OP,3,16,19,13,Spring2019
1220,SE Foster & 77th,1814,E,FS,10,56,66,21,Spring2019
1221,SE Foster & 78th,1815,W,NS,74,17,91,23,Spring2019
1222,SE Foster & 79th,1816,E,FS,8,37,45,27,Spring2019
1223,SE Foster & 82nd,1818,W,FS,234,129,363,100,Spring2019
1224,SE Foster & 82nd,1819,E,NS,72,162,234,57,Spring2019
1225,SE Foster & 85th,1821,E,NS,3,31,34,3,Spring2019
1226,SE Foster & 86th,1823,E,FS,1,19,20,3,Spring2019
1227,SE Foster & 86th,1824,W,FS,30,5,35,5,Spring2019
1228,SE Foster & 88th,1826,W,FS,39,5,44,15,Spring2019
1229,SE Foster & 89th,1827,E,FS,1,58,59,15,Spring2019
1230,SE Foster & 91st,1829,W,FS,66,1,67,10,Spring2019
1231,SE Foster & 94th (I-205 Overpass),1831,W,NS,114,183,297,29,Spring2019
1232,SE Foster & 97th,1832,W,NS,1,14,15,1,Spring2019
1233,NE Fremont & Alameda,1834,E,NS,1,4,5,0,Spring2019
1234,NE Fremont & Alameda,1835,W,FS,4,1,5,0,Spring2019
1235,N Fremont & Borthwick,1837,E,NS,8,26,34,0,Spring2019
1236,NE Fremont & Cleveland,1838,E,NS,22,9,31,2,Spring2019
1237,N Fremont & Gantenbein,1841,W,NS,50,51,101,17,Spring2019
1238,NE Fremont & Mallory,1842,E,OP,5,3,8,2,Spring2019
1239,N Fremont & Albina,1843,W,FS,8,34,42,3,Spring2019
1240,NE Fremont & Mallory,1845,W,NS,7,11,18,3,Spring2019
1241,NE Fremont & M L King,1846,E,NS,19,11,30,4,Spring2019
1242,NE Fremont & M L King,1847,W,NS,9,22,31,13,Spring2019
1243,NE Fremont & 12th,1851,E,NS,7,5,12,1,Spring2019
1244,NE Fremont & 11th,1852,W,NS,5,6,11,0,Spring2019
1245,NE Fremont & 138th,1853,W,FS,1,1,2,1,Spring2019
1246,NE Fremont & 15th,1856,E,FS,20,13,33,2,Spring2019
1247,NE Fremont & 15th,1857,W,NS,13,20,33,7,Spring2019
1248,NE Fremont & 18th,1858,E,NS,3,2,5,0,Spring2019
1249,NE Fremont & 18th,1859,W,NS,3,6,9,0,Spring2019
1250,NE Fremont & 21st,1860,E,NS,3,1,4,0,Spring2019
1251,NE Fremont & 21st,1861,W,FS,2,3,5,0,Spring2019
1252,NE Fremont & 24th,1862,W,FS,9,10,19,2,Spring2019
1253,NE Fremont & 24th,1863,E,NS,13,8,21,1,Spring2019
1254,NE Fremont & 27th,1864,W,NS,3,5,8,0,Spring2019
1255,NE Fremont & 27th,1865,E,NS,7,3,10,0,Spring2019
1256,NE Fremont & 31st,1868,E,NS,2,2,4,0,Spring2019
1257,NE Fremont & Edgehill Place,1869,W,NS,2,2,4,0,Spring2019
1258,NE Fremont & 33rd Place,1870,W,OP,5,7,12,0,Spring2019
1259,NE Fremont & 33rd,1871,E,NS,6,7,13,1,Spring2019
1260,NE Fremont & 35th,1872,E,NS,2,2,4,0,Spring2019
1261,NE Fremont & 35th,1873,W,FS,2,2,4,0,Spring2019
1262,NE Fremont & Cesar Chavez Blvd,1874,E,NS,2,3,5,1,Spring2019
1263,NE Fremont & Cesar Chavez Blvd,1875,W,NS,2,2,4,0,Spring2019
1264,NE Fremont & 41st,1876,E,NS,16,26,42,2,Spring2019
1265,NE Fremont & 42nd,1877,W,FS,25,15,40,3,Spring2019
1272,NE Fremont & 48th,1882,E,NS,5,7,12,1,Spring2019
1273,NE Fremont & 48th,1883,W,FS,7,6,13,1,Spring2019
1274,NE Fremont & 51st,1887,W,FS,4,3,7,0,Spring2019
1275,NE Fremont & 54th,1888,E,NS,1,3,4,0,Spring2019
1276,NE Fremont & 54th,1889,W,OP,7,1,8,0,Spring2019
1277,NE Fremont & 57th,1890,E,FS,6,20,26,4,Spring2019
1278,NE Fremont & 57th,1891,W,FS,19,6,25,6,Spring2019
1279,NE Fremont & 61st,1893,W,NS,5,4,9,0,Spring2019
1280,NE Fremont & 61st,1894,E,NS,5,4,9,0,Spring2019
1281,NE Fremont & 64th,1895,E,NS,3,6,9,0,Spring2019
1282,NE Fremont & 64th,1896,W,FS,5,3,8,0,Spring2019
1283,NE Fremont & 67th,1898,W,NS,5,2,7,0,Spring2019
1284,NE Fremont & 7th,1899,W,NS,4,7,11,1,Spring2019
1285,NE Fremont & 7th,1900,E,FS,10,4,14,1,Spring2019
1286,NE Fremont & 69th,1902,W,NS,7,6,13,16,Spring2019
1287,NE Fremont & 71st,1903,W,NS,9,8,17,4,Spring2019
1288,NE Fremont & 74th,1904,E,NS,4,6,10,1,Spring2019
1289,NE Fremont & 74th,1905,W,NS,5,4,9,3,Spring2019
1290,NE Fremont & 77th,1906,E,NS,1,5,6,0,Spring2019
1291,NE Fremont & 77th,1907,W,NS,6,1,7,0,Spring2019
1292,NE Fremont & 80th,1908,E,NS,1,9,10,1,Spring2019
1293,NE Fremont & 80th,1909,W,NS,3,1,4,1,Spring2019
1294,NE Fremont & 82nd,1910,W,FS,28,12,40,9,Spring2019
1295,NE Fremont & 82nd,1911,E,FS,11,23,34,3,Spring2019
1296,NE Fremont & 85th,1912,E,OP,2,2,4,2,Spring2019
1297,NE Fremont & 85th,1913,W,FS,3,4,7,3,Spring2019
1298,NE Fremont & 88th,1916,W,NS,9,4,13,1,Spring2019
1299,NE Fremont & 89th,1917,E,NS,13,9,22,0,Spring2019
1300,NE Fremont Ct & 145th ,1919,E,NS,4,3,7,45,Spring2019
1301,4300 Block NW Front ,1921,W,AT,0,7,7,0,Spring2019
1302,4800 Block NW Front ,1922,W,AT,1,4,5,0,Spring2019
1303,4500 Block NW Front ,1924,W,AT,0,2,2,0,Spring2019
1304,4700 Block NW Front ,1925,W,AT,1,7,8,0,Spring2019
1305,SW Naito Parkway & Harrison,1926,N,NS,1,104,105,1,Spring2019
1306,SW Naito Parkway & Harrison,1927,S,NS,65,2,67,8,Spring2019
1307,SW Naito Parkway & Hooker,1929,S,AT,22,15,37,2,Spring2019
1308,SW Naito Parkway & Hooker,1930,N,AT,16,68,84,3,Spring2019
1309,3700 Block NW Front ,1931,W,AT,2,18,20,0,Spring2019
1310,SE Fuller & Sunnyside Dr,1934,N,NS,2,4,6,1,Spring2019
1311,11900 Block SE Fuller (La Salle),1935,N,OP,5,1,6,0,Spring2019
1312,11900 Block SE Fuller (La Salle),1936,S,AT,6,4,10,0,Spring2019
1313,SE Fuller & Southgate ,1939,N,NS,2,2,4,0,Spring2019
1314,SE Fuller & Southgate ,1940,S,FS,3,2,5,0,Spring2019
1315,SW Gaines & 11th ,1945,W,NS,44,48,92,6,Spring2019
1316,SW Gaines & 6th ,1947,W,OP,22,46,68,6,Spring2019
1317,SW Gaines & 9th ,1949,W,OP,42,73,115,0,Spring2019
1318,SW Garden Home & Multnomah,1951,W,NS,2,6,8,0,Spring2019
1325,SW Garden Home & 40th,1954,E,NS,4,2,6,0,Spring2019
1326,SW Garden Home & 42nd,1955,W,OP,1,3,4,0,Spring2019
1327,SW Garden Home & 42nd,1956,E,FS,5,0,5,0,Spring2019
1328,SW Garden Home & 45th,1957,W,NS,2,11,13,0,Spring2019
1329,SW Garden Home & 45th,1958,E,NS,14,3,17,0,Spring2019
1330,SW Garden Home & 47th,1959,E,FS,5,0,5,0,Spring2019
1331,SW Garden Home & 47th,1960,W,NS,1,5,6,0,Spring2019
1332,SW Garden Home & 50th,1961,W,OP,0,8,8,0,Spring2019
1333,SW Garden Home & 50th,1962,E,NS,10,0,10,0,Spring2019
1334,SW Garden Home & 52nd,1963,W,OP,0,4,4,0,Spring2019
1335,SW Garden Home & 54th,1965,W,NS,0,1,1,0,Spring2019
1336,SW Garden Home & 54th,1966,E,NS,6,0,6,0,Spring2019
1337,SW Garden Home & 56th,1967,W,FS,0,3,3,0,Spring2019
1338,SW Garden Home & 56th,1968,E,NS,2,0,2,0,Spring2019
1339,SW Garden Home & 57th,1969,W,NS,0,6,6,0,Spring2019
1340,SW Garden Home & 57th,1970,E,OP,7,0,7,0,Spring2019
1341,SW Garden Home & 61st,1971,W,NS,1,7,8,0,Spring2019
1342,SW Garden Home & 61st,1972,E,FS,6,2,8,0,Spring2019
1343,SW Garden Home & 62nd Pl,1973,W,NS,1,8,9,0,Spring2019
1344,SW Garden Home & 62nd Pl,1974,E,OP,10,1,11,0,Spring2019
1345,SW Garden Home & 64th,1975,W,NS,0,1,1,0,Spring2019
1346,SW Garden Home & 64th,1976,E,OP,1,0,1,0,Spring2019
1347,SW Garden Home & 66th,1977,W,OP,0,2,2,0,Spring2019
1348,SW Garden Home & 66th,1978,E,FS,4,0,4,0,Spring2019
1349,SW Garden Home & 67th,1979,W,OP,1,1,2,0,Spring2019
1350,SW Garden Home & 67th,1980,E,NS,2,1,3,0,Spring2019
1351,SW Garden Home & 69th/Multnomah,1981,E,FS,7,1,8,3,Spring2019
1352,SW Garden Home & 71st,1982,W,FS,18,48,66,1,Spring2019
1353,SW Garden Home & 71st,1983,E,NS,28,11,39,1,Spring2019
1354,SE Gladstone & 26th ,1990,W,NS,16,6,22,0,Spring2019
1355,SE Gladstone & 28th ,1991,E,NS,8,20,28,0,Spring2019
1356,Glen Echo & SE Mildred ,1993,E,OP,2,2,4,1,Spring2019
1357,Glen Echo & Mildred ,1994,W,FS,1,2,3,2,Spring2019
1358,NW Glisan & Broadway ,1997,W,FS,88,46,134,50,Spring2019
1359,NE Glisan & Floral ,2000,W,FS,19,2,21,1,Spring2019
1360,NE Glisan & Laddington ,2001,E,NS,1,7,8,1,Spring2019
1361,NE Glisan & Laddington ,2002,W,NS,7,2,9,1,Spring2019
1362,NE Glisan & Laurelhurst ,2003,E,NS,2,16,18,0,Spring2019
1363,12900 Block NE Glisan (Menlo Park ES),2005,E,AT,1,2,3,2,Spring2019
1364,4700 Block NE Glisan ,2009,W,OP,78,51,129,113,Spring2019
1365,NE Glisan & 122nd ,2010,E,FS,6,4,10,1,Spring2019
1366,NW Glisan & 10th ,2011,W,NS,30,69,99,30,Spring2019
1367,NE Glisan & 102nd ,2015,E,FS,4,1,5,3,Spring2019
1368,NE Glisan & 102nd ,2016,W,NS,1,4,5,2,Spring2019
1369,NE Glisan & 104th ,2017,W,NS,1,2,3,1,Spring2019
1370,NE Glisan & 105th ,2018,E,NS,1,1,2,0,Spring2019
1371,NE Glisan & 108th ,2020,E,OP,2,1,3,0,Spring2019
1378,NE Glisan & 108th,2021,W,NS,1,1,2,0,Spring2019
1379,NE Glisan & 113th,2024,E,NS,1,1,2,1,Spring2019
1380,NE Glisan & 113th,2025,W,NS,1,1,2,0,Spring2019
1381,NE Glisan & 117th,2028,E,NS,1,2,3,1,Spring2019
1382,NE Glisan & 117th,2029,W,NS,2,0,2,1,Spring2019
1383,NW Glisan & 12th,2030,W,NS,19,67,86,18,Spring2019
1384,NE Glisan & 120th,2032,E,OP,2,3,5,2,Spring2019
1385,NE Glisan & 122nd,2034,W,NS,5,7,12,3,Spring2019
1386,NE Glisan & 126th,2036,E,FS,1,1,2,0,Spring2019
1387,NE Glisan & 128th,2037,W,FS,4,1,5,3,Spring2019
1388,NE Glisan & 133rd,2040,E,NS,0,1,1,2,Spring2019
1389,NE Glisan & 133rd,2041,W,OP,1,0,1,0,Spring2019
1390,NE Glisan & 136th,2042,E,NS,0,1,1,0,Spring2019
1391,NE Glisan & 136th,2043,W,OP,4,0,4,0,Spring2019
1392,NE Glisan & 139th,2044,E,NS,0,2,2,1,Spring2019
1393,NW Glisan & 14th,2046,W,NS,12,57,69,10,Spring2019
1394,NE Glisan & 141st,2047,W,OP,3,0,3,0,Spring2019
1395,NE Glisan & 141st,2048,E,FS,1,2,3,0,Spring2019
1396,NE Glisan & 143rd,2049,E,NS,0,0,0,0,Spring2019
1397,NE Glisan & 143rd,2050,W,OP,0,0,0,0,Spring2019
1398,NE Glisan & 146th,2051,E,NS,0,2,2,0,Spring2019
1399,NE Glisan & 148th,2053,E,FS,0,2,2,2,Spring2019
1400,NE Glisan & 148th,2054,W,FS,2,0,2,0,Spring2019
1401,NE Glisan & 152nd,2057,W,NS,1,0,1,0,Spring2019
1402,NE Glisan & 155th,2058,E,OP,1,4,5,1,Spring2019
1403,NE Glisan & 155th,2059,W,NS,3,1,4,1,Spring2019
1404,NE Glisan & 157th,2060,E,NS,1,3,4,1,Spring2019
1405,NE Glisan & 157th,2061,W,FS,6,1,7,4,Spring2019
1406,NW Glisan & 16th,2062,W,NS,2,15,17,4,Spring2019
1407,NE Glisan & 160th,2063,E,FS,1,3,4,0,Spring2019
1408,NE Glisan & 160th,2064,W,NS,1,0,1,0,Spring2019
1409,NE Glisan & 162nd,2065,E,FS,3,8,11,4,Spring2019
1410,NE Glisan & 162nd,2066,W,FS,8,2,10,5,Spring2019
1411,NE Glisan & 165th,2067,E,NS,1,4,5,0,Spring2019
1412,NE Glisan & 165th,2068,W,NS,3,1,4,1,Spring2019
1413,NE Glisan & 167th Pl,2069,E,NS,1,1,2,0,Spring2019
1414,NE Glisan & 167th Pl,2070,W,NS,2,0,2,0,Spring2019
1415,NE Glisan & 172nd,2073,W,FS,2,0,2,0,Spring2019
1416,NE Glisan & 172nd,2074,E,FS,1,2,3,0,Spring2019
1417,NE Glisan & 176th,2075,W,NS,2,0,2,2,Spring2019
1418,NE Glisan & 176th,2076,E,FS,0,2,2,0,Spring2019
1419,NE Glisan & 181st,2081,W,FS,9,3,12,3,Spring2019
1420,NW Glisan & 19th,2086,W,NS,13,83,96,48,Spring2019
1421,NW Glisan & 21st,2099,W,NS,17,147,164,30,Spring2019
1422,NE Glisan & 28th,2105,E,FS,32,68,100,9,Spring2019
1423,NE Glisan & 30th,2106,E,FS,8,19,27,4,Spring2019
1424,NE Glisan & 30th,2107,W,NS,27,11,38,5,Spring2019
1431,NE Glisan & 32nd,2108,E,NS,7,13,20,2,Spring2019
1432,NE Glisan & 32nd,2109,W,NS,11,5,16,2,Spring2019
1433,NE Glisan & Cesar Chavez Blvd,2110,E,FS,33,29,62,34,Spring2019
1434,NE Glisan & Cesar Chavez Blvd,2111,W,FS,27,47,74,34,Spring2019
1435,NE Glisan & 43rd,2114,E,NS,3,15,18,1,Spring2019
1436,NE Glisan & 43rd,2115,W,NS,17,3,20,1,Spring2019
1437,NE Glisan & 45th,2117,W,NS,35,11,46,21,Spring2019
1438,NE Glisan & 49th,2119,E,FS,70,87,157,139,Spring2019
1439,NE Glisan & 52nd,2121,W,NS,65,39,104,46,Spring2019
1440,NE Glisan & 53rd,2122,E,NS,22,46,68,21,Spring2019
1441,NE Glisan & 55th,2123,W,NS,13,10,23,10,Spring2019
1442,NE Glisan & 56th,2124,E,FS,10,13,23,7,Spring2019
1443,NE Glisan & 57th,2126,W,NS,13,8,21,17,Spring2019
1444,NE Glisan & 60th,2127,E,NS,29,50,79,46,Spring2019
1445,NE Glisan & 60th,2128,W,NS,49,31,80,39,Spring2019
1446,NE Glisan & 62nd,2129,W,NS,15,1,16,1,Spring2019
1447,NE Glisan & 62nd,2130,E,NS,2,8,10,0,Spring2019
1448,NE Glisan & 65th,2131,E,NS,5,31,36,12,Spring2019
1449,NE Glisan & 65th,2132,W,NS,45,8,53,49,Spring2019
1450,NE Glisan & 67th,2133,W,NS,34,28,62,24,Spring2019
1451,NE Glisan & 67th,2134,E,NS,33,47,80,24,Spring2019
1452,NE Glisan & 71st,2137,W,NS,35,13,48,3,Spring2019
1453,NE Glisan & 71st,2138,E,NS,9,29,38,3,Spring2019
1454,NE Glisan & 73rd,2139,E,FS,7,30,37,5,Spring2019
1455,NE Glisan & 78th,2143,W,NS,38,12,50,14,Spring2019
1456,NE Glisan & 78th,2144,E,NS,12,37,49,11,Spring2019
1457,NE Glisan & 80th,2145,W,NS,31,5,36,7,Spring2019
1458,NE Glisan & 80th,2146,E,NS,4,24,28,6,Spring2019
1459,NE Glisan & 82nd,2147,E,FS,25,93,118,40,Spring2019
1460,NE Glisan & 82nd,2148,W,NS,79,28,107,58,Spring2019
1461,NE Glisan & 85th,2149,W,OP,7,4,11,0,Spring2019
1462,NE Glisan & 86th,2151,E,NS,6,13,19,1,Spring2019
1463,NE Glisan & 90th,2153,W,NS,25,10,35,3,Spring2019
1464,NE Glisan & 92nd,2155,E,NS,9,21,30,7,Spring2019
1465,NE Glisan & 92nd,2156,W,NS,24,13,37,4,Spring2019
1466,NE Glisan & 94th,2158,E,NS,3,10,13,1,Spring2019
1467,N Going & Port Center Way,2161,W,FS,4,44,48,3,Spring2019
1468,NE Grand & Broadway,2165,N,FS,106,30,136,55,Spring2019
1469,SE Grand & E Burnside,2167,N,NS,256,100,356,64,Spring2019
1470,NE Grand & Hoyt ,2169,N,OP,34,38,72,7,Spring2019
1471,SE Grand & Main ,2170,N,NS,233,45,278,26,Spring2019
1472,SE Grand & Mill ,2171,N,NS,0,3,3,0,Spring2019
1473,NE Grand & Holladay,2175,N,FS,292,130,422,70,Spring2019
1474,NE Grand & Weidler,2178,N,NS,128,67,195,50,Spring2019
1475,N Greeley & Ainsworth,2182,N,NS,3,21,24,1,Spring2019
1476,N Greeley & Ainsworth,2183,S,NS,22,2,24,4,Spring2019
1477,N Greeley & Bryant ,2185,N,NS,2,22,24,3,Spring2019
1484,N Greeley & Bryant,2186,S,NS,32,2,34,3,Spring2019
1485,N Greeley & Dekum,2190,N,NS,1,11,12,0,Spring2019
1486,N Greeley & Dekum,2191,S,NS,13,1,14,0,Spring2019
1487,N Greeley & Going Overpass,2195,N,AT,7,10,17,1,Spring2019
1488,N Greeley & Going,2196,S,NS,4,3,7,0,Spring2019
1489,N Greeley & Holman,2197,N,NS,2,12,14,0,Spring2019
1490,N Greeley & Holman,2198,S,NS,20,2,22,0,Spring2019
1491,N Greeley & Jessup,2205,S,NS,15,1,16,1,Spring2019
1492,N Greeley & Jessup,2206,N,NS,3,13,16,1,Spring2019
1493,N Greeley & Killingsworth,2208,N,NS,8,41,49,2,Spring2019
1494,N Greeley & Killingsworth,2209,S,NS,43,15,58,3,Spring2019
1495,N Greeley & Lombard St,2212,N,NS,1,35,36,4,Spring2019
1496,N Greeley & Lombard St,2213,S,FS,36,6,42,5,Spring2019
1497,N Greeley & Rosa Parks Way,2221,N,FS,4,22,26,2,Spring2019
1498,N Greeley & Rosa Parks Way,2222,S,NS,27,3,30,5,Spring2019
1499,N Greeley & Sumner,2226,N,NS,12,28,40,3,Spring2019
1500,N Greeley & Sumner,2227,S,OP,33,20,53,2,Spring2019
1501,SW Greenburg & Cascade,2230,E,OP,42,25,67,20,Spring2019
1502,SW Greenburg & Cascade,2231,S,FS,28,43,71,13,Spring2019
1503,SW Greenburg & Center,2232,N,FS,57,28,85,8,Spring2019
1504,SW Greenburg & Center,2233,S,NS,20,44,64,5,Spring2019
1505,SW Greenburg & North Dakota,2234,N,FS,26,25,51,8,Spring2019
1506,SW Greenburg & North Dakota,2235,S,OP,32,23,55,9,Spring2019
1507,SW Greenburg & 92nd,2237,E,FS,7,8,15,10,Spring2019
1508,SW Greenburg & 90th,2238,W,FS,6,4,10,5,Spring2019
1509,SW Greenburg & 92nd,2239,W,FS,9,10,19,7,Spring2019
1510,SW Greenburg & Lincoln,2240,S,NS,9,6,15,2,Spring2019
1511,SW Greenburg & 95th,2242,W,NS,6,8,14,0,Spring2019
1512,SW Greenburg & 95th,2243,E,FS,11,8,19,0,Spring2019
1513,SW Greenburg & 98th,2245,W,OP,11,13,24,0,Spring2019
1514,SW Greenburg & 98th,2246,E,FS,13,11,24,1,Spring2019
1515,200 Block Greenridge,2247,W,OP,0,7,7,0,Spring2019
1516,200 Block Greenridge,2248,E,AT,7,0,7,0,Spring2019
1517,Greenridge & Greenridge Ct,2249,N,OP,0,0,0,0,Spring2019
1518,Greenridge & Greenridge Ct,2250,S,FS,0,1,1,0,Spring2019
1519,Greenridge & SW Monroe Pkwy,2251,N,NS,0,0,0,0,Spring2019
1520,SW Greenway & Council Crest,2252,N,FS,1,0,1,0,Spring2019
1521,Gresham Transit Center,2253,E,AT,1181,917,2098,428,Spring2019
1522,SW Haines & Lesser,2257,E,NS,3,4,7,0,Spring2019
1523,5500 Block SW Hall,2260,N,AT,22,14,36,38,Spring2019
1524,6200 Block SW Hall,2261,N,AT,17,12,29,0,Spring2019
1525,7800 Block SW Hall,2262,N,AT,26,9,35,0,Spring2019
1526,7800 Block SW Hall,2263,S,AT,10,24,34,1,Spring2019
1527,9800 Block SW Hall,2264,N,AT,3,1,4,0,Spring2019
1528,SW Hall & Allen,2267,N,NS,52,99,151,19,Spring2019
1529,3600 Block SW Hall,2268,E,AT,18,19,37,7,Spring2019
1530,SW Hall & Broadway,2271,N,FS,2,77,79,14,Spring2019
1537,SW Hall & Cascade ,2272,E,NS,13,28,41,3,Spring2019
1538,SW Hall & Cedar Hills ,2273,W,NS,16,31,47,10,Spring2019
1539,SW Hall & Colony ,2274,W,NS,8,6,14,3,Spring2019
1540,SW Hall & Creekside ,2275,W,OP,35,16,51,4,Spring2019
1541,SW Hall & Creekside ,2276,E,FS,11,25,36,2,Spring2019
1542,SW Hall & Cresmoor ,2277,W,NS,6,2,8,3,Spring2019
1543,SW Hall & Denney ,2278,N,FS,25,11,36,1,Spring2019
1544,SW Hall & Denney ,2279,S,FS,12,28,40,1,Spring2019
1545,SW Hall & Green Lane ,2280,S,NS,4,9,13,0,Spring2019
1546,SW Hall & Greenburg ,2282,E,FS,4,3,7,0,Spring2019
1547,SW Hall & Greenway ,2283,E,FS,31,68,99,11,Spring2019
1548,SW Hall & Greenway ,2284,W,FS,57,21,78,13,Spring2019
1549,SW Hall & Hart ,2285,N,FS,25,11,36,8,Spring2019
1550,SW Hall & Hart ,2286,S,FS,10,27,37,5,Spring2019
1551,SW Hall & Hemlock ,2287,N,FS,4,2,6,4,Spring2019
1552,SW Hall & Nimbus ,2290,E,FS,19,48,67,10,Spring2019
1553,SW Hall & Ridgecrest ,2291,W,FS,12,7,19,0,Spring2019
1554,SW Hall & Ridgecrest ,2292,E,OP,9,28,37,5,Spring2019
1555,SW Hall & Scholls Ferry ,2295,W,NS,77,28,105,10,Spring2019
1556,SW Hall & Scholls Ferry ,2296,E,FS,19,61,80,9,Spring2019
1557,SW Hall & Sussex ,2297,N,NS,13,11,24,2,Spring2019
1558,SW Hall & Washington ,2298,W,FS,0,0,0,0,Spring2019
1559,SW Hall & Washington ,2299,E,FS,2,3,5,3,Spring2019
1560,SW Hall & 13th,2300,N,OP,18,7,25,1,Spring2019
1561,SW Hall & 13th,2301,S,NS,25,43,68,15,Spring2019
1562,SW Hall & 2nd,2302,N,FS,20,43,63,17,Spring2019
1563,SW Hall & 22nd,2303,S,NS,14,19,33,1,Spring2019
1564,SW Hall & 5th,2305,N,NS,25,38,63,35,Spring2019
1565,SW Hall & 88th,2307,W,FS,1,0,1,0,Spring2019
1566,SW Hall & 88th,2308,E,OP,0,0,0,0,Spring2019
1567,SW Hall & 91st,2311,W,FS,0,1,1,0,Spring2019
1568,SW Hall & 91st,2312,E,OP,0,0,0,0,Spring2019
1569,N Halleck & Delaware ,2315,N,OP,11,13,24,3,Spring2019
1570,N Halleck & Delaware ,2316,E,NS,10,11,21,0,Spring2019
1571,N Halleck & Peninsular ,2317,W,NS,4,12,16,0,Spring2019
1572,NE Halsey & 148th ,2320,E,FS,3,13,16,4,Spring2019
1573,NE Halsey & 176th ,2322,E,NS,1,6,7,2,Spring2019
1574,NE Halsey & 196th ,2326,W,FS,17,2,19,0,Spring2019
1575,NE Halsey & Market Dr ,2327,E,NS,5,23,28,22,Spring2019
1576,23300 Block NE Halsey ,2330,E,AT,5,19,24,8,Spring2019
1577,23300 Block NE Halsey ,2331,W,AT,16,9,25,6,Spring2019
1578,23900 Block NE Halsey ,2333,W,AT,4,1,5,0,Spring2019
1579,2100 Block SW Halsey (Edgefield Manor),2339,E,AT,1,10,11,1,Spring2019
1580,2100 Block SW Halsey (Edgefield Manor),2340,W,OP,8,2,10,0,Spring2019
1581,NE Halsey & Fairview/223rd,2341,E,FS,25,77,102,18,Spring2019
1582,NE Halsey & Fairview/223rd,2342,W,FS,39,8,47,8,Spring2019
1583,NE Halsey & 100th ,2343,W,FS,35,65,100,24,Spring2019
1590,SW Halsey & Halsey Loop,2345,E,FS,1,12,13,0,Spring2019
1591,SW Halsey & Halsey Loop,2346,W,FS,14,1,15,1,Spring2019
1592,NE Halsey & 176th ,2349,W,OP,9,1,10,1,Spring2019
1593,12400 Block NE Halsey,2352,W,OP,28,55,83,17,Spring2019
1594,NE Halsey & Wasco ,2353,E,NS,2,12,14,2,Spring2019
1595,NE 102nd & Halsey ,2354,N,NS,1,1,2,1,Spring2019
1596,10500 Block NE Halsey,2356,E,AT,47,25,72,29,Spring2019
1597,NE Halsey & 108th,2357,E,OP,11,21,32,21,Spring2019
1598,NE Halsey & 111th,2358,E,NS,12,35,47,21,Spring2019
1599,NE Halsey & 114th,2360,E,NS,14,19,33,8,Spring2019
1600,NE Halsey & 114th,2361,W,NS,15,6,21,5,Spring2019
1601,NE Halsey & 119th,2364,E,OP,4,18,22,6,Spring2019
1602,NE Halsey & 119th,2365,W,NS,12,6,18,4,Spring2019
1603,NE Halsey & 122nd,2366,E,FS,101,126,227,99,Spring2019
1604,NE Halsey & 122nd,2367,W,FS,103,48,151,66,Spring2019
1605,NE Halsey & 126th,2368,E,NS,3,10,13,4,Spring2019
1606,NE Halsey & 126th,2369,W,NS,7,3,10,2,Spring2019
1607,NE Halsey & 128th,2370,E,NS,2,7,9,2,Spring2019
1608,NE Halsey & 129th Pl,2373,W,NS,4,1,5,0,Spring2019
1609,NE Halsey & 131st Pl,2374,E,NS,6,29,35,8,Spring2019
1610,NE Halsey & 132nd,2375,W,NS,34,5,39,4,Spring2019
1611,NE Halsey & 136th Pl,2378,E,NS,2,11,13,4,Spring2019
1612,NE Halsey & 136th Pl,2379,W,OP,8,3,11,3,Spring2019
1613,NE Halsey & 140th,2380,E,OP,0,4,4,1,Spring2019
1614,NE Halsey & 141st,2381,W,FS,4,0,4,0,Spring2019
1615,NE Halsey & 143rd,2382,W,FS,4,1,5,0,Spring2019
1616,NE Halsey & 143rd,2383,E,OP,0,4,4,0,Spring2019
1617,NE Halsey & 146th,2384,W,FS,2,1,3,0,Spring2019
1618,NE Halsey & 146th,2385,E,OP,0,1,1,0,Spring2019
1619,NE Halsey & 148th,2386,W,NS,11,4,15,5,Spring2019
1620,NE Halsey & 155th,2389,E,NS,2,16,18,1,Spring2019
1621,NE Halsey & 155th,2390,W,NS,16,2,18,0,Spring2019
1622,NE Halsey & 157th,2391,E,NS,1,4,5,0,Spring2019
1623,NE Halsey & 157th,2392,W,NS,6,1,7,1,Spring2019
1624,NE Halsey & 160th,2393,E,FS,4,14,18,2,Spring2019
1625,NE Halsey & 162nd,2395,W,NS,67,21,88,6,Spring2019
1626,NE Halsey & 162nd,2396,E,NS,20,51,71,6,Spring2019
1627,NE Halsey & 168th Pl,2397,E,NS,3,17,20,2,Spring2019
1628,NE Halsey & 169th,2398,W,NS,21,3,24,2,Spring2019
1629,NE Halsey & 172nd,2399,W,OP,41,12,53,5,Spring2019
1630,NE Halsey & 172nd,2400,E,FS,12,42,54,7,Spring2019
1631,NE Halsey & 181st,2401,E,NS,48,77,125,26,Spring2019
1632,NE Halsey & 186th,2405,E,NS,10,16,26,8,Spring2019
1633,NE Halsey & 186th,2406,W,OP,12,8,20,9,Spring2019
1634,NE Halsey & 192nd,2407,W,FS,17,6,23,1,Spring2019
1635,NE Halsey & 192nd,2408,E,NS,5,20,25,3,Spring2019
1636,NE Halsey & 195th,2409,E,FS,3,15,18,2,Spring2019
1643,NE Halsey & 201st,2410,E,FS,14,37,51,1,Spring2019
1644,NE Halsey & 201st,2411,W,FS,40,18,58,3,Spring2019
1645,NE Halsey & Fairview Parkway,2414,W,NS,8,2,10,2,Spring2019
1646,NE Halsey & Fairview Parkway,2415,E,FS,2,6,8,3,Spring2019
1647,NE Halsey & 227th,2416,E,OP,14,54,68,23,Spring2019
1648,NE Halsey & 230th Ct,2418,E,NS,14,33,47,3,Spring2019
1649,NE Halsey & 230th Ct,2419,W,OP,42,11,53,5,Spring2019
1650,NE Halsey & 238th,2420,W,FS,74,50,124,20,Spring2019
1651,NE Halsey & 238th,2421,E,FS,16,34,50,9,Spring2019
1652,NE Halsey & 244th,2422,E,NS,2,22,24,11,Spring2019
1653,NE Halsey & 244th,2423,W,FS,19,2,21,7,Spring2019
1654,NE Halsey & 49th,2425,W,NS,3,3,6,0,Spring2019
1655,NE Halsey & 50th,2426,E,OP,5,7,12,1,Spring2019
1656,NE Halsey & 53rd,2428,W,NS,14,6,20,1,Spring2019
1657,NE Halsey & 53rd,2429,E,NS,5,18,23,4,Spring2019
1658,NE Halsey & 55th,2430,E,OP,4,9,13,1,Spring2019
1659,NE Halsey & 55th,2431,W,NS,7,3,10,1,Spring2019
1660,NE Halsey & 57th,2432,W,NS,29,22,51,7,Spring2019
1661,NE Halsey & 58th,2434,E,NS,29,37,66,29,Spring2019
1662,NE Halsey & Village St,2436,E,FS,5,16,21,2,Spring2019
1663,NE Halsey & 7th St,2437,W,FS,38,9,47,23,Spring2019
1664,NE Halsey & 60th,2438,W,FS,16,17,33,19,Spring2019
1665,NE Halsey & 60th,2439,E,FS,29,19,48,8,Spring2019
1666,NE Halsey & 63rd,2440,E,NS,12,12,24,8,Spring2019
1667,NE Halsey & 63rd,2441,W,NS,12,8,20,5,Spring2019
1668,NE Halsey & 66th,2442,E,OP,50,48,98,11,Spring2019
1669,NE Halsey & 66th,2443,W,NS,51,47,98,19,Spring2019
1670,NE Halsey & 69th,2445,W,OP,17,15,32,7,Spring2019
1671,NE Halsey & 69th,2446,E,AT,16,17,33,3,Spring2019
1672,NE Halsey & 72nd,2448,E,OP,8,12,20,7,Spring2019
1673,NE Halsey & 74th,2450,E,NS,7,17,24,1,Spring2019
1674,NE Halsey & 74th,2451,W,OP,17,9,26,1,Spring2019
1675,NE Halsey & 76th,2452,E,NS,2,5,7,2,Spring2019
1676,NE Halsey & 76th,2453,W,NS,7,2,9,0,Spring2019
1677,NE Halsey & 78th,2454,E,NS,2,4,6,1,Spring2019
1678,NE Halsey & 79th,2455,W,OP,3,2,5,1,Spring2019
1679,NE Halsey & 86th,2456,E,OP,4,6,10,2,Spring2019
1680,NE Halsey & 86th,2457,W,NS,4,2,6,0,Spring2019
1681,NE Halsey & 88th,2458,E,FS,2,5,7,8,Spring2019
1682,NE Halsey & 90th,2459,W,FS,3,1,4,9,Spring2019
1683,NE Halsey & 92nd,2460,E,NS,5,10,15,1,Spring2019
1684,SW Hamilton & 55th Pl,2461,W,FS,0,0,0,0,Spring2019
1685,5700 Block SW Hamilton,2462,E,AT,1,0,1,0,Spring2019
1686,SW Hamilton & Semler Way,2463,W,NS,0,3,3,0,Spring2019
1687,6200 Block SW Hamilton,2464,E,AT,4,0,4,0,Spring2019
1688,SW Hamilton & Scholls Ferry,2465,E,FS,0,0,0,0,Spring2019
1689,SW Hamilton & Dosch,2466,E,NS,0,0,0,0,Spring2019
1696,SW Hamilton & Dosch,2467,W,NS,20,8,28,0,Spring2019
1697,SW Hamilton & Hamilton Ct,2468,E,FS,1,0,1,0,Spring2019
1698,SW Hamilton & Hamilton Ct,2469,W,OP,0,1,1,0,Spring2019
1699,SW Hamilton & Scholls Ferry,2470,W,NS,0,0,0,0,Spring2019
1700,SW Hamilton & Shattuck,2471,W,NS,0,1,1,0,Spring2019
1701,SW Hamilton & Shattuck,2472,E,NS,4,0,4,0,Spring2019
1702,SW Hamilton & 34th,2473,W,FS,0,1,1,0,Spring2019
1703,SW Hamilton & 34th,2474,E,NS,0,0,0,0,Spring2019
1704,SW Hamilton & 36th Pl,2475,W,FS,0,0,0,0,Spring2019
1705,SW Hamilton & 36th Pl,2476,E,OP,0,0,0,0,Spring2019
1706,SW Hamilton & 39th Dr,2477,E,FS,0,0,0,0,Spring2019
1707,SW Hamilton & 39th Dr,2478,W,OP,0,0,0,0,Spring2019
1708,SW Hamilton & 41st,2479,W,NS,0,0,0,0,Spring2019
1709,SW Hamilton & 42nd Pl,2480,E,NS,0,0,0,0,Spring2019
1710,SW Hamilton & 45th,2481,W,OP,0,1,1,0,Spring2019
1711,SW Hamilton & 45th,2482,E,NS,1,0,1,0,Spring2019
1712,SW Hamilton & 47th Dr,2483,W,FS,0,1,1,0,Spring2019
1713,SW Hamilton & 47th,2484,E,FS,1,0,1,0,Spring2019
1714,SW Hamilton & 53rd,2486,E,FS,4,0,4,0,Spring2019
1715,SW Hamilton & 54th Pl,2487,W,FS,0,0,0,0,Spring2019
1716,SW Hamilton & 58th,2490,E,OP,0,0,0,0,Spring2019
1717,SW Hamilton & 60th Pl,2492,E,NS,1,0,1,0,Spring2019
1718,6900 Block SW Hampton,2494,E,AT,11,50,61,13,Spring2019
1719,SW Hampton & 72nd,2496,E,FS,1,15,16,2,Spring2019
1720,SE Harmony & Linwood,2498,E,FS,11,6,17,1,Spring2019
1721,12400 Block SE Harold,2505,E,AT,0,2,2,0,Spring2019
1722,12400 Block SE Harold,2506,W,AT,2,0,2,0,Spring2019
1723,12900 Block SE Harold,2507,W,AT,5,0,5,0,Spring2019
1724,SE Harold & 133rd,2510,W,OP,6,0,6,0,Spring2019
1725,SE Harold & 92nd,2512,E,FS,18,15,33,3,Spring2019
1726,SE Harold & 101st,2517,E,FS,1,14,15,0,Spring2019
1727,SE Harold & 103rd,2518,E,NS,1,11,12,0,Spring2019
1728,SE Harold & 105th,2520,E,OP,1,6,7,0,Spring2019
1729,SE Harold & 109th,2522,E,FS,1,3,4,0,Spring2019
1730,SE Harold & 109th,2523,W,NS,4,1,5,0,Spring2019
1731,SE Harold & 111th,2524,E,OP,1,3,4,0,Spring2019
1732,SE Harold & 111th,2525,W,NS,3,2,5,0,Spring2019
1733,SE Harold & 113th,2526,E,OP,0,2,2,0,Spring2019
1734,SE Harold & 113th,2527,W,NS,3,0,3,0,Spring2019
1735,SE Harold & 115th,2528,E,NS,1,5,6,0,Spring2019
1736,SE Harold & 115th,2529,W,NS,7,0,7,0,Spring2019
1737,SE Harold & 118th,2530,E,OP,0,5,5,1,Spring2019
1738,SE Harold & 118th,2531,W,NS,6,0,6,1,Spring2019
1739,SE Harold & 122nd,2534,E,NS,16,21,37,4,Spring2019
1740,SE Harold & 122nd,2535,W,FS,26,13,39,0,Spring2019
1741,SE Harold & 128th,2537,E,NS,1,8,9,3,Spring2019
1742,SE Harold & 128th,2538,W,NS,9,1,10,0,Spring2019
1749,SE Harold & 136th,2539,E,NS,5,20,25,0,Spring2019
1750,SE Harold & 136th,2540,W,FS,26,4,30,0,Spring2019
1751,SE Harold & 52nd,2541,W,NS,40,18,58,0,Spring2019
1752,SE Harold & 54th,2542,E,NS,6,11,17,0,Spring2019
1753,SE Harold & 57th,2544,E,NS,2,13,15,0,Spring2019
1754,SE Harold & 57th,2545,W,FS,15,2,17,0,Spring2019
1755,SE Harold & 60th,2546,E,NS,2,20,22,0,Spring2019
1756,SE Harold & 60th,2547,W,NS,27,3,30,0,Spring2019
1757,SE Harold & 62nd,2548,E,NS,3,14,17,0,Spring2019
1758,SE Harold & 62nd,2549,W,NS,15,2,17,0,Spring2019
1759,SE Harold & 65th,2550,E,NS,2,19,21,0,Spring2019
1760,SE Harold & 67th,2551,E,NS,4,20,24,0,Spring2019
1761,SE Harold & 69th,2552,E,NS,3,9,12,0,Spring2019
1762,SE Harold & 69th,2553,W,FS,13,1,14,0,Spring2019
1763,SE Harold & 72nd,2554,W,NS,40,15,55,4,Spring2019
1764,SE Harold & 72nd,2555,E,FS,16,40,56,4,Spring2019
1765,SE Harold & 74th,2557,E,NS,2,9,11,1,Spring2019
1766,SE Harold & 74th,2558,W,NS,14,1,15,1,Spring2019
1767,SE Harold & 79th,2561,E,OP,3,14,17,3,Spring2019
1768,SE 79th & Harold,2562,S,NS,17,6,23,4,Spring2019
1769,SE Harold & 92nd,2563,W,NS,16,27,43,6,Spring2019
1770,SE Harold & 97th,2564,E,NS,5,13,18,0,Spring2019
1771,SE Harold & 97th,2565,W,NS,17,5,22,1,Spring2019
1772,200 Block SW Harrison,2566,E,AT,181,34,215,7,Spring2019
1773,200 Block SW Harrison,2567,W,OP,29,293,322,15,Spring2019
1774,SE Harrison & Hwy 224,2568,E,NS,28,19,47,12,Spring2019
1775,SE Harrison & 24th,2569,E,OP,35,11,46,13,Spring2019
1776,SE Harrison & 24th,2570,W,NS,6,17,23,12,Spring2019
1777,2700 Block SE Harrison,2571,W,OP,10,31,41,2,Spring2019
1778,SE Harrison & 28th,2572,E,NS,30,7,37,3,Spring2019
1779,SE Harrison & 29th,2573,W,NS,11,24,35,12,Spring2019
1780,SE Harrison & 31st,2574,W,NS,49,89,138,44,Spring2019
1781,SE Harrison & 32nd,2575,E,FS,60,43,103,27,Spring2019
1782,SE Harrison & 34th,2577,W,NS,7,14,21,3,Spring2019
1783,SE Harrison & 37th,2578,E,NS,6,7,13,1,Spring2019
1784,SE Harrison & 37th,2579,W,NS,4,5,9,3,Spring2019
1785,SW Harrison & 4th,2580,E,NS,290,70,360,20,Spring2019
1786,SE Harrison & 40th,2582,E,NS,3,7,10,2,Spring2019
1787,SE Harrison & 40th,2583,W,NS,9,4,13,0,Spring2019
1788,Rose Quarter Transit Center,2592,W,AT,673,1121,1794,265,Spring2019
1789,SE Hawthorne & 6th,2594,E,NS,314,210,524,52,Spring2019
1790,SE Hawthorne & Maple,2595,E,FS,32,31,63,1,Spring2019
1791,SE Hawthorne & Poplar,2596,E,NS,16,33,49,4,Spring2019
1792,SE Hawthorne & 9th,2597,E,NS,39,33,72,5,Spring2019
1793,SE Hawthorne & 12th,2599,E,NS,204,189,393,22,Spring2019
1794,SE Hawthorne & 14th,2602,W,FS,38,41,79,6,Spring2019
1795,SE Hawthorne & 16th,2603,E,FS,43,62,105,41,Spring2019
1802,SE Hawthorne & 16th,2604,W,NS,72,37,109,47,Spring2019
1803,SE Hawthorne & 19th,2606,W,FS,68,28,96,11,Spring2019
1804,SE Hawthorne & 20th,2607,E,FS,32,54,86,10,Spring2019
1805,SE Hawthorne & 23rd,2608,E,NS,29,39,68,1,Spring2019
1806,SE Hawthorne & 22nd,2609,W,NS,71,43,114,8,Spring2019
1807,SE Hawthorne & 25th,2611,W,FS,50,17,67,14,Spring2019
1808,SE Hawthorne & 25th,2612,E,FS,16,38,54,3,Spring2019
1809,SE Hawthorne & 27th,2613,W,NS,94,64,158,17,Spring2019
1810,SE Hawthorne & 28th,2614,E,OP,56,138,194,28,Spring2019
1811,SE Hawthorne & 30th,2615,E,NS,28,66,94,3,Spring2019
1812,SE Hawthorne & 30th,2616,W,NS,81,31,112,6,Spring2019
1813,SE Hawthorne & 32nd Pl,2617,E,FS,14,45,59,3,Spring2019
1814,SE Hawthorne & 32nd,2619,W,NS,42,18,60,1,Spring2019
1815,SE Hawthorne & 34th,2620,E,FS,42,84,126,7,Spring2019
1816,SE Hawthorne & 37th,2623,E,FS,45,124,169,28,Spring2019
1817,SE Hawthorne & 37th,2624,W,NS,106,41,147,19,Spring2019
1818,SE Hawthorne & Cesar Chavez Blvd,2625,E,NS,163,217,380,62,Spring2019
1819,SE Hawthorne & Cesar Chavez Blvd,2626,W,FS,211,159,370,116,Spring2019
1820,SE Hawthorne & 41st,2628,E,NS,51,77,128,14,Spring2019
1821,SE Hawthorne & 41st,2629,W,NS,55,41,96,15,Spring2019
1822,SE Hawthorne & 44th,2630,E,NS,22,51,73,5,Spring2019
1823,SE Hawthorne & 44th,2632,W,FS,62,26,88,5,Spring2019
1824,SE Hawthorne & 47th,2633,E,FS,33,72,105,10,Spring2019
1825,SE Hawthorne & 47th,2635,W,OP,63,24,87,9,Spring2019
1826,Hawthorne Bridge,2641,E,AT,89,97,186,8,Spring2019
1827,Hawthorne Bridge,2642,W,AT,82,111,193,9,Spring2019
1828,Hawthorne Bridge Ramp & SE M L King,2643,E,FS,36,231,267,24,Spring2019
1829,N Hayden Meadows Dr & Whitaker,2648,E,FS,22,22,44,22,Spring2019
1830,SW Heiney & Binford Lake,2650,S,NS,6,1,7,0,Spring2019
1831,S High & 1st,2662,N,NS,1,3,4,0,Spring2019
1832,S High & 1st,2663,S,FS,3,1,4,0,Spring2019
1833,High & 3rd,2664,N,NS,4,8,12,1,Spring2019
1834,High & 5th,2666,N,NS,4,7,11,7,Spring2019
1835,SW Highland & Linneman,2667,E,FS,0,0,0,0,Spring2019
1836,SW Highland & Linneman,2668,W,OP,0,0,0,0,Spring2019
1837,SW Highland & 11th St,2669,N,FS,16,6,22,2,Spring2019
1838,SW Highland & 11th St,2670,S,FS,4,0,4,0,Spring2019
1839,SW Highland & 14th Dr,2671,E,NS,0,0,0,0,Spring2019
1840,Hillsboro Transit Center,2672,E,AT,142,62,204,39,Spring2019
1841,Holcomb & Apperson,2674,E,OP,0,4,4,0,Spring2019
1842,Holcomb & Apperson,2675,W,NS,8,0,8,0,Spring2019
1843,S Holcomb & Hunter Ave,2679,W,NS,2,0,2,0,Spring2019
1844,S Holcomb & Swan Ave,2681,E,NS,0,1,1,0,Spring2019
1845,S Holcomb & Swan Ave,2682,W,NS,4,0,4,0,Spring2019
1846,SE Holgate & 117th,2683,W,NS,19,1,20,0,Spring2019
1847,SE Holgate & 125th,2684,E,FS,0,1,1,0,Spring2019
1848,SE Holgate & 134th Dr,2685,E,NS,105,129,234,38,Spring2019
1855,SE Holgate & 100th,2686,E,FS,2,19,21,1,Spring2019
1856,SE Holgate & 101st,2687,W,FS,20,2,22,1,Spring2019
1857,SE Holgate & 103rd,2690,W,NS,78,15,93,19,Spring2019
1858,SE Holgate & 104th,2691,E,NS,14,70,84,35,Spring2019
1859,SE Holgate & 107th,2692,E,OP,1,7,8,0,Spring2019
1860,SE Holgate & 108th Pl,2695,W,OP,11,3,14,1,Spring2019
1861,SE Holgate & 112th,2696,E,NS,6,46,52,5,Spring2019
1862,SE Holgate & 112th,2697,W,NS,53,11,64,5,Spring2019
1863,SE Holgate & 115th,2699,E,FS,2,28,30,1,Spring2019
1864,SE Holgate & 115th,2700,W,NS,26,2,28,0,Spring2019
1865,SE Holgate & 118th,2701,E,NS,0,24,24,2,Spring2019
1866,SE Holgate & 122nd,2703,E,FS,26,171,197,61,Spring2019
1867,SE Holgate & 122nd,2705,W,FS,103,12,115,32,Spring2019
1868,SE Holgate & 128th,2706,E,NS,1,19,20,9,Spring2019
1869,SE Holgate & 130th,2707,E,FS,0,12,12,19,Spring2019
1870,SE Holgate & 136th,2708,E,NS,28,2,30,1,Spring2019
1871,SE Holgate & 26th,2712,E,NS,16,25,41,3,Spring2019
1872,SE Holgate & 26th,2713,W,NS,24,13,37,3,Spring2019
1873,SE Holgate & 28th,2714,E,FS,45,86,131,4,Spring2019
1874,SE Holgate & 28th,2715,W,NS,102,50,152,4,Spring2019
1875,SE Holgate & 32nd,2718,E,OP,44,53,97,87,Spring2019
1876,SE Holgate & 32nd,2719,W,NS,46,42,88,96,Spring2019
1877,SE Holgate & 34th,2720,E,NS,8,30,38,2,Spring2019
1878,SE Holgate & 34th,2721,W,OP,31,9,40,5,Spring2019
1879,SE Holgate & 36th,2722,E,NS,6,30,36,2,Spring2019
1880,SE Holgate & 36th,2723,W,NS,51,7,58,4,Spring2019
1881,SE Holgate & Cesar Chavez Blvd,2726,E,OP,60,136,196,78,Spring2019
1882,SE Holgate & Cesar Chavez Blvd,2727,W,NS,124,65,189,81,Spring2019
1883,SE Holgate & 41st,2728,E,NS,10,42,52,4,Spring2019
1884,SE Holgate & 41st,2729,W,OP,45,9,54,4,Spring2019
1885,SE Holgate & 45th,2732,E,NS,3,34,37,1,Spring2019
1886,SE Holgate & 45th,2733,W,NS,25,4,29,0,Spring2019
1887,SE Holgate & 47th,2734,E,NS,3,15,18,1,Spring2019
1888,SE Holgate & 47th,2735,W,NS,15,4,19,1,Spring2019
1889,SE Holgate & 49th,2736,E,NS,3,19,22,0,Spring2019
1890,SE Holgate & 49th,2737,W,NS,22,4,26,1,Spring2019
1891,SE Holgate & 52nd,2738,E,FS,41,66,107,9,Spring2019
1892,SE Holgate & 52nd,2739,W,FS,75,38,113,15,Spring2019
1893,SE Holgate & 56th,2740,E,NS,3,8,11,1,Spring2019
1894,SE Holgate & 56th,2741,W,NS,12,2,14,0,Spring2019
1895,SE Holgate & 58th,2742,E,NS,6,25,31,5,Spring2019
1896,SE Holgate & 58th,2743,W,NS,29,7,36,5,Spring2019
1897,SE Holgate & 62nd,2746,E,NS,33,66,99,8,Spring2019
1898,SE Holgate & 62nd,2747,W,OP,49,23,72,6,Spring2019
1899,SE Holgate & 64th,2748,W,NS,38,31,69,10,Spring2019
1900,SE Holgate & 65th,2749,E,NS,23,28,51,17,Spring2019
1901,SE Holgate & 67th,2750,E,FS,9,18,27,2,Spring2019
1908,SE Holgate & 67th,2751,W,NS,25,14,39,15,Spring2019
1909,SE Holgate & 70th,2752,E,NS,7,13,20,0,Spring2019
1910,SE Holgate & 70th,2753,W,NS,15,7,22,2,Spring2019
1911,SE Holgate & 72nd,2754,E,NS,6,20,26,1,Spring2019
1912,SE Holgate & 72nd,2755,W,NS,23,7,30,3,Spring2019
1913,SE Holgate & 74th,2756,W,NS,19,3,22,6,Spring2019
1914,SE Holgate & 75th,2757,E,NS,4,17,21,15,Spring2019
1915,SE Holgate & 77th,2758,E,FS,1,13,14,0,Spring2019
1916,SE Holgate & 77th,2759,W,OP,14,2,16,0,Spring2019
1917,SE Holgate & 79th,2760,E,NS,9,49,58,23,Spring2019
1918,SE Holgate & 79th,2761,W,NS,41,13,54,13,Spring2019
1919,SE Holgate & 83rd,2762,E,NS,183,208,391,172,Spring2019
1920,SE Holgate & 82nd,2763,W,FS,152,105,257,70,Spring2019
1921,SE Holgate & 88th,2767,E,FS,7,37,44,3,Spring2019
1922,SE Holgate & 88th,2768,W,NS,37,10,47,2,Spring2019
1923,NE Hood & 9th,2798,S,OP,0,17,17,4,Spring2019
1924,SW Huber & Capitol Hwy,2804,E,FS,6,3,9,0,Spring2019
1925,SW Huber & 35th,2806,E,NS,4,1,5,0,Spring2019
1926,SW Huber & 40th,2809,W,FS,1,1,2,0,Spring2019
1927,7500 Block SW Hunziker,2810,W,AT,4,1,5,0,Spring2019
1928,8000 Block SW Hunziker,2811,W,AT,3,0,3,0,Spring2019
1929,8000 Block SW Hunziker,2812,E,OP,1,2,3,0,Spring2019
1930,SW Hunziker & Hall,2815,E,FS,2,1,3,1,Spring2019
1931,SW Hunziker & Knoll,2816,W,NS,2,2,4,3,Spring2019
1932,SW Hunziker & 72nd,2817,W,FS,32,5,37,0,Spring2019
1933,SW Hunziker & 72nd,2818,E,NS,6,44,50,15,Spring2019
1934,29800 Block SE Hwy 211,2819,W,AT,0,0,0,0,Spring2019
1935,SE Hwy 211 & Hwy 224,2824,E,FS,1,2,3,0,Spring2019
1936,Molalla & Char Diaz Dr,2827,S,FS,0,5,5,0,Spring2019
1937,Molalla & Lazy Creek Ln,2828,N,OP,21,1,22,4,Spring2019
1938,Molalla & Sebastian Way,2830,E,NS,0,22,22,2,Spring2019
1939,Molalla & Clairmont,2837,N,FS,88,8,96,12,Spring2019
1940,Molalla & Clairmont,2838,S,FS,6,88,94,14,Spring2019
1941,Molalla & Gaffney Ln,2841,N,NS,51,8,59,40,Spring2019
1942,Molalla & Gaffney Ln,2842,S,FS,8,46,54,25,Spring2019
1943,Molalla & Warner-Milne,2866,S,FS,1,18,19,5,Spring2019
1944,10800 Block SE Highway 212,2868,E,AT,2,13,15,0,Spring2019
1945,SE Hwy 224 & Eckert Ln,2870,S,NS,0,2,2,0,Spring2019
1946,15700 Block SE Hwy 224,2872,S,AT,0,7,7,6,Spring2019
1947,15700 Block SE Hwy 224,2873,N,OP,8,0,8,3,Spring2019
1948,SE Hwy 224 & Springwater Rd,2874,W,OP,4,1,5,1,Spring2019
1949,16200 Block SE Hwy 224,2875,E,AT,1,5,6,2,Spring2019
1950,SE Hwy 224 & Amisigger Rd,2876,W,NS,1,0,1,0,Spring2019
1951,SE Hwy 224 & Amisigger Rd,2877,E,OP,0,1,1,0,Spring2019
1952,SE Hwy 224 & Bartlemay,2878,W,FS,0,0,0,0,Spring2019
1953,SE Hwy 224 & Barton Church,2879,E,AT,1,0,1,1,Spring2019
1954,SE Hwy 224 & Barton Church,2880,W,OP,0,1,1,0,Spring2019
1961,SE Hwy 224 & Bakers Ferry Rd,2881,E,FS,1,6,7,0,Spring2019
1962,SE Hwy 224 & Bakers Ferry Rd,2882,W,OP,6,1,7,1,Spring2019
1963,16400 Block SE Hwy 224,2883,E,OP,0,0,0,0,Spring2019
1964,16400 Block SE Hwy 224,2884,W,AT,1,1,2,0,Spring2019
1965,16000 Block SE Hwy 224,2885,S,FS,0,2,2,0,Spring2019
1966,16000 Block SE Hwy 224,2886,N,NS,1,0,1,0,Spring2019
1967,SE Hwy 212 & Evelyn,2888,E,NS,5,27,32,4,Spring2019
1968,SE Hwy 212 & 102nd,2889,W,FS,11,5,16,1,Spring2019
1969,SE Hwy 212 & 130th,2890,W,NS,10,1,11,0,Spring2019
1970,Hwy 212 & Fred Meyer Dc Entr,2891,E,FS,1,13,14,2,Spring2019
1971,11400 Block SE Hwy 212,2892,W,AT,11,2,13,2,Spring2019
1972,SE Hwy 224 & Hwy 212,2895,S,FS,0,2,2,0,Spring2019
1973,SE Hwy 224 & Hwy 212,2896,N,NS,1,0,1,0,Spring2019
1974,SE Hwy 224 & Marna,2898,W,FS,0,0,0,0,Spring2019
1975,10700 Block SE Hwy 212,2899,W,AT,12,1,13,4,Spring2019
1976,SE Hwy 224 & Odell,2900,E,NS,0,0,0,0,Spring2019
1977,SE Hwy 212 & 122nd,2904,E,FS,2,29,31,1,Spring2019
1978,SE Hwy 212 & 122nd,2905,W,FS,14,2,16,1,Spring2019
1979,SE Hwy 212 & 130th,2906,E,NS,1,10,11,1,Spring2019
1980,SE Hwy 224 & 135th,2907,E,FS,4,16,20,1,Spring2019
1981,SE Hwy 224 & 142nd,2908,E,NS,0,9,9,1,Spring2019
1982,SE Hwy 224 & 142nd,2909,W,NS,8,0,8,1,Spring2019
1983,SE Hwy 224 & 152nd,2910,E,OP,0,1,1,0,Spring2019
1984,SE Hwy 224 & 152nd,2911,W,NS,2,0,2,0,Spring2019
1985,SE Hwy 224 & 197th,2912,E,FS,0,0,0,0,Spring2019
1986,SE Hwy 224 & 197th,2913,W,OP,0,0,0,0,Spring2019
1987,SE Hwy 224 & 82nd Dr,2914,E,NS,37,26,63,6,Spring2019
1988,SE Hwy 212 & 82nd Dr,2915,W,NS,9,29,38,5,Spring2019
1989,N Interstate & Albina,2945,S,NS,14,18,32,2,Spring2019
1990,N Interstate & Graham,2962,N,FS,2,3,5,0,Spring2019
1991,N Interstate & Graham,2964,S,OP,3,2,5,0,Spring2019
1992,N Ivanhoe & Baltimore,3008,N,NS,36,7,43,3,Spring2019
1993,N Ivanhoe & Charleston,3009,E,NS,3,50,53,9,Spring2019
1994,Jackson & 12th,3020,S,NS,3,5,8,1,Spring2019
1995,Jackson & 12th,3021,N,NS,2,4,6,1,Spring2019
1996,Jackson & 15th,3024,S,NS,2,1,3,0,Spring2019
1997,Jackson & 15th,3025,N,NS,2,2,4,0,Spring2019
1998,Jean Rd & Bryant,3030,E,NS,1,0,1,0,Spring2019
1999,Jean Rd & Bryant,3031,W,FS,0,1,1,0,Spring2019
2000,Jean Rd & Schalit,3032,E,FS,1,0,1,0,Spring2019
2001,SW Jean Rd & Tualata,3033,W,OP,0,1,1,0,Spring2019
2002,Jean Rd & Schalit,3036,W,FS,0,1,1,0,Spring2019
2003,SW Jean Rd & Tualata,3038,E,FS,2,0,2,0,Spring2019
2004,SW Jefferson & Broadway,3039,W,NS,12,447,459,32,Spring2019
2005,Jefferson & Independence,3040,S,OP,2,9,11,0,Spring2019
2006,Jefferson & Independence,3041,N,NS,5,0,5,0,Spring2019
2007,2 Jefferson Parkway,3043,E,FS,4,1,5,0,Spring2019
2014,SW Jefferson & McNary,3045,S,FS,1,8,9,0,Spring2019
2015,SW Jefferson Pkwy & McNary Pkwy,3046,N,NS,7,1,8,0,Spring2019
2016,Jefferson & Mt Jefferson,3048,N,FS,2,0,2,0,Spring2019
2017,SW Jefferson & 10th,3049,W,NS,197,357,554,112,Spring2019
2018,SW Jefferson & 13th,3051,W,NS,30,85,115,56,Spring2019
2019,SW Jefferson & 16th,3052,W,NS,55,86,141,5,Spring2019
2020,SW Jefferson & 20th,3054,W,NS,38,18,56,6,Spring2019
2021,Jenkins & Bardeen,3056,E,NS,2,2,4,0,Spring2019
2022,SW Jenkins & Ecole,3062,W,NS,7,10,17,0,Spring2019
2023,SW Jenkins & Briggs,3063,W,FS,4,7,11,1,Spring2019
2024,SW Jenkins & Karl Braun,3064,E,FS,10,3,13,27,Spring2019
2025,SW Jenkins & Hocken,3067,E,NS,12,12,24,3,Spring2019
2026,SW Jenkins & Ecole,3069,E,OP,10,4,14,1,Spring2019
2027,N Vancouver & Jessup,3070,N,NS,6,9,15,2,Spring2019
2028,SE Johnson Creek & 42nd,3076,W,FS,7,15,22,1,Spring2019
2029,SE Johnson Creek & Brookside,3077,N,FS,23,10,33,1,Spring2019
2030,SE Johnson Creek & Brookside,3078,S,OP,9,12,21,2,Spring2019
2031,SE Johnson Creek & Springwater Corridor,3079,N,NS,20,8,28,3,Spring2019
2032,SE Johnson Creek & Springwater Corridor,3080,S,FS,12,27,39,4,Spring2019
2033,SE Johnson Creek & 32nd,3081,W,NS,2,1,3,1,Spring2019
2034,SE Johnson Creek & 36th,3082,W,OP,4,5,9,14,Spring2019
2035,SE Johnson Creek & 36th,3083,E,NS,5,5,10,14,Spring2019
2036,SE Johnson Creek & 42nd,3086,E,FS,16,6,22,2,Spring2019
2037,NE Kane & 18th Ct,3091,N,OP,16,13,29,6,Spring2019
2038,NE Kane & Division,3092,N,FS,52,47,99,74,Spring2019
2039,NE Kane & Division,3093,S,NS,59,54,113,82,Spring2019
2040,NE Kane & SE Stark,3094,N,NS,5,5,10,2,Spring2019
2041,NE Kane & 15th,3097,N,FS,34,35,69,20,Spring2019
2042,NE Kane & 18th Ct,3099,S,NS,21,25,46,20,Spring2019
2043,SE Kane & 2nd,3100,N,OP,0,4,4,1,Spring2019
2044,SE Kane & 2nd,3101,S,FS,4,0,4,0,Spring2019
2045,NE Kane & 2nd Ct,3102,N,OP,4,3,7,2,Spring2019
2046,NE Kane & 23rd,3104,S,FS,29,25,54,4,Spring2019
2047,NE Kane & 23rd,3105,N,FS,27,32,59,4,Spring2019
2048,NE Kane & 8th,3106,S,FS,1,0,1,0,Spring2019
2049,NE Kane & 8th,3107,N,NS,0,1,1,0,Spring2019
2050,SW Kelly & Corbett,3116,N,NS,19,35,54,6,Spring2019
2051,50 Block Kerr Parkway,3125,S,AT,1,7,8,0,Spring2019
2052,50 Block Kerr Parkway,3126,N,OP,7,3,10,0,Spring2019
2053,Kerr & Boones Ferry Rd,3127,S,NS,2,9,11,17,Spring2019
2054,Kerr & Independence,3129,N,FS,0,0,0,0,Spring2019
2055,Kerr & Jefferson Pkwy,3132,N,FS,8,6,14,0,Spring2019
2056,Kerr & McNary,3133,N,FS,6,3,9,0,Spring2019
2057,Kerr & Tanglewood,3134,E,FS,2,3,5,0,Spring2019
2058,Kerr & Tanglewood,3135,W,FS,4,2,6,1,Spring2019
2059,Kerr & The Grotto,3137,S,FS,5,4,9,1,Spring2019
2060,Kerr & The Grotto,3138,N,OP,7,5,12,2,Spring2019
2067,Kerr & Touchstone,3141,E,NS,7,17,24,9,Spring2019
2068,4500 Block NE Killingsworth,3144,E,AT,16,18,34,3,Spring2019
2069,5700 Block NE Killingsworth,3145,E,AT,8,8,16,1,Spring2019
2070,NE Killingsworth & 60th,3146,E,NS,86,68,154,27,Spring2019
2071,6300 Block NE Killingsworth,3147,W,AT,28,38,66,3,Spring2019
2072,NE Killingsworth & 64th,3148,E,FS,45,25,70,3,Spring2019
2073,7700 Block NE Killingsworth,3149,W,AT,0,2,2,0,Spring2019
2074,N Killingsworth & Albina,3153,E,NS,253,47,300,44,Spring2019
2075,N Killingsworth & Albina,3154,W,NS,53,247,300,59,Spring2019
2076,N Killingsworth & Commercial,3156,E,NS,105,16,121,9,Spring2019
2077,N Killingsworth & Commercial,3157,W,FS,25,211,236,27,Spring2019
2078,N Killingsworth & Concord,3158,E,NS,14,2,16,1,Spring2019
2079,N Killingsworth & Concord,3159,W,NS,3,14,17,2,Spring2019
2080,N Killingsworth & Delaware,3160,E,NS,15,2,17,4,Spring2019
2081,N Killingsworth & Delaware,3161,W,NS,1,20,21,4,Spring2019
2082,N Killingsworth & Denver,3162,E,NS,27,3,30,4,Spring2019
2083,N Killingsworth & Denver,3163,W,NS,2,26,28,3,Spring2019
2084,NE Killingsworth & Garfield,3165,E,NS,16,42,58,22,Spring2019
2085,N Greeley & Willamette,3167,S,NS,3,37,40,4,Spring2019
2086,N Killingsworth & Interstate,3169,E,FS,264,54,318,71,Spring2019
2087,N Killingsworth & Interstate,3170,W,NS,48,227,275,90,Spring2019
2088,N Killingsworth & Kerby,3171,E,NS,142,36,178,32,Spring2019
2089,N Killingsworth & Michigan,3173,E,NS,32,9,41,2,Spring2019
2090,N Killingsworth & Michigan,3174,W,NS,9,33,42,4,Spring2019
2091,N Killingsworth & Gay Ave,3179,E,NS,11,1,12,2,Spring2019
2092,N Killingsworth & Omaha,3180,W,NS,2,16,18,1,Spring2019
2093,N Killingsworth & Vancouver,3183,E,NS,92,39,131,32,Spring2019
2094,N Killingsworth & Vancouver,3184,W,NS,63,138,201,50,Spring2019
2095,8100 Block NE Killingsworth,3185,E,AT,55,19,74,10,Spring2019
2096,7600 Block NE Killingsworth,3186,E,AT,5,1,6,1,Spring2019
2097,NE Killingsworth & 31st,3189,W,NS,11,31,42,6,Spring2019
2098,NE Killingsworth & 33rd,3191,E,FS,115,90,205,33,Spring2019
2099,NE Killingsworth & 33rd,3192,W,FS,78,89,167,26,Spring2019
2100,NE Killingsworth & 35th,3193,E,NS,4,6,10,2,Spring2019
2101,NE Killingsworth & 35th,3194,W,NS,6,13,19,5,Spring2019
2102,NE Killingsworth & 36th,3195,E,NS,11,12,23,20,Spring2019
2103,NE Killingsworth & 36th,3196,W,NS,14,11,25,24,Spring2019
2104,NE Killingsworth & Cesar Chavez Blvd,3197,W,NS,8,6,14,1,Spring2019
2105,NE Killingsworth & Cesar Chavez Blvd,3198,E,NS,7,7,14,1,Spring2019
2106,NE Killingsworth & 42nd,3199,E,FS,157,125,282,30,Spring2019
2107,NE Killingsworth & 42nd,3200,W,NS,132,165,297,35,Spring2019
2108,NE Killingsworth & 46th Pl,3201,W,OP,20,15,35,4,Spring2019
2109,NE Killingsworth & 49th,3202,E,FS,34,28,62,14,Spring2019
2110,NE Killingsworth & 49th,3203,W,OP,17,21,38,2,Spring2019
2111,NE Killingsworth & 52nd,3204,E,FS,38,41,79,24,Spring2019
2112,NE Killingsworth & 52nd,3205,W,OP,56,53,109,27,Spring2019
2113,NE Killingsworth & 54th,3207,W,OP,25,30,55,9,Spring2019
2120,NE Killingsworth & 55th,3208,E,NS,34,30,64,5,Spring2019
2121,NE Killingsworth & 57th,3209,W,OP,11,13,24,1,Spring2019
2122,NE Killingsworth & 60th,3210,W,NS,66,81,147,19,Spring2019
2123,NE Killingsworth & 72nd,3211,E,FS,80,37,117,28,Spring2019
2124,NE Killingsworth & 72nd,3212,W,NS,36,78,114,32,Spring2019
2125,NE Killingsworth & 75th,3215,W,NS,1,5,6,1,Spring2019
2126,NE Killingsworth & 82nd,3216,W,FS,20,54,74,6,Spring2019
2127,N Kilpatrick & Brandon,3218,W,NS,8,8,16,6,Spring2019
2128,N Kilpatrick & Brandon,3219,E,NS,6,11,17,3,Spring2019
2129,N Kilpatrick & Denver,3221,W,FS,72,42,114,25,Spring2019
2130,N Kilpatrick & Denver,3222,E,NS,46,67,113,17,Spring2019
2131,7100 Block SE King,3224,E,AT,7,8,15,1,Spring2019
2132,7900 Block SE King,3226,E,AT,5,23,28,5,Spring2019
2133,SE King & Fuller,3228,W,OP,199,28,227,44,Spring2019
2134,SE King & Bell,3229,W,NS,98,20,118,8,Spring2019
2135,SE King & Bell,3230,E,OP,8,46,54,5,Spring2019
2136,SE King & Hollywood,3231,E,OP,12,8,20,2,Spring2019
2137,SE King & Hollywood,3232,W,FS,9,10,19,1,Spring2019
2138,SE King & Home,3233,E,FS,8,8,16,0,Spring2019
2139,SE King & Linwood,3234,E,FS,38,34,72,10,Spring2019
2140,SE King & Linwood,3235,W,NS,39,34,73,16,Spring2019
2141,SW King & Salmon,3236,N,NS,4,1,5,0,Spring2019
2142,SE King & Stanley,3237,W,NS,16,12,28,0,Spring2019
2143,SE King & Stanley,3238,E,NS,10,17,27,1,Spring2019
2144,SE King & 47th,3242,E,NS,7,5,12,1,Spring2019
2145,SE King & 47th,3243,W,OP,5,4,9,0,Spring2019
2146,SE King & 52nd,3245,E,NS,3,5,8,1,Spring2019
2147,SE King & 52nd,3246,W,OP,4,4,8,2,Spring2019
2148,SE King & 66th,3249,W,NS,14,8,22,2,Spring2019
2149,SE King & 66th,3250,E,NS,10,12,22,1,Spring2019
2150,SE King & 74th,3251,E,NS,13,19,32,3,Spring2019
2151,SE King & 77th,3254,W,OP,12,3,15,1,Spring2019
2152,SW Kingston & Japanese Garden,3276,N,OP,9,13,22,0,Spring2019
2153,SW Knight & Kingston,3277,S,FS,0,0,0,0,Spring2019
2154,SW Kingston & Tichner,3279,N,NS,0,0,0,0,Spring2019
2155,SW Knights & Kingston,3291,N,NS,2,0,2,0,Spring2019
2156,Kruse Way & Carman,3293,E,NS,11,1,12,0,Spring2019
2157,Kruse Way & Carman,3294,W,NS,1,11,12,0,Spring2019
2158,Kruse Way & Kruse Oaks,3295,E,FS,7,5,12,4,Spring2019
2159,Kruse Way & Kruse Oaks,3296,W,FS,5,12,17,31,Spring2019
2160,Kruse Way & Daniel Way,3297,W,NS,3,7,10,0,Spring2019
2161,Kruse Way & Kruse Woods,3298,E,FS,16,4,20,20,Spring2019
2162,Kruse Way & Mercantile,3299,E,FS,4,3,7,0,Spring2019
2163,Kruse Way & Westlake Dr,3300,W,FS,2,15,17,3,Spring2019
2164,SE Ladd & Division,3301,N,FS,13,4,17,1,Spring2019
2165,SE Ladd & Division,3302,S,NS,15,19,34,4,Spring2019
2166,SE Ladd & Hawthorne,3303,N,NS,12,42,54,2,Spring2019
2173,SE Ladd & Ladd Circle,3304,S,NS,10,5,15,0,Spring2019
2174,SE Ladd & Ladd Circle,3305,N,NS,13,8,21,1,Spring2019
2175,SE Ladd & Lavender,3307,N,NS,5,2,7,0,Spring2019
2176,SE Ladd & Lavender,3308,S,NS,3,4,7,0,Spring2019
2177,SE Ladd & Palm St,3309,S,NS,7,8,15,0,Spring2019
2178,SE Ladd & Palm,3310,N,NS,9,6,15,0,Spring2019
2179,SE Ladd & 16th,3311,E,NS,9,5,14,0,Spring2019
2180,SE Ladd & 16th,3312,W,NS,6,11,17,0,Spring2019
2181,N Lagoon & Anchor,3315,N,NS,19,61,80,2,Spring2019
2182,N Lagoon & Ballast,3316,N,OP,0,1,1,0,Spring2019
2183,N Lagoon & Commerce,3317,N,NS,0,3,3,0,Spring2019
2184,N Dolphin & Channel,3318,S,NS,2,13,15,0,Spring2019
2185,5500 Block N Lagoon (at Gate 18),3319,N,OP,1,0,1,0,Spring2019
2186,SE Lake & 33rd Pl,3321,W,OP,1,4,5,0,Spring2019
2187,6300 Block SE Lake,3322,S,AT,1,1,2,0,Spring2019
2188,6200 Block SE Lake,3323,N,AT,2,1,3,0,Spring2019
2189,6400 Block SE Lake,3324,S,AT,1,2,3,0,Spring2019
2190,SE Lake & Boss,3325,E,FS,0,0,0,0,Spring2019
2191,SE Lake & Boss,3326,W,OP,0,0,0,0,Spring2019
2192,SE Lake & Harmony,3328,E,NS,1,1,2,0,Spring2019
2193,SE Lake & Harmony,3329,N,NS,0,1,1,0,Spring2019
2194,SE Lake & Lena/51st,3332,W,NS,0,0,0,0,Spring2019
2195,SE Lake & Mintone,3334,W,FS,0,0,0,0,Spring2019
2196,SE Lake & Oatfield,3335,E,FS,1,0,1,0,Spring2019
2197,SE Lake & Oatfield,3336,E,NS,4,2,6,0,Spring2019
2198,6600 Block SE Lake,3337,N,AT,2,1,3,0,Spring2019
2199,6500 Block SE Lake,3338,S,AT,1,1,2,1,Spring2019
2200,SE Lake & Rusk,3339,E,NS,2,1,3,0,Spring2019
2201,SE Lake & Rusk,3340,W,OP,2,2,4,0,Spring2019
2202,SE Lake & Where Else Ln,3343,E,FS,0,2,2,0,Spring2019
2203,SE Lake & 23rd,3344,E,OP,5,0,5,0,Spring2019
2204,SE Lake & 23rd,3345,W,FS,2,4,6,0,Spring2019
2205,SE Lake & 28th,3347,W,OP,1,5,6,1,Spring2019
2206,SE Lake & 28th,3348,E,NS,4,1,5,0,Spring2019
2207,SE Lake & 31st Pl,3349,E,NS,2,2,4,1,Spring2019
2208,SE Lake & 31st Pl,3350,W,OP,2,2,4,0,Spring2019
2209,SE Lake & 34th,3352,W,NS,1,1,2,0,Spring2019
2210,SE Lake & 36th,3353,E,OP,0,0,0,0,Spring2019
2211,SE Lake & 36th,3354,W,FS,0,1,1,0,Spring2019
2212,SE Lake & 51st,3356,E,FS,1,1,2,0,Spring2019
2213,Lake Oswego Transit Center,3363,S,AT,96,6,102,8,Spring2019
2214,4400 Block Lakeview,3364,W,AT,1,3,4,1,Spring2019
2215,N Interstate & Larrabee,3365,N,FS,9,1,10,0,Spring2019
2216,SW Laurelwood & Laurel,3367,N,OP,74,0,74,0,Spring2019
2217,NW Leahy & Alpenglow Way,3376,W,FS,0,0,0,0,Spring2019
2218,NW Leahy & Oak,3377,E,NS,1,0,1,0,Spring2019
2219,NW Leahy & 101st,3378,E,NS,1,0,1,0,Spring2019
2226,NW Leahy & 101st,3379,W,OP,0,0,0,0,Spring2019
2227,NW Leahy & 95th,3383,E,FS,0,0,0,0,Spring2019
2228,NW Leahy & 97th,3385,E,NS,2,0,2,0,Spring2019
2229,12100 Block SW Lesser,3387,N,AT,0,0,0,0,Spring2019
2230,12000 Block SW Lesser,3388,S,OP,0,0,0,0,Spring2019
2231,SW Lesser & Haines,3389,S,NS,2,3,5,2,Spring2019
2232,SW Lesser & 60th,3392,S,OP,4,1,5,0,Spring2019
2233,SW Lesser & 60th,3393,E,FS,2,3,5,0,Spring2019
2234,300 Block SW Lincoln,3397,E,AT,192,56,248,14,Spring2019
2235,SW Lincoln & 1st,3398,W,FS,53,219,272,13,Spring2019
2236,SE Lincoln & 57th,3403,E,NS,8,4,12,0,Spring2019
2237,SE Lincoln & 57th,3404,W,OP,4,10,14,3,Spring2019
2238,Linn & A V Davis,3407,S,NS,10,22,32,8,Spring2019
2239,Linn & Charman,3408,S,FS,3,3,6,0,Spring2019
2240,Linn & Charman,3409,N,OP,4,2,6,0,Spring2019
2241,Linn & Ethel,3410,N,NS,26,10,36,13,Spring2019
2242,Linn & Holmes,3411,S,NS,4,20,24,3,Spring2019
2243,Linn & Holmes,3412,N,NS,13,6,19,1,Spring2019
2244,Linn & Narain,3413,N,FS,5,2,7,1,Spring2019
2245,Linn & Oak,3414,S,NS,7,15,22,0,Spring2019
2246,Linn & Park,3415,S,FS,1,8,9,0,Spring2019
2247,Linn & Pearl,3416,N,FS,19,7,26,0,Spring2019
2248,Linn & Williams,3418,N,NS,33,3,36,4,Spring2019
2249,SE Linn & 13th,3419,W,NS,9,1,10,0,Spring2019
2250,SE Linn & 16th,3421,W,NS,5,3,8,1,Spring2019
2251,Linn & 4th,3422,S,NS,3,8,11,1,Spring2019
2252,Linn & 4th,3423,N,OP,5,6,11,1,Spring2019
2253,SE Linwood & Montgomery,3424,S,OP,1,1,2,0,Spring2019
2254,SE Linwood & Montgomery,3425,N,NS,1,1,2,0,Spring2019
2255,11600 Block SE Linwood,3426,N,OP,2,1,3,0,Spring2019
2256,11600 Block SE Linwood,3427,S,AT,2,2,4,0,Spring2019
2257,12300 Block SE Linwood,3428,N,OP,4,2,6,0,Spring2019
2258,12300 Block SE Linwood,3429,S,AT,5,4,9,0,Spring2019
2259,SE Linwood & Furnberg,3430,N,NS,0,0,0,0,Spring2019
2260,SE Linwood & Furnberg,3431,S,OP,0,1,1,0,Spring2019
2261,11900 Block SE Linwood (Linwood Sch),3432,N,OP,2,3,5,0,Spring2019
2262,11900 Block SE Linwood (Linwood Sch),3433,S,AT,3,2,5,0,Spring2019
2263,SE Linwood & Monroe,3434,N,FS,2,1,3,0,Spring2019
2264,SE Linwood & Monroe,3435,S,NS,1,1,2,0,Spring2019
2265,SW Locust & Hall,3438,W,NS,1,4,5,1,Spring2019
2266,SW Locust & Hall,3439,E,FS,6,1,7,1,Spring2019
2267,SW Locust & 80th,3440,E,NS,0,1,1,0,Spring2019
2268,SW Locust & 82nd,3441,W,FS,0,1,1,0,Spring2019
2269,SW Locust & 82nd,3442,E,NS,2,0,2,0,Spring2019
2270,N Lombard & Mississippi,3451,E,NS,22,19,41,7,Spring2019
2271,N Lombard & Albina,3452,W,NS,11,35,46,3,Spring2019
2272,N Lombard & Albina,3453,E,FS,42,19,61,1,Spring2019
2279,SW Lombard & Allen,3454,S,NS,31,70,101,9,Spring2019
2280,SW Lombard & Allen,3455,N,FS,87,25,112,16,Spring2019
2281,N Lombard & Buchanan,3462,W,FS,7,34,41,41,Spring2019
2282,N Lombard & Buchanan,3464,E,FS,37,6,43,50,Spring2019
2283,N Lombard & Burlington,3465,E,OP,264,103,367,157,Spring2019
2284,N Lombard & Burrage,3471,E,FS,44,12,56,20,Spring2019
2285,N Lombard & Burrage,3472,W,NS,5,24,29,6,Spring2019
2286,N Lombard & Charleston,3474,E,FS,165,57,222,43,Spring2019
2287,N Lombard & Chautauqua,3478,W,NS,9,14,23,6,Spring2019
2288,N Lombard & Chautauqua,3479,E,NS,13,10,23,5,Spring2019
2289,N Lombard & Clarendon,3480,W,NS,9,13,22,2,Spring2019
2290,N Lombard & Delaware,3483,W,NS,24,27,51,9,Spring2019
2291,N Lombard & Delaware,3484,E,NS,18,16,34,4,Spring2019
2292,N Lombard & Denver,3485,W,NS,101,77,178,46,Spring2019
2293,N Lombard & Denver,3486,E,NS,12,21,33,8,Spring2019
2294,N Lombard & Dwight,3487,W,NS,7,13,20,7,Spring2019
2295,N Lombard & Fenwick,3489,E,NS,39,49,88,15,Spring2019
2296,N Lombard & Fiske,3491,W,NS,26,63,89,47,Spring2019
2297,N Lombard & Gilbert,3494,W,FS,4,34,38,4,Spring2019
2298,N Lombard & Gilbert,3496,E,OP,84,14,98,25,Spring2019
2299,N Lombard & Hodge,3498,W,NS,28,29,57,7,Spring2019
2300,N Lombard & Hodge,3500,E,NS,15,26,41,4,Spring2019
2301,N Lombard & Huron,3501,E,NS,25,15,40,13,Spring2019
2302,N Lombard & Huron,3502,W,FS,12,22,34,14,Spring2019
2303,N Lombard & Ida,3503,E,NS,181,84,265,40,Spring2019
2304,N Lombard & Ida,3504,W,NS,87,219,306,87,Spring2019
2305,N Lombard Transit Center,3506,E,NS,461,754,1215,338,Spring2019
2306,N Lombard Transit Center,3507,W,FS,748,455,1203,323,Spring2019
2307,N Lombard & John,3509,W,NS,71,208,279,90,Spring2019
2308,N Lombard & Jordan,3511,E,NS,60,37,97,44,Spring2019
2309,N Lombard & McKenna,3518,W,NS,5,14,19,1,Spring2019
2310,N Lombard & Mississippi,3521,W,NS,40,28,68,8,Spring2019
2311,N Lombard & Oswego,3532,E,OP,29,5,34,13,Spring2019
2312,N Lombard & Oswego,3534,W,NS,3,35,38,21,Spring2019
2313,N Lombard & Peninsular,3535,W,NS,84,151,235,62,Spring2019
2314,N Lombard & Portsmouth,3537,E,FS,45,40,85,37,Spring2019
2315,N Lombard & Portsmouth,3538,W,NS,32,44,76,32,Spring2019
2316,13200 Block N Lombard,3540,N,AT,2,0,2,0,Spring2019
2317,13200 Block N Lombard,3541,S,OP,2,1,3,0,Spring2019
2318,NE Lombard & Rodney,3546,W,NS,8,4,12,0,Spring2019
2319,NE Lombard & Rodney,3547,E,FS,6,8,14,1,Spring2019
2320,N Lombard & Russet,3548,W,FS,3,10,13,1,Spring2019
2321,N Lombard & Tyler,3554,E,FS,59,18,77,42,Spring2019
2322,N Lombard & Tyler,3555,W,NS,19,54,73,59,Spring2019
2323,NE Lombard & M L King,3557,W,FS,97,25,122,34,Spring2019
2324,NE Lombard & M L King,3558,E,NS,15,89,104,24,Spring2019
2325,N Lombard & Van Houten,3559,E,NS,16,14,30,6,Spring2019
2332,N Lombard & Vancouver,3561,W,FS,38,29,67,13,Spring2019
2333,N Lombard & Vancouver,3562,E,NS,29,37,66,14,Spring2019
2334,N Lombard & Villard,3563,E,NS,60,54,114,42,Spring2019
2335,N Lombard & Wabash,3564,E,NS,24,16,40,4,Spring2019
2336,N Lombard & Wabash,3566,W,FS,20,33,53,7,Spring2019
2337,N Lombard & Wall,3569,W,NS,7,34,41,16,Spring2019
2338,N Lombard & Wall,3570,E,NS,56,13,69,16,Spring2019
2339,N Lombard & Wayland,3574,E,NS,4,2,6,2,Spring2019
2340,N Lombard & Westanna,3575,W,NS,22,41,63,17,Spring2019
2341,N Lombard & Westanna,3576,E,NS,37,21,58,21,Spring2019
2342,N Lombard & Woolsey,3578,E,NS,15,10,25,6,Spring2019
2343,SW Lombard & 12th,3580,N,NS,9,2,11,0,Spring2019
2344,SW Lombard & 12th,3581,S,OP,4,12,16,1,Spring2019
2345,SW Lombard & 2nd,3582,N,NS,8,15,23,6,Spring2019
2346,SW Lombard & 5th,3583,N,NS,11,12,23,1,Spring2019
2347,SW Lombard & 5th,3584,S,NS,10,13,23,2,Spring2019
2348,SW Lombard & 9th,3585,N,NS,14,3,17,25,Spring2019
2349,SW Lombard & 9th,3586,S,NS,3,13,16,24,Spring2019
2350,Longview & Holcomb,3588,S,NS,25,21,46,6,Spring2019
2351,SW Macadam & Boundary,3603,N,NS,127,9,136,18,Spring2019
2352,SW Macadam & Boundary,3604,S,NS,12,115,127,15,Spring2019
2353,SW Macadam & Gaines,3611,N,NS,20,10,30,0,Spring2019
2354,SW Macadam & Hamilton Ct,3612,S,OP,3,31,34,1,Spring2019
2355,SW Macadam & Hamilton Ct,3613,N,NS,19,2,21,0,Spring2019
2356,SW Macadam & Nebraska,3614,S,NS,3,45,48,4,Spring2019
2357,SW Macadam & Julia,3615,S,FS,2,29,31,1,Spring2019
2358,SW Macadam & Julia,3616,N,OP,50,2,52,1,Spring2019
2359,SW Macadam & Nebraska,3619,N,NS,45,3,48,2,Spring2019
2360,SW Macadam & Nevada,3620,S,NS,15,60,75,2,Spring2019
2361,SW Macadam & Nevada,3622,N,OP,61,13,74,1,Spring2019
2362,SW Macadam & Pendleton,3623,N,NS,87,4,91,0,Spring2019
2363,SW Macadam & Pendleton,3624,S,NS,4,76,80,1,Spring2019
2364,SE Madison & Grand,3633,W,NS,203,364,567,71,Spring2019
2365,SW Madison & 1st,3635,E,NS,882,71,953,82,Spring2019
2366,SE Madison & 11th,3637,W,NS,174,140,314,30,Spring2019
2367,SW Madison & 4th,3639,E,NS,865,78,943,91,Spring2019
2368,SE Madison & 7th,3641,W,NS,23,63,86,10,Spring2019
2369,SE Main & Beta,3652,E,NS,1,0,1,0,Spring2019
2370,SW Main & Burnham,3653,W,OP,23,20,43,3,Spring2019
2371,SW Main & Burnham,3654,E,NS,39,32,71,27,Spring2019
2372,SW Main & Scoffins,3655,E,NS,97,48,145,17,Spring2019
2373,SW Main & Commercial,3656,S,NS,126,93,219,18,Spring2019
2374,SE Main & Milport,3657,N,NS,9,14,23,2,Spring2019
2375,SE Main & Mailwell,3658,N,FS,3,1,4,0,Spring2019
2376,SE Main & Milport,3661,S,FS,8,6,14,1,Spring2019
2377,SE Main & Scott,3668,S,NS,0,1,1,1,Spring2019
2378,SW Main & Pacific Hwy,3669,N,NS,106,6,112,28,Spring2019
2385,SW Railroad & Washington,3670,N,OP,60,52,112,13,Spring2019
2386,SE Main & Scott,3672,N,OP,0,1,1,1,Spring2019
2387,SW Main & Scoffins,3673,W,NS,103,317,420,62,Spring2019
2388,N Main & NE 10th,3683,N,NS,1,15,16,3,Spring2019
2389,E Main & NE 12th,3687,W,FS,0,8,8,0,Spring2019
2390,E Main & SE 12th,3688,E,NS,7,1,8,2,Spring2019
2391,Main & 13th,3690,N,FS,4,0,4,2,Spring2019
2392,Main & 15th,3693,N,NS,0,0,0,0,Spring2019
2393,E Main & SE 18th,3711,W,OP,6,4,10,0,Spring2019
2394,E Main & SE 18th,3712,E,FS,4,6,10,0,Spring2019
2395,N Main & NE 2nd,3715,N,NS,8,61,69,17,Spring2019
2396,E Main & SE 24th,3716,W,NS,3,3,6,0,Spring2019
2397,E Main & SE 24th,3717,E,NS,4,4,8,0,Spring2019
2398,E Main & SE 26th,3718,W,OP,10,6,16,1,Spring2019
2399,E Main & SE 28th,3719,E,NS,10,8,18,0,Spring2019
2400,SE Main & 3rd,3720,S,NS,0,15,15,2,Spring2019
2401,400 Block SE Main (Estacada City Hall),3724,S,AT,64,48,112,14,Spring2019
2402,N Main & NE 5th,3725,N,NS,3,8,11,1,Spring2019
2403,Main & 8th St,3727,W,NS,14,20,34,8,Spring2019
2404,SW Martinazzi & Boones Ferry,3778,N,NS,31,4,35,0,Spring2019
2405,SW Martinazzi & Seneca,3779,S,NS,4,36,40,3,Spring2019
2406,13700 Block SE McLoughlin,3780,N,AT,4,6,10,1,Spring2019
2407,SE McLoughlin & Boardman,3781,N,FS,36,18,54,9,Spring2019
2408,SE McLoughlin & Chestnut,3782,N,NS,8,6,14,0,Spring2019
2409,SE McLoughlin & Concord,3783,N,FS,77,62,139,43,Spring2019
2410,SE McLoughlin & Courtney,3784,N,FS,50,39,89,34,Spring2019
2411,SE McLoughlin & Holly Farm Mall,3789,N,AT,20,17,37,8,Spring2019
2412,SE McLoughlin & Hull Ave,3790,N,FS,25,11,36,2,Spring2019
2413,SE McLoughlin & Jennings,3791,N,FS,59,23,82,5,Spring2019
2414,SE McLoughlin & Maple,3792,N,NS,19,11,30,4,Spring2019
2415,SE McLoughlin & Naef,3794,N,FS,43,15,58,5,Spring2019
2416,SE McLoughlin & Oak Grove,3795,N,FS,158,134,292,142,Spring2019
2417,SE Ochoco & McLoughlin,3797,W,NS,5,12,17,0,Spring2019
2418,SE McLoughlin & Park Ave,3798,N,FS,50,325,375,85,Spring2019
2419,SE McLoughlin & Risley,3799,N,FS,19,15,34,6,Spring2019
2420,SE McLoughlin & Roethe,3800,N,FS,126,50,176,28,Spring2019
2421,SE McLoughlin & Silver Springs,3801,N,NS,8,10,18,3,Spring2019
2422,SE McLoughlin & Silverleaf,3802,N,OP,13,9,22,5,Spring2019
2423,SE McLoughlin & Vineyard,3807,N,FS,44,32,76,19,Spring2019
2424,12200 Block SE McLoughlin,3810,N,AT,7,10,17,9,Spring2019
2425,600 Block McVey,3811,E,OP,1,0,1,0,Spring2019
2426,600 Block McVey,3812,W,AT,0,0,0,0,Spring2019
2427,McVey & Cornell,3813,W,NS,0,2,2,0,Spring2019
2428,McVey & Cornell,3814,E,FS,3,0,3,0,Spring2019
2429,McVey & Maple,3815,E,NS,3,0,3,0,Spring2019
2430,McVey & Lakefront,3816,W,NS,0,1,1,0,Spring2019
2431,McVey & Oak,3817,W,FS,0,0,0,0,Spring2019
2438,McVey & Oak,3818,E,FS,0,0,0,0,Spring2019
2439,SE McKinley & Jefferson,3825,N,OP,1,2,3,0,Spring2019
2440,13700 Block SE McLoughlin,3827,S,OP,9,8,17,3,Spring2019
2441,SE McLoughlin & Boardman,3829,S,FS,15,29,44,7,Spring2019
2442,SE McLoughlin & Chestnut,3830,S,FS,4,12,16,0,Spring2019
2443,McLoughlin & Clackamette Dr,3831,S,NS,45,61,106,32,Spring2019
2444,16000 Block SE McLoughlin,3832,S,AT,9,30,39,10,Spring2019
2445,SE McLoughlin & Concord,3833,S,FS,54,68,122,35,Spring2019
2446,SE McLoughlin & Courtney,3834,S,NS,36,47,83,26,Spring2019
2447,SE McLoughlin & Hull Ave,3838,S,FS,9,22,31,1,Spring2019
2448,SE McLoughlin & Jennings,3839,S,FS,26,56,82,10,Spring2019
2449,SE McLoughlin & Maple,3840,S,NS,13,33,46,8,Spring2019
2450,SE McLoughlin & Meldrum,3841,S,NS,7,15,22,2,Spring2019
2451,McLoughlin & Oregon City Shopping Center,3842,N,AT,74,55,129,36,Spring2019
2452,SE McLoughlin & Oak Grove,3843,S,FS,114,152,266,85,Spring2019
2453,SE Frontage Rd & Ochoco St,3846,S,FS,16,5,21,1,Spring2019
2454,SE McLoughlin & Park Ave,3848,S,NS,359,59,418,74,Spring2019
2455,SE McLoughlin & Risley,3849,S,FS,10,24,34,10,Spring2019
2456,SE McLoughlin & River Rd,3850,S,FS,16,15,31,6,Spring2019
2457,SE McLoughlin & Roethe,3851,S,FS,53,115,168,37,Spring2019
2458,SE McLoughlin & Silver Springs,3852,S,OP,21,15,36,4,Spring2019
2459,SE McLoughlin & Silverleaf,3853,S,NS,19,18,37,5,Spring2019
2460,8500 Block SE McLoughlin,3854,S,AT,1,2,3,4,Spring2019
2461,SE McLoughlin & Vineyard,3857,S,FS,23,31,54,10,Spring2019
2462,SE McLoughlin & Lakewood,3860,S,OP,1,5,6,1,Spring2019
2463,McNary & Churchill Downs,3862,E,FS,3,1,4,0,Spring2019
2464,McNary & Condolea,3863,W,FS,1,3,4,0,Spring2019
2465,McNary & Condolea,3864,E,OP,4,0,4,0,Spring2019
2466,Meridian Park Hospital Rd & SW 65th,3867,N,NS,3,0,3,0,Spring2019
2467,Meridian Park Hospital Main Stop,3868,N,AT,56,66,122,19,Spring2019
2468,13500 Block SW Millikan,3892,E,OP,6,6,12,1,Spring2019
2469,SE Milwaukie & Center,3908,N,FS,37,18,55,48,Spring2019
2470,SE Milwaukie & Center,3909,S,NS,17,45,62,35,Spring2019
2471,SE Milwaukie & Claybourne,3911,S,NS,17,48,65,30,Spring2019
2472,SE Milwaukie & Claybourne,3912,N,NS,37,15,52,38,Spring2019
2473,SE Milwaukie & Haig,3916,S,NS,13,15,28,1,Spring2019
2474,SE Milwaukie & Haig,3917,N,NS,22,19,41,3,Spring2019
2475,SE Milwaukie & Insley,3921,S,OP,5,24,29,3,Spring2019
2476,SE Milwaukie & Insley,3922,N,FS,30,5,35,2,Spring2019
2477,SE Milwaukie & Long,3928,S,FS,10,20,30,9,Spring2019
2478,SE Milwaukie & Long,3929,N,OP,20,10,30,5,Spring2019
2479,SE Milwaukie & Mall,3931,S,NS,13,22,35,27,Spring2019
2480,SE Milwaukie & Mall,3932,N,NS,23,13,36,18,Spring2019
2481,SE Milwaukie & Mitchell,3933,N,FS,43,19,62,102,Spring2019
2482,SE Milwaukie & Mitchell,3935,S,OP,15,38,53,78,Spring2019
2483,SE Milwaukie & Ramona,3938,S,NS,5,35,40,1,Spring2019
2484,SE Milwaukie & Ramona,3940,N,OP,44,4,48,2,Spring2019
2491,SE Milwaukie & Tolman,3946,S,NS,10,61,71,14,Spring2019
2492,SE Milwaukie & Tolman,3947,N,NS,46,10,56,14,Spring2019
2493,N Mississippi & Beech,3955,N,NS,14,49,63,5,Spring2019
2494,N Mississippi & Failing,3957,S,FS,132,59,191,20,Spring2019
2495,N Mississippi & Failing,3958,N,NS,38,79,117,10,Spring2019
2496,N Mississippi & Mason,3966,N,FS,24,54,78,15,Spring2019
2497,N Mississippi & Mason,3967,S,NS,40,25,65,19,Spring2019
2498,N Mississippi & Skidmore,3976,N,FS,13,27,40,7,Spring2019
2499,N Mississippi & Skidmore,3977,S,NS,30,19,49,5,Spring2019
2500,Molalla & Beverly,3981,S,FS,0,2,2,1,Spring2019
2501,Molalla & Hilda,3983,N,NS,6,5,11,1,Spring2019
2502,Molalla & Hillcrest,3984,N,NS,2,1,3,1,Spring2019
2503,Molalla & Holmes,3985,S,FS,3,6,9,0,Spring2019
2504,Molalla & Pearl,3989,S,NS,3,21,24,4,Spring2019
2505,Molalla & Pearl,3990,N,NS,18,5,23,1,Spring2019
2506,Molalla & Warner,3992,S,NS,2,3,5,0,Spring2019
2507,Molalla & Willamette,3993,S,FS,3,2,5,1,Spring2019
2508,Molalla & Willamette,3994,N,NS,3,2,5,3,Spring2019
2509,Monroe & Boones Ferry Rd,3995,W,FS,1,6,7,0,Spring2019
2510,Monroe & Boones Ferry Rd,3996,E,NS,3,2,5,0,Spring2019
2511,SW Monroe & Greenridge,3997,E,NS,1,0,1,0,Spring2019
2512,NE Morris & 111th,4011,W,NS,2,0,2,0,Spring2019
2513,NE Morris & 117th,4012,E,NS,0,2,2,0,Spring2019
2514,SE Morrison & Grand,4013,W,NS,149,129,278,54,Spring2019
2515,SE Morrison & 12th,4014,W,FS,151,126,277,87,Spring2019
2516,SE Morrison & 14th,4016,W,NS,83,32,115,17,Spring2019
2517,SE Morrison & 16th,4019,W,NS,73,13,86,2,Spring2019
2518,SE Morrison & 18th,4022,W,NS,36,10,46,12,Spring2019
2519,SE Morrison & 20th,4023,W,NS,136,35,171,11,Spring2019
2520,SE Morrison & 9th,4026,W,NS,61,27,88,6,Spring2019
2521,Morrison Bridge,4028,E,AT,7,23,30,0,Spring2019
2522,Morrison Bridge,4029,W,AT,14,11,25,0,Spring2019
2523,10000 Block SE Mt Scott,4032,E,AT,0,3,3,0,Spring2019
2524,9900 Block SE Mt Scott,4033,W,AT,3,0,3,0,Spring2019
2525,SE Mt Scott & 103rd,4035,W,NS,4,4,8,11,Spring2019
2526,SE Mt Scott & 105th,4036,E,OP,1,10,11,8,Spring2019
2527,SE Mt Scott & 105th,4037,W,FS,6,1,7,0,Spring2019
2528,SE Mt Scott & Aspen Summit,4039,E,FS,1,4,5,0,Spring2019
2529,SE Mt Scott & 98th,4040,W,NS,2,0,2,2,Spring2019
2530,NE Multnomah & Grand,4042,E,FS,68,119,187,26,Spring2019
2531,NE Multnomah & Grand,4043,W,NS,60,74,134,28,Spring2019
2532,NE Multnomah & 11th,4044,W,OP,109,55,164,35,Spring2019
2533,NE Multnomah & 13th,4045,W,OP,77,234,311,25,Spring2019
2534,NE Multnomah & 13th,4047,E,FS,149,39,188,19,Spring2019
2535,NE Multnomah & 16th,4048,E,NS,5,15,20,10,Spring2019
2536,NE Multnomah & 16th,4049,W,NS,16,5,21,6,Spring2019
2537,NE Multnomah & 19th,4050,E,OP,2,8,10,1,Spring2019
2544,SW Multnomah & 45th,4052,W,FS,2,2,4,3,Spring2019
2545,NE Multnomah & 9th,4055,E,NS,27,60,87,7,Spring2019
2546,3600 Block SW Murray,4057,S,AT,10,7,17,1,Spring2019
2547,3900 Block SW Murray,4060,N,AT,2,1,3,0,Spring2019
2548,5300 Block SW Murray,4062,S,AT,11,14,25,10,Spring2019
2549,SW Murray & Bonnie Brae,4064,S,NS,2,6,8,1,Spring2019
2550,SW Murray & Bonnie Brae,4065,N,NS,12,4,16,0,Spring2019
2551,SW Murray & Butner,4066,N,FS,9,11,20,1,Spring2019
2552,SW Murray & Butner,4067,S,FS,15,13,28,1,Spring2019
2553,SW Murray & Farmington,4068,S,FS,58,24,82,7,Spring2019
2554,SW Murray & Farmington,4069,N,FS,28,43,71,10,Spring2019
2555,SW Murray & Linda,4077,N,OP,8,10,18,12,Spring2019
2556,SW Murray & Linda,4078,S,NS,8,3,11,1,Spring2019
2557,NW Murray & Milburn,4080,S,NS,6,7,13,0,Spring2019
2558,NW Murray & Science Park Dr,4085,N,FS,7,45,52,3,Spring2019
2559,NW Murray & Science Park Dr,4086,S,NS,47,15,62,2,Spring2019
2560,SW Murray & Tualatin Valley Hwy,4087,N,NS,15,34,49,3,Spring2019
2561,SW Murray & Tualatin Valley Hwy,4088,S,FS,33,12,45,2,Spring2019
2562,SW Murray & Walker,4090,N,FS,21,28,49,1,Spring2019
2563,SW Murray & Walker,4091,S,NS,34,18,52,5,Spring2019
2564,SW Murray & 6th,4095,N,NS,15,12,27,5,Spring2019
2565,SW Nebraska & Corbett,4102,W,NS,2,0,2,0,Spring2019
2566,SW Nebraska & Virginia,4103,E,NS,4,3,7,1,Spring2019
2567,SW Nevada Ct & 54th,4104,W,OP,3,1,4,0,Spring2019
2568,NW Nicolai & 27th,4105,E,NS,8,4,12,1,Spring2019
2569,SW Oak & Armco Ave,4116,E,NS,48,24,72,14,Spring2019
2570,SW Oak & 17th,4119,E,FS,78,58,136,31,Spring2019
2571,SE Oak & 7th,4123,E,NS,63,41,104,24,Spring2019
2572,SE Oak & 9th,4125,E,NS,21,50,71,17,Spring2019
2573,14100 Block SE Oatfield,4136,S,AT,1,0,1,0,Spring2019
2574,SE Oatfield & Oak Grove,4137,N,OP,5,10,15,1,Spring2019
2575,16800 Block SE Oatfield,4138,S,OP,0,0,0,0,Spring2019
2576,16800 Block SE Oatfield,4139,N,AT,0,0,0,0,Spring2019
2577,Oatfield & Stone Oaks Ct,4140,S,OP,0,1,1,0,Spring2019
2578,SE Oatfield & Alchar Dr,4141,W,FS,2,1,3,0,Spring2019
2579,SE Oatfield & Aldercrest,4142,E,NS,1,1,2,0,Spring2019
2580,SE Oatfield & Allan,4143,N,NS,2,0,2,0,Spring2019
2581,SE Oatfield & Allan,4144,S,OP,0,1,1,0,Spring2019
2582,Oatfield & Stone Oaks Ct,4145,N,NS,2,0,2,0,Spring2019
2583,SE Oatfield & Clayson,4146,S,NS,3,2,5,0,Spring2019
2584,SE Oatfield & Clayson,4147,N,OP,3,3,6,0,Spring2019
2585,Oatfield & Collins Crest,4148,S,NS,3,2,5,0,Spring2019
2586,SE Oatfield & Concord,4149,S,NS,3,8,11,0,Spring2019
2587,SE Oatfield & Concord,4150,N,FS,4,5,9,0,Spring2019
2588,SE Oatfield & Courtney,4151,S,NS,1,1,2,0,Spring2019
2589,Oatfield & E Exeter,4154,S,NS,2,7,9,1,Spring2019
2590,Oatfield & Glen Echo,4159,E,NS,6,4,10,0,Spring2019
2597,SE Oatfield & Guilford,4160,S,OP,1,1,2,0,Spring2019
2598,SE Oatfield & Guilford,4161,N,FS,0,1,1,0,Spring2019
2599,Oatfield & E Hereford,4164,S,FS,2,5,7,0,Spring2019
2600,SE Oatfield & Hill,4165,S,OP,0,3,3,3,Spring2019
2601,SE Oatfield & Hill,4166,N,FS,2,1,3,0,Spring2019
2602,SE Oatfield & Jennings,4169,N,NS,1,1,2,0,Spring2019
2603,SE Oatfield & Jennings,4170,S,NS,1,2,3,0,Spring2019
2604,Oatfield & E Kenmore,4171,S,FS,1,4,5,0,Spring2019
2605,SE Oatfield & Loeffelman Rd,4172,S,OP,1,3,4,0,Spring2019
2606,SE Oatfield & Loeffelman Rd,4173,N,FS,3,1,4,0,Spring2019
2607,SE Oatfield & McNary,4174,N,FS,3,1,4,0,Spring2019
2608,SE Oatfield & McNary,4175,S,OP,1,3,4,0,Spring2019
2609,SE Oatfield & Naef,4176,S,OP,0,1,1,0,Spring2019
2610,SE Oatfield & Naef,4177,N,NS,1,0,1,0,Spring2019
2611,SE Oatfield & Oak Grove,4178,S,NS,9,8,17,10,Spring2019
2612,SE Oatfield & Oakland,4179,S,OP,0,1,1,0,Spring2019
2613,SE Oatfield & Oakland,4180,N,FS,1,0,1,0,Spring2019
2614,Oatfield & Oakridge,4181,E,OP,2,4,6,0,Spring2019
2615,Oatfield & Oakridge,4182,W,NS,5,2,7,0,Spring2019
2616,SE Oatfield & Oatfield Ct,4183,S,OP,0,0,0,0,Spring2019
2617,SE Oatfield & Oatfield Ct,4184,N,FS,0,0,0,0,Spring2019
2618,SE Oatfield & Park,4185,S,FS,3,2,5,1,Spring2019
2619,SE Oatfield & Park,4186,N,NS,1,20,21,0,Spring2019
2620,Oatfield & Park Way,4187,W,NS,5,7,12,0,Spring2019
2621,SE Oatfield & Pinehurst,4188,N,FS,0,1,1,0,Spring2019
2622,SE Oatfield & Raymond,4189,S,FS,0,1,1,0,Spring2019
2623,SE Oatfield & Raymond,4190,N,OP,1,0,1,0,Spring2019
2624,Oatfield & Ridgegate,4191,N,NS,4,3,7,0,Spring2019
2625,SE Oatfield & Risley,4192,S,FS,1,2,3,0,Spring2019
2626,SE Oatfield & Risley,4193,N,NS,1,2,3,0,Spring2019
2627,SE Oatfield & Roethe,4194,S,NS,2,9,11,0,Spring2019
2628,SE Oatfield & Roethe,4195,N,FS,5,4,9,0,Spring2019
2629,SE Oatfield & Silver Springs,4198,S,OP,1,3,4,19,Spring2019
2630,SE Oatfield & Silver Springs,4199,N,FS,2,1,3,12,Spring2019
2631,SE Oatfield & Thiessen,4200,N,NS,3,1,4,0,Spring2019
2632,SE Oatfield & Thiessen,4201,S,OP,1,3,4,1,Spring2019
2633,Oatfield & 82nd Dr,4204,E,NS,1,2,3,0,Spring2019
2634,SW Oleson & Alden,4205,S,NS,3,8,11,4,Spring2019
2635,SW Oleson & Garden Home,4206,N,NS,33,21,54,1,Spring2019
2636,SW Oleson & Garden Home,4207,S,FS,13,8,21,0,Spring2019
2637,SW Oleson & Hall,4208,E,FS,6,2,8,1,Spring2019
2638,SW Oleson & Hall,4209,S,NS,1,6,7,0,Spring2019
2639,SW Oleson & Obrien,4210,S,NS,0,1,1,0,Spring2019
2640,SW Oleson & Rustling Leaves Pl,4214,E,FS,3,1,4,0,Spring2019
2641,SW Oleson & Rustling Leaves Pl,4215,W,OP,1,4,5,0,Spring2019
2642,SW Oleson & 80th,4216,N,NS,13,4,17,2,Spring2019
2643,SW Oleson & Skyhar Dr,4217,S,NS,2,5,7,0,Spring2019
2650,SW Oleson & 89th,4218,W,NS,0,2,2,0,Spring2019
2651,SW Oleson & 91st,4219,E,NS,8,3,11,0,Spring2019
2652,SW Oleson & 91st,4220,W,OP,1,6,7,0,Spring2019
2653,SE Orient Dr & Welch Rd,4230,S,FS,0,0,0,0,Spring2019
2654,SE Orient Dr & 14th,4231,S,FS,0,1,1,0,Spring2019
2655,SE Orient Dr & Welch Rd,4243,N,FS,0,0,0,0,Spring2019
2656,11500 Block SW Pacific Hwy,4248,E,AT,7,8,15,0,Spring2019
2657,SW Pacific Hwy & 72nd,4249,W,FS,36,35,71,27,Spring2019
2658,11700 Block SW Pacific Hwy,4252,E,OP,3,10,13,1,Spring2019
2659,11700 Block SW Pacific Hwy,4253,W,AT,4,4,8,1,Spring2019
2660,13400 Block SW Pacific Hwy,4254,W,AT,6,19,25,14,Spring2019
2661,SW Pacific Hwy & McDonald/Gaarde,4255,E,FS,84,15,99,25,Spring2019
2662,16400 Block SW Pacific Hwy,4257,S,AT,2,5,7,4,Spring2019
2663,SW Pacific Hwy & Fischer,4258,S,FS,9,67,76,12,Spring2019
2664,17000 Block SW Pacific Hwy,4259,N,AT,15,2,17,0,Spring2019
2665,SW Pacific Hwy & 124th,4260,W,OP,6,60,66,11,Spring2019
2666,Pacific Ave & A St,4264,W,NS,1,91,92,11,Spring2019
2667,SW Pacific Hwy & Beef Bend,4266,N,OP,19,1,20,2,Spring2019
2668,SW Pacific Hwy & Beef Bend,4267,S,FS,2,19,21,2,Spring2019
2669,SW Pacific Hwy & Bull Mtn,4270,N,NS,28,5,33,1,Spring2019
2670,SW Pacific Hwy & Bull Mtn,4271,S,FS,3,34,37,4,Spring2019
2671,3900 Block Pacific Ave,4272,E,AT,31,9,40,10,Spring2019
2672,SW Pacific Hwy & Canterbury,4273,S,NS,9,42,51,3,Spring2019
2673,SW Pacific Hwy & Canterbury,4274,N,FS,43,10,53,1,Spring2019
2674,Pacific Ave & Cedar,4275,W,NS,3,104,107,25,Spring2019
2675,SW Pacific Hwy & Cipole,4276,E,NS,8,2,10,5,Spring2019
2676,SW Pacific Hwy & Cipole,4277,W,FS,2,6,8,1,Spring2019
2677,Pacific Ave & College Way,4278,W,NS,2,104,106,22,Spring2019
2678,Pacific Ave & Mountain View Ln,4279,W,NS,7,38,45,2,Spring2019
2679,Pacific Ave & Elm,4280,W,NS,2,45,47,21,Spring2019
2680,SW Pacific Hwy & 72nd,4284,E,FS,42,29,71,33,Spring2019
2681,SW Pacific Hwy & Gaarde/McDonald,4286,W,NS,13,76,89,23,Spring2019
2682,10000 Block NE Pacific St,4287,E,AT,170,8,178,88,Spring2019
2683,10000 Block NE Pacific St,4288,W,OP,5,178,183,108,Spring2019
2684,3800 Block Pacific Ave,4289,W,AT,17,43,60,8,Spring2019
2685,SW Pacific Hwy & Hall,4290,E,FS,53,5,58,8,Spring2019
2686,Pacific Ave & Hawthorne,4291,W,NS,4,49,53,21,Spring2019
2687,SW Pacific Hwy & Hazelbrook,4293,N,NS,45,5,50,13,Spring2019
2688,Pacific Ave & Maple,4294,E,NS,73,16,89,22,Spring2019
2689,Pacific Ave & Maple,4295,W,OP,7,63,70,12,Spring2019
2690,Pacific Ave & Oak,4298,E,NS,41,7,48,16,Spring2019
2691,Pacific Ave & Oak,4299,W,FS,14,46,60,26,Spring2019
2692,SW Pacific Hwy & Pacific Dr,4300,W,NS,2,6,8,21,Spring2019
2693,SW Pacific Hwy & 130th,4301,E,FS,8,0,8,1,Spring2019
2694,SW Pacific Hwy & Park,4304,E,NS,5,2,7,1,Spring2019
2695,SW Pacific Hwy & 78th,4305,W,NS,33,43,76,12,Spring2019
2696,Pacific Ave & Quince,4306,E,FS,60,18,78,6,Spring2019
2703,Pacific Ave & Quince,4307,W,FS,11,40,51,11,Spring2019
2704,SW Pacific Hwy & Royal Villa Dr,4308,N,NS,67,8,75,16,Spring2019
2705,2900 Block Pacific Ave,4309,W,AT,42,142,184,56,Spring2019
2706,SW Pacific Hwy & School,4310,W,FS,9,27,36,2,Spring2019
2707,Pacific Ave & Mountain View Ln,4311,E,NS,27,11,38,7,Spring2019
2708,SW Pacific Hwy & 124th,4316,E,FS,27,3,30,2,Spring2019
2709,SW Pacific Hwy & Walnut,4317,E,NS,36,16,52,2,Spring2019
2710,SW Pacific Hwy & Walnut,4318,W,NS,28,40,68,3,Spring2019
2711,SW Pacific Hwy & Warner,4319,W,NS,1,51,52,9,Spring2019
2712,SW Pacific Hwy & Watkins,4320,W,FS,2,12,14,1,Spring2019
2713,SW Pacific Hwy & Watkins,4321,E,OP,8,4,12,1,Spring2019
2714,N Adair & Yew,4322,W,NS,27,108,135,9,Spring2019
2715,Pacific Ave & Yew,4323,E,OP,97,26,123,10,Spring2019
2716,SW Pacific Hwy & 65th,4326,W,FS,20,52,72,4,Spring2019
2717,SW Pacific Hwy & 68th,4327,E,FS,22,16,38,5,Spring2019
2718,SW Pacific Hwy & 69th,4328,W,NS,9,21,30,3,Spring2019
2719,SW Pacific Hwy & 71st,4329,W,FS,7,26,33,7,Spring2019
2720,SW Palatine Hill & Palatine Hill/Palater,4334,W,NS,1,0,1,0,Spring2019
2721,SW Palatine Hill & Riverside,4336,S,FS,0,21,21,0,Spring2019
2722,SW Park Pl & St Clair,4340,W,NS,2,7,9,1,Spring2019
2723,SW Park Pl & Douglas,4341,E,NS,1,0,1,0,Spring2019
2724,SW Park Pl & Green,4343,W,FS,1,1,2,0,Spring2019
2725,SW Park Pl & King,4345,E,NS,0,1,1,0,Spring2019
2726,SW Park Pl & Lewis & Clark,4346,W,NS,0,1,1,0,Spring2019
2727,SW Rose Garden Way & Wright,4351,W,FS,1,1,2,0,Spring2019
2728,10200 Block SW Park Way,4366,E,OP,0,1,1,0,Spring2019
2729,SW Park Way & Cedar Hills,4369,W,FS,2,0,2,0,Spring2019
2730,SW Park Way & Cedar Hills,4370,E,NS,0,7,7,0,Spring2019
2731,SW Park Way & Dellwood,4371,W,NS,0,0,0,0,Spring2019
2732,SW Park Way & Dellwood,4372,E,NS,0,0,0,0,Spring2019
2733,SW Park Way & Devonshire,4374,E,OP,0,0,0,0,Spring2019
2734,SW Park Way & Hicrest,4376,E,NS,1,0,1,0,Spring2019
2735,SW Park Way & Hilldale,4377,W,NS,0,0,0,0,Spring2019
2736,SW Park Way & Huntington,4378,W,NS,2,0,2,0,Spring2019
2737,SW Park Way & Huntington,4379,E,NS,0,1,1,0,Spring2019
2738,SW Park Way & Parkwood,4380,W,NS,0,0,0,0,Spring2019
2739,SW Park Way & Parkwood,4381,E,NS,0,0,0,0,Spring2019
2740,SW Park Way & Tremont,4382,W,NS,0,0,0,0,Spring2019
2741,SW Park Way & Walker,4383,W,NS,1,0,1,0,Spring2019
2742,SW Park Way & Walker,4384,E,FS,1,1,2,0,Spring2019
2743,SW Park Way & Wynwood,4385,W,NS,0,0,0,0,Spring2019
2744,SW Park Way & Wynwood,4386,E,NS,0,0,0,0,Spring2019
2745,13500 Block SW Park Way,4387,W,AT,0,0,0,0,Spring2019
2746,SW Patrick & Council Crest,4410,W,NS,0,0,0,0,Spring2019
2747,3400 Block SW Patton,4413,W,AT,0,0,0,0,Spring2019
2748,SW Patton & Greenway,4415,E,FS,11,0,11,0,Spring2019
2749,SW Patton & Homar,4416,E,OP,3,0,3,0,Spring2019
2756,SW Patton & Montgomery,4417,W,FS,0,3,3,0,Spring2019
2757,SW Patton & Old Orchard,4419,W,OP,0,2,2,0,Spring2019
2758,SW Patton & Old Orchard,4420,E,NS,1,0,1,0,Spring2019
2759,SW Patton & Patton Ct,4422,E,OP,0,0,0,0,Spring2019
2760,SW Patton & Patton Ln,4423,W,OP,0,2,2,0,Spring2019
2761,SW Patton & Patton Ln,4424,E,FS,3,0,3,0,Spring2019
2762,PCC Drive & Springville,4426,S,NS,14,0,14,0,Spring2019
2763,PCC Lower Drive (G St) & H St,4427,E,NS,0,5,5,3,Spring2019
2764,PCC Rock Creek Main Stop,4429,S,AT,491,524,1015,85,Spring2019
2765,PCC Sylvania Main Stop,4431,S,AT,541,531,1072,143,Spring2019
2766,N Peninsular & Farragut,4432,N,FS,1,27,28,0,Spring2019
2767,N Peninsular & Farragut,4433,S,NS,38,1,39,0,Spring2019
2768,N Peninsular & Halleck,4434,N,NS,1,6,7,0,Spring2019
2769,N Peninsular & Halleck,4435,S,NS,17,9,26,1,Spring2019
2770,N Peninsular & Russet,4437,S,FS,46,9,55,4,Spring2019
2771,N Peninsular & Watts,4438,N,FS,1,13,14,1,Spring2019
2772,N Peninsular & Watts,4439,S,NS,24,1,25,0,Spring2019
2773,N Philadelphia & Ivanhoe,4440,E,NS,1,82,83,4,Spring2019
2774,N Philadelphia & Syracuse,4441,W,NS,52,1,53,6,Spring2019
2775,SW Pine & 2nd,4451,S,NS,0,16,16,1,Spring2019
2776,SW Pine & 2nd,4452,N,NS,9,0,9,1,Spring2019
2777,N Rosa Parks Way & Albina,4455,E,NS,17,14,31,17,Spring2019
2778,Portland Ave & W Arlington,4456,S,NS,4,5,9,2,Spring2019
2779,N Rosa Parks Way & Boston,4457,E,NS,9,3,12,1,Spring2019
2780,N Rosa Parks Way & Congress,4458,W,FS,4,17,21,0,Spring2019
2781,N Rosa Parks Way & Congress,4459,E,OP,18,4,22,1,Spring2019
2782,N Rosa Parks Way & Curtis,4461,E,NS,6,3,9,1,Spring2019
2783,Portland Ave & W Dartmouth,4462,S,NS,1,5,6,1,Spring2019
2784,Portland Ave & E Dartmouth,4463,N,NS,22,4,26,21,Spring2019
2785,N Rosa Parks Way & Delaware,4464,W,NS,4,13,17,1,Spring2019
2786,N Rosa Parks Way & Denver,4465,W,NS,6,13,19,1,Spring2019
2787,N Rosa Parks Way & Denver,4466,E,NS,11,4,15,1,Spring2019
2788,Portland Ave & W Fairfield,4467,S,NS,0,0,0,0,Spring2019
2789,Portland Ave & E Fairfield,4468,N,NS,1,0,1,0,Spring2019
2790,N Rosa Parks Way & Greeley,4470,E,FS,9,12,21,5,Spring2019
2791,N Rosa Parks Way & Greeley,4471,W,NS,13,16,29,8,Spring2019
2792,Portland Ave & E Hereford,4472,N,NS,2,1,3,1,Spring2019
2793,N Rosa Parks Way & Interstate,4473,W,NS,61,34,95,14,Spring2019
2794,N Rosa Parks Way & Interstate,4474,E,FS,25,51,76,11,Spring2019
2795,Portland Ave & W Ipswich,4475,S,NS,1,0,1,0,Spring2019
2796,N Rosa Parks Way & Vancouver,4485,W,FS,12,23,35,1,Spring2019
2797,N Rosa Parks Way & Vancouver,4486,E,NS,22,9,31,2,Spring2019
2798,N Portsmouth & Amherst,4491,S,NS,0,10,10,0,Spring2019
2799,N Portsmouth & Depauw,4492,N,FS,14,0,14,0,Spring2019
2800,N Portsmouth & Lombard St,4494,S,NS,3,29,32,3,Spring2019
2801,N Portsmouth & Lombard St,4495,N,NS,45,5,50,7,Spring2019
2802,N Portsmouth & Oberlin,4496,S,NS,0,10,10,1,Spring2019
2809,N Portsmouth & Princeton,4497,N,NS,15,0,15,0,Spring2019
2810,N Portsmouth & Syracuse,4498,S,NS,0,10,10,0,Spring2019
2811,N Portsmouth & Willis,4501,N,NS,44,2,46,2,Spring2019
2812,N Portsmouth & Yale,4502,N,NS,16,0,16,0,Spring2019
2813,10800 Block SE Powell,4503,W,AT,25,10,35,4,Spring2019
2814,10800 Block SE Powell,4504,E,AT,8,32,40,8,Spring2019
2815,SE Powell & 151st,4506,W,FS,35,9,44,3,Spring2019
2816,2900 Block W Powell,4507,E,AT,10,18,28,4,Spring2019
2817,2900 Block W Powell,4508,W,OP,18,7,25,2,Spring2019
2818,W Powell & NW Bella Vista,4513,E,OP,1,2,3,0,Spring2019
2819,W Powell & SW Birdsdale,4515,E,NS,10,16,26,3,Spring2019
2820,W Powell & NW Birdsdale,4516,W,FS,14,12,26,4,Spring2019
2821,E Powell & SE Burnside,4518,W,FS,14,3,17,8,Spring2019
2822,E Powell & SE Cleveland,4520,E,NS,4,5,9,2,Spring2019
2823,E Powell & NE Cleveland,4521,W,FS,4,2,6,0,Spring2019
2824,W Powell & SW Duniway,4522,E,OP,115,129,244,39,Spring2019
2825,W Powell & SW Duniway,4523,W,FS,25,65,90,22,Spring2019
2826,E Powell & NE Hogan,4528,W,NS,4,1,5,0,Spring2019
2827,E Powell & SE Hogan,4529,E,NS,2,4,6,3,Spring2019
2828,E Powell & NE Liberty,4531,E,OP,2,3,5,1,Spring2019
2829,SE Powell & Meadowland Center,4534,E,AT,19,42,61,36,Spring2019
2830,SE Powell & Milwaukie,4537,E,NS,84,57,141,40,Spring2019
2831,SE Powell & Milwaukie,4538,W,FS,185,330,515,90,Spring2019
2832,SE Powell & Milwaukie,4539,N,NS,66,59,125,12,Spring2019
2833,SE Powell & Powell Garage Dr,4542,E,NS,30,14,44,4,Spring2019
2834,SE Powell & Powell Garage Dr,4543,W,FS,21,91,112,10,Spring2019
2835,E Powell & SE Rene,4545,E,FS,8,32,40,4,Spring2019
2836,E Powell & SE Rene,4546,W,OP,26,4,30,0,Spring2019
2837,W Powell & SW Towle,4552,E,FS,9,15,24,7,Spring2019
2838,W Powell & NW Towle,4553,W,FS,10,11,21,7,Spring2019
2839,W Powell & Village Drive,4554,W,FS,39,14,53,6,Spring2019
2840,W Powell & SW Wallula,4555,E,FS,3,12,15,7,Spring2019
2841,W Powell & NW Wallula,4556,W,NS,8,3,11,13,Spring2019
2842,W Powell & SW Walters,4557,E,FS,4,13,17,8,Spring2019
2843,W Powell & SW Walters,4558,W,FS,8,3,11,5,Spring2019
2844,10000 Block SE Powell,4561,W,AT,6,10,16,2,Spring2019
2845,SE Powell & 102nd,4562,E,FS,6,11,17,3,Spring2019
2846,SE Powell & 102nd,4563,W,NS,4,1,5,1,Spring2019
2847,SE Powell & 104th,4564,E,FS,6,17,23,3,Spring2019
2848,SE Powell & 104th,4565,W,OP,20,8,28,4,Spring2019
2849,SE Powell & 112th,4566,W,FS,78,34,112,19,Spring2019
2850,SE Powell & 112th,4567,E,FS,32,74,106,15,Spring2019
2851,SE Powell & 116th,4568,E,OP,4,10,14,1,Spring2019
2852,SE Powell & 116th,4569,W,NS,16,4,20,3,Spring2019
2853,SE Powell & 119th,4570,W,NS,33,5,38,5,Spring2019
2854,SE Powell & 119th,4571,E,NS,6,61,67,14,Spring2019
2855,SE Powell & 122nd,4572,W,FS,182,69,251,70,Spring2019
2862,SE Powell & 122nd,4573,E,FS,169,196,365,85,Spring2019
2863,SE Powell & 124th,4575,W,FS,26,93,119,35,Spring2019
2864,SE Powell & 127th Pl,4576,W,FS,27,10,37,3,Spring2019
2865,SE Powell & 129th,4578,W,NS,42,8,50,4,Spring2019
2866,SE Powell & 130th,4580,E,NS,7,47,54,4,Spring2019
2867,SE Powell & 132nd,4581,W,OP,50,11,61,7,Spring2019
2868,SE Powell & 132nd,4582,E,FS,11,42,53,23,Spring2019
2869,SE Powell & 134th,4583,W,NS,128,22,150,36,Spring2019
2870,SE Powell & 134th,4584,E,OP,5,24,29,10,Spring2019
2871,SE Powell & 136th,4585,E,NS,26,97,123,27,Spring2019
2872,SE Powell & 136th,4586,W,NS,17,21,38,13,Spring2019
2873,SE Powell & 138th,4587,W,NS,18,8,26,7,Spring2019
2874,SE Powell & 138th,4588,E,OP,11,25,36,5,Spring2019
2875,SE Powell & 140th,4591,W,NS,22,7,29,3,Spring2019
2876,SE Powell & 141st,4592,E,NS,5,18,23,1,Spring2019
2877,SE Powell & 143rd,4593,E,NS,5,15,20,1,Spring2019
2878,SE Powell & 145th,4595,W,NS,25,11,36,3,Spring2019
2879,SE Powell & 145th,4596,E,FS,6,22,28,4,Spring2019
2880,SE Powell & 148th,4597,W,FS,54,21,75,20,Spring2019
2881,SE Powell & 148th,4598,E,FS,24,60,84,17,Spring2019
2882,SE Powell & 151st,4599,E,FS,8,19,27,6,Spring2019
2883,SE Powell & 154th,4600,E,FS,5,14,19,2,Spring2019
2884,SE Powell & 157th,4602,E,OP,4,13,17,23,Spring2019
2885,SE Powell & 157th,4603,W,NS,13,5,18,3,Spring2019
2886,SE Powell & 160th,4606,E,FS,12,21,33,6,Spring2019
2887,SE Powell & 160th,4607,W,NS,25,12,37,11,Spring2019
2888,SE Powell & 164th,4609,W,NS,39,14,53,17,Spring2019
2889,SE Powell & Naegeli ,4610,E,FS,5,27,32,7,Spring2019
2890,SE Powell & 166th,4611,W,NS,25,4,29,4,Spring2019
2891,SE Powell & 168th,4612,E,OP,12,44,56,8,Spring2019
2892,SE Powell & 168th,4613,W,FS,37,9,46,6,Spring2019
2893,SE Powell & 170th,4614,W,NS,45,15,60,15,Spring2019
2894,SE Powell & 174th,4615,E,FS,22,56,78,29,Spring2019
2895,SE Powell & 174th,4616,W,NS,69,26,95,58,Spring2019
2896,W Powell & SW 181st,4617,W,OP,115,64,179,58,Spring2019
2897,W Powell & SW Highland,4618,E,FS,111,147,258,54,Spring2019
2898,W Powell & Powell Loop,4620,E,FS,6,13,19,4,Spring2019
2899,W Powell & Powell Loop,4621,W,FS,14,7,21,3,Spring2019
2900,SE Powell & 21st ,4622,E,FS,65,95,160,18,Spring2019
2901,SE Powell & 21st ,4623,W,NS,103,46,149,23,Spring2019
2902,SE Powell & 24th ,4625,E,OP,23,15,38,3,Spring2019
2903,SE Powell & 24th ,4626,W,FS,78,20,98,5,Spring2019
2904,SE Powell & 26th ,4627,E,NS,138,167,305,20,Spring2019
2905,SE Powell & 28th ,4631,W,NS,213,228,441,32,Spring2019
2906,SE Powell Valley & 282nd,4633,E,NS,1,1,2,0,Spring2019
2907,E Powell & SE 3rd ,4638,N,FS,0,0,0,0,Spring2019
2908,E Powell & SE 3rd ,4639,S,OP,0,3,3,0,Spring2019
2915,SE Powell & 33rd,4643,W,FS,76,35,111,17,Spring2019
2916,SE Powell & 33rd,4644,E,NS,43,83,126,17,Spring2019
2917,SE Powell & 34th,4646,W,OP,62,33,95,18,Spring2019
2918,SE Powell & 34th,4647,E,FS,51,68,119,22,Spring2019
2919,SE Powell & 36th Pl,4648,E,FS,10,33,43,5,Spring2019
2920,SE Powell & 36th,4649,W,FS,38,13,51,12,Spring2019
2921,SE Powell & Cesar Chavez Blvd,4651,E,FS,175,281,456,108,Spring2019
2922,SE Powell & Cesar Chavez Blvd,4653,W,FS,255,151,406,87,Spring2019
2923,SE Powell & 40th,4654,W,NS,7,24,31,7,Spring2019
2924,SE Powell & 42nd,4656,E,NS,22,43,65,8,Spring2019
2925,SE Powell & 43rd,4657,W,NS,42,18,60,6,Spring2019
2926,SE Powell & 47th,4662,E,OP,16,40,56,4,Spring2019
2927,SE Powell & 47th,4663,W,FS,16,8,24,2,Spring2019
2928,SE Powell & 49th,4664,W,NS,84,38,122,28,Spring2019
2929,SE Powell & 50th/Foster,4666,E,FS,56,138,194,38,Spring2019
2930,SE Powell & 52nd,4667,E,FS,114,115,229,25,Spring2019
2931,SE Powell & 52nd,4668,W,FS,127,97,224,24,Spring2019
2932,SE Powell & 58th,4674,W,NS,49,17,66,9,Spring2019
2933,SE Powell & 60th,4675,E,FS,12,30,42,9,Spring2019
2934,SE Powell & 62nd,4676,W,FS,20,11,31,9,Spring2019
2935,SE Powell & 65th,4679,E,FS,15,67,82,15,Spring2019
2936,SE Powell & 67th,4680,E,FS,16,26,42,4,Spring2019
2937,SE Powell & 67th,4681,W,FS,42,20,62,6,Spring2019
2938,SE Powell & 69th,4682,E,FS,14,31,45,11,Spring2019
2939,SE Powell & 69th,4683,W,FS,39,13,52,5,Spring2019
2940,SE Powell & 71st,4684,W,NS,71,23,94,9,Spring2019
2941,SE Powell & 72nd,4686,E,NS,21,60,81,16,Spring2019
2942,SE Powell & 79th,4691,E,OP,14,116,130,34,Spring2019
2943,SE Powell & 79th,4692,W,FS,101,12,113,35,Spring2019
2944,SE Powell & 82nd,4693,E,FS,296,251,547,94,Spring2019
2945,SE Powell & 82nd,4695,W,FS,215,207,422,102,Spring2019
2946,SE Powell & 84th,4698,W,FS,13,60,73,13,Spring2019
2947,SE Powell & 86th,4699,E,FS,50,78,128,13,Spring2019
2948,SE Powell & 87th,4700,W,FS,76,50,126,12,Spring2019
2949,SE Powell & 9th,4701,E,NS,2,26,28,2,Spring2019
2950,SE Powell & 9th,4702,W,FS,17,5,22,4,Spring2019
2951,SE Powell & 90th Pl,4704,E,OP,8,29,37,5,Spring2019
2952,SE Powell & 90th Pl,4706,W,FS,16,8,24,6,Spring2019
2953,SE Powell & 92nd,4707,E,FS,235,112,347,49,Spring2019
2954,SE Powell & 92nd,4709,W,FS,106,96,202,46,Spring2019
2955,2800 Block SE Powell Valley,4713,E,AT,3,11,14,4,Spring2019
2956,2800 Block SE Powell Valley,4714,W,AT,6,4,10,4,Spring2019
2957,SE Powell Valley & Hale,4715,E,OP,1,8,9,1,Spring2019
2958,SE Powell Valley & Dogwood,4718,E,FS,0,0,0,0,Spring2019
2959,SE Powell Valley & Dogwood,4719,W,NS,1,0,1,0,Spring2019
2960,SE Powell Valley & Robin,4720,W,OP,7,0,7,0,Spring2019
2961,NE Prescott & 102nd,4724,E,NS,37,14,51,13,Spring2019
2968,10600 Block NE Prescott,4725,E,AT,10,5,15,0,Spring2019
2969,10700 Block NE Prescott,4726,W,OP,8,7,15,1,Spring2019
2970,NE Prescott & 102nd,4730,W,FS,18,38,56,6,Spring2019
2971,NE Prescott & 105th,4731,E,NS,32,13,45,1,Spring2019
2972,NE Prescott & 105th,4732,W,NS,13,33,46,2,Spring2019
2973,NE Prescott & 110th,4733,E,NS,10,5,15,4,Spring2019
2974,NE Prescott & 110th,4734,W,OP,7,7,14,2,Spring2019
2975,NE Prescott & 112th,4735,E,NS,13,12,25,6,Spring2019
2976,NE Prescott & 112th,4736,W,NS,10,19,29,3,Spring2019
2977,NE Prescott & 115th,4737,E,FS,12,4,16,6,Spring2019
2978,NE Prescott & 115th,4738,W,NS,8,13,21,10,Spring2019
2979,NE Prescott & 118th,4739,E,OP,7,5,12,2,Spring2019
2980,NE Prescott & 118th,4740,W,NS,6,10,16,2,Spring2019
2981,NE Prescott & 121st Pl,4741,E,NS,19,7,26,2,Spring2019
2982,NE Prescott & 64th,4744,E,NS,5,10,15,1,Spring2019
2983,NE Prescott & 64th,4745,W,NS,14,7,21,0,Spring2019
2984,NE Prescott & 68th,4748,E,NS,13,23,36,1,Spring2019
2985,NE Prescott & 68th,4749,W,FS,22,11,33,1,Spring2019
2986,NE Prescott & 72nd,4752,E,NS,10,21,31,12,Spring2019
2987,NE Prescott & 72nd,4753,W,NS,23,7,30,17,Spring2019
2988,NE Prescott & 77th,4756,E,NS,2,14,16,4,Spring2019
2989,NE Prescott & 77th,4757,W,NS,17,2,19,0,Spring2019
2990,NE Prescott & 82nd,4760,E,NS,18,46,64,11,Spring2019
2991,NE Prescott & 82nd,4761,W,FS,38,14,52,13,Spring2019
2992,NE Prescott & 85th,4762,E,NS,1,2,3,1,Spring2019
2993,NE Prescott & 84th,4763,W,FS,4,4,8,0,Spring2019
2994,NE Prescott & 88th,4764,E,NS,2,7,9,12,Spring2019
2995,NE Prescott & 92nd,4766,E,FS,20,2,22,0,Spring2019
2996,NE Prescott & 92nd,4767,W,NS,2,25,27,3,Spring2019
2997,NE Prescott & 97th,4769,E,OP,6,1,7,0,Spring2019
2998,NE Prescott & 99th,4770,E,NS,5,3,8,1,Spring2019
2999,12600 Block NE Prescott Dr,4772,E,OP,1,7,8,1,Spring2019
3000,NE Prescott Dr & 125th Pl,4773,W,NS,9,0,9,0,Spring2019
3001,NE Prescott Dr & 129th Pl,4774,E,NS,4,10,14,1,Spring2019
3002,NE Prescott Dr & 129th Pl,4775,W,OP,9,0,9,1,Spring2019
3003,NE Prescott Dr & 131st Pl,4776,E,NS,1,11,12,1,Spring2019
3004,NE Prescott Dr & 131st Pl,4777,W,NS,8,0,8,3,Spring2019
3005,NE Prescott Dr & 132nd Pl,4778,W,OP,21,1,22,1,Spring2019
3006,Railroad & 7th ,4784,N,NS,6,10,16,1,Spring2019
3007,NW Thurman & 21st ,4787,E,NS,14,7,21,1,Spring2019
3008,SW Ravensview & Terrace,4799,E,NS,4,0,4,0,Spring2019
3009,SW Redondo & Santa Monica,4801,S,OP,0,1,1,0,Spring2019
3010,NE Regents & 26th ,4811,E,NS,2,4,6,0,Spring2019
3011,NE Regents & Ridgewood Dr,4812,W,NS,7,2,9,0,Spring2019
3012,SE Rex & 28th ,4813,W,NS,5,1,6,0,Spring2019
3013,SE Rex & 32nd ,4816,E,NS,3,18,21,1,Spring2019
3014,N Richmond & Syracuse,4817,N,NS,17,44,61,12,Spring2019
3021,N Richmond & Syracuse,4818,S,NS,189,189,378,85,Spring2019
3022,12500 Block SE River Rd,4819,N,AT,10,1,11,0,Spring2019
3023,12500 Block SE River Rd,4820,S,AT,0,6,6,0,Spring2019
3024,12600 Block SE River Rd,4821,S,OP,1,5,6,0,Spring2019
3025,14000 Block SE River Rd,4822,N,AT,1,0,1,0,Spring2019
3026,14100 Block SE River Rd,4823,S,AT,0,1,1,0,Spring2019
3027,17300 Block SE River Rd,4824,S,AT,0,1,1,0,Spring2019
3028,SE River Rd & Anspach,4831,N,NS,1,1,2,0,Spring2019
3029,SE River Rd & Anspach,4832,S,OP,1,1,2,0,Spring2019
3030,SE River Rd & Boardman,4833,N,NS,2,1,3,0,Spring2019
3031,SE River Rd & Boardman,4834,S,FS,1,3,4,0,Spring2019
3032,SE River Rd & Britton,4835,N,OP,4,1,5,0,Spring2019
3033,SE River Rd & Britton,4836,S,NS,0,2,2,0,Spring2019
3034,SE River Rd & Concord,4837,N,NS,1,0,1,0,Spring2019
3035,SE River Rd & Concord,4838,S,OP,0,1,1,0,Spring2019
3036,SE River Rd & Cooke,4839,S,FS,0,2,2,0,Spring2019
3037,SE River Rd & Courtney,4840,N,NS,3,2,5,0,Spring2019
3038,SE River Rd & Courtney,4841,S,NS,3,2,5,0,Spring2019
3039,SE River Rd & Laurelwood,4844,N,OP,3,0,3,0,Spring2019
3040,SE River Rd & Evergreen,4846,N,NS,6,2,8,0,Spring2019
3041,SE River Rd & Evergreen,4847,S,OP,1,6,7,0,Spring2019
3042,SE River Rd & Hull Ave,4849,N,NS,1,0,1,0,Spring2019
3043,SE River Rd & Hull Ave,4850,S,FS,1,0,1,0,Spring2019
3044,SE River Rd & Jennings,4851,N,NS,3,2,5,0,Spring2019
3045,SE River Rd & Jennings,4852,S,NS,0,2,2,0,Spring2019
3046,SE River Rd & Juniper Dr,4853,N,OP,0,1,1,0,Spring2019
3047,SE River Rd & Juniper Dr,4854,S,NS,1,0,1,0,Spring2019
3048,SE River Rd & Maple,4857,N,NS,2,2,4,0,Spring2019
3049,SE River Rd & Maple,4858,S,FS,2,2,4,0,Spring2019
3050,SE River Rd & Meldrum,4860,N,NS,1,0,1,0,Spring2019
3051,SE River Rd & Meldrum,4861,S,NS,0,1,1,0,Spring2019
3052,SE River Rd & Mulberry,4862,N,OP,3,0,3,0,Spring2019
3053,SE River Rd & Mulberry,4863,S,FS,0,1,1,2,Spring2019
3054,SE River Rd & Naef,4864,N,FS,1,0,1,0,Spring2019
3055,SE River Rd & Oak Grove,4865,N,NS,21,6,27,1,Spring2019
3056,SE River Rd & Oak Grove,4866,S,FS,7,17,24,2,Spring2019
3057,SE River Rd & Parkview Circle,4867,N,NS,4,1,5,0,Spring2019
3058,SE River Rd & River Dr,4870,N,OP,4,2,6,0,Spring2019
3059,SE River Rd & River Dr,4871,S,NS,1,1,2,0,Spring2019
3060,SE River Rd & River Forest,4874,S,FS,2,2,4,0,Spring2019
3061,SE River Rd & River Glen Ct,4875,N,OP,0,1,1,0,Spring2019
3062,SE River Rd & River Glen Ct,4876,S,FS,0,0,0,0,Spring2019
3063,SE River Rd & Cooke,4878,N,OP,1,0,1,0,Spring2019
3064,SE River Rd & Roethe,4879,N,NS,1,0,1,0,Spring2019
3065,SE River Rd & Roethe,4880,S,OP,0,1,1,0,Spring2019
3066,SE River Rd & Rogers,4881,N,NS,1,0,1,0,Spring2019
3067,SE River Rd & Rosebrier,4883,N,NS,2,0,2,0,Spring2019
3074,SE River Rd & Rosebrier,4884,S,OP,1,1,2,0,Spring2019
3075,SE River Rd & Swain,4888,N,FS,2,0,2,0,Spring2019
3076,SE River Rd & Swain,4889,S,OP,0,2,2,0,Spring2019
3077,SE River Rd & Torbank,4891,N,NS,3,2,5,0,Spring2019
3078,SE River Rd & Wren,4892,N,NS,2,1,3,0,Spring2019
3079,SW Riverside & Briarwood,4894,S,OP,0,2,2,0,Spring2019
3080,SW Riverside & Briarwood,4895,N,NS,3,0,3,0,Spring2019
3081,SW Riverside & Elk Rock,4896,N,FS,1,0,1,0,Spring2019
3082,SW Riverside & Greenwood,4897,N,OP,2,1,3,0,Spring2019
3083,SW Riverside & Breyman,4898,S,NS,1,2,3,0,Spring2019
3084,SW Riverside & Midvale,4899,S,FS,0,2,2,0,Spring2019
3085,SW Riverside & Military,4900,S,NS,1,4,5,0,Spring2019
3086,SW Riverside & Military,4901,N,NS,3,1,4,0,Spring2019
3087,SW Riverside & Palatine Hill,4902,S,FS,0,1,1,0,Spring2019
3088,SW Riverside & Palatine Hill,4904,N,OP,1,0,1,0,Spring2019
3089,SW Riverside & Radcliffe,4905,S,FS,0,2,2,0,Spring2019
3090,SW Riverside & Riverdale,4906,S,NS,1,4,5,0,Spring2019
3091,SW Riverside & Riverdale,4908,N,OP,5,1,6,0,Spring2019
3092,SW Riverside & Riverwood,4909,S,OP,0,0,0,0,Spring2019
3093,SW Riverside & Riverwood,4910,N,NS,0,0,0,0,Spring2019
3094,N Riverside Way & 33rd Dr,4912,E,NS,0,14,14,0,Spring2019
3095,SE Roots & 79th,4934,W,FS,0,0,0,0,Spring2019
3096,SE Roots & Hearthwood Dr,4935,E,NS,2,1,3,0,Spring2019
3097,SE Roots & Johnson,4937,W,NS,2,2,4,1,Spring2019
3098,SE Roots & Lark,4938,W,NS,2,1,3,0,Spring2019
3099,SE Roots & Rickshire,4939,E,OP,0,0,0,0,Spring2019
3100,SE Roots & Rickshire,4941,W,NS,0,0,0,0,Spring2019
3101,SE Webster & Roots,4943,N,FS,3,2,5,0,Spring2019
3102,SE Roots & 79th,4945,E,NS,0,0,0,0,Spring2019
3103,SE Roots & 81st,4946,E,FS,1,1,2,0,Spring2019
3104,13600 Block NE Rose Parkway,4955,E,AT,1,2,3,0,Spring2019
3105,NE Rose Parkway & 141st,4958,E,NS,2,2,4,1,Spring2019
3106,NE Rose Parkway & 143rd,4960,E,OP,1,3,4,4,Spring2019
3107,Ross Island Bridge,4964,E,AT,26,16,42,9,Spring2019
3108,NE Sacramento & 142nd,4979,E,NS,1,1,2,0,Spring2019
3109,NE Sacramento & 142nd,4980,W,FS,1,0,1,0,Spring2019
3110,NE Sacramento & 146th Dr,4982,W,NS,3,0,3,0,Spring2019
3111,NE Sacramento & Brazee Ct,4984,W,NS,3,0,3,0,Spring2019
3112,NE Sacramento & 132nd,4987,W,NS,5,0,5,0,Spring2019
3113,NE Sacramento & 134th Pl,4988,E,NS,0,2,2,0,Spring2019
3114,NE Sacramento & 138th Pl,4990,E,NS,0,4,4,4,Spring2019
3115,NE Sacramento & 138th Pl,4991,W,NS,4,0,4,4,Spring2019
3116,14600 Block NE Sacramento,4993,E,OP,3,4,7,1,Spring2019
3117,NE Sacramento & 148th,4994,E,NS,0,0,0,0,Spring2019
3118,7800 Block SW Sagert,4999,E,AT,1,4,5,0,Spring2019
3119,SW Sagert & Wampanoag,5001,E,FS,0,15,15,0,Spring2019
3120,SW Sagert & 70th,5002,E,FS,0,23,23,0,Spring2019
3127,SW Sagert & 72nd,5003,E,FS,0,6,6,0,Spring2019
3128,SW Sagert & 86th,5004,E,NS,4,5,9,0,Spring2019
3129,SW Salmon & 19th,5006,E,FS,3,18,21,0,Spring2019
3130,SW Salmon & Park,5007,E,NS,108,95,203,32,Spring2019
3131,SW Salmon & 10th,5009,E,NS,105,50,155,59,Spring2019
3132,SW Salmon & 12th,5012,E,FS,69,67,136,82,Spring2019
3133,SW Salmon & 14th,5014,E,NS,58,76,134,11,Spring2019
3134,SW Salmon & 16th,5016,E,OP,1,58,59,0,Spring2019
3135,SW Salmon & 20th,5018,W,FS,5,5,10,0,Spring2019
3136,SW Salmon & 20th,5019,E,NS,2,1,3,0,Spring2019
3137,SW Salmon & 5th,5020,E,NS,491,477,968,133,Spring2019
3138,NW Barnes & Saltzman,5025,S,FS,42,9,51,4,Spring2019
3139,SW Sam Jackson Pk & Campus Dr,5027,E,NS,82,34,116,7,Spring2019
3140,SW Sam Jackson Pk & OHSU,5028,E,AT,548,322,870,89,Spring2019
3141,SW Sam Jackson Pk & US Veterans,5032,E,FS,427,520,947,66,Spring2019
3142,NE San Rafael & 125th,5033,E,FS,0,0,0,0,Spring2019
3143,NE San Rafael & 125th,5034,W,FS,0,2,2,0,Spring2019
3144,NE San Rafael & 122nd,5035,E,FS,7,4,11,9,Spring2019
3145,NE San Rafael & 122nd,5036,W,NS,3,8,11,1,Spring2019
3146,NE San Rafael & 128th,5037,E,OP,0,1,1,0,Spring2019
3147,NE San Rafael & 132nd,5039,E,NS,0,2,2,0,Spring2019
3148,NE Sandy & Flanders,5044,E,NS,38,63,101,11,Spring2019
3149,NE Sandy & Fremont,5045,E,NS,17,26,43,16,Spring2019
3150,NE Sandy & Grotto,5046,E,AT,7,13,20,3,Spring2019
3151,NE Sandy & Imperial,5048,E,FS,8,18,26,17,Spring2019
3152,NE Sandy & Lawrence,5049,E,FS,8,21,29,7,Spring2019
3153,NE Sandy & Parkrose Transit Center,5050,W,AT,0,314,314,2,Spring2019
3154,NE Sandy & Prescott,5051,E,FS,3,36,39,6,Spring2019
3155,NE Sandy & Prescott,5052,W,FS,15,4,19,3,Spring2019
3156,NE Sandy & Sacramento,5054,E,FS,8,26,34,1,Spring2019
3157,NE Sandy & 14th,5058,W,NS,52,29,81,13,Spring2019
3158,NE Sandy & 16th,5060,W,NS,80,38,118,34,Spring2019
3159,NE Sandy & 18th,5061,E,NS,68,84,152,59,Spring2019
3160,NE Sandy & 18th,5062,W,FS,83,55,138,82,Spring2019
3161,NE Sandy & 20th,5063,W,NS,103,54,157,19,Spring2019
3162,NE Sandy & 24th,5066,E,FS,50,85,135,11,Spring2019
3163,NE Sandy & 24th,5067,W,NS,69,34,103,9,Spring2019
3164,NE Sandy & 26th,5068,W,FS,53,40,93,14,Spring2019
3165,NE Sandy & 28th,5069,W,NS,2,14,16,2,Spring2019
3166,NE Sandy & 28th,5070,E,NS,43,65,108,17,Spring2019
3167,NE Sandy & 31st,5076,E,FS,21,40,61,16,Spring2019
3168,NE Sandy & 31st,5077,W,FS,32,22,54,20,Spring2019
3169,NE Sandy & 33rd,5079,E,FS,41,71,112,21,Spring2019
3170,NE Sandy & 33rd,5080,W,NS,73,38,111,21,Spring2019
3171,NE Sandy & 35th,5081,W,FS,15,9,24,16,Spring2019
3172,NE Sandy & 42nd,5087,E,FS,161,217,378,117,Spring2019
3173,NE Sandy & 44th,5091,E,FS,29,24,53,17,Spring2019
3180,NE Sandy & 47th,5093,W,NS,48,13,61,6,Spring2019
3181,NE Sandy & 47th,5094,E,FS,18,44,62,7,Spring2019
3182,NE Sandy & 50th,5097,E,FS,8,28,36,6,Spring2019
3183,NE Sandy & 50th,5098,W,FS,28,8,36,5,Spring2019
3184,NE Sandy & 52nd,5100,W,FS,25,9,34,4,Spring2019
3185,NE Sandy & 54th,5102,E,OP,9,42,51,1,Spring2019
3186,NE Sandy & 54th,5103,W,NS,40,10,50,1,Spring2019
3187,NE Sandy & 57th,5104,E,NS,23,128,151,66,Spring2019
3188,NE Sandy & 57th,5105,W,NS,114,31,145,60,Spring2019
3189,NE Sandy & 59th,5107,W,NS,21,12,33,5,Spring2019
3190,NE Sandy & 60th,5110,E,FS,7,25,32,6,Spring2019
3191,NE Sandy & 62nd,5112,E,FS,10,40,50,4,Spring2019
3192,NE Sandy & 62nd,5113,W,NS,25,9,34,3,Spring2019
3193,NE Sandy & 64th,5114,W,NS,35,6,41,1,Spring2019
3194,NE Sandy & 65th,5115,E,NS,5,21,26,2,Spring2019
3195,NE Sandy & 67th,5118,E,NS,6,57,63,5,Spring2019
3196,NE Sandy & 67th,5119,W,NS,45,6,51,1,Spring2019
3197,NE Sandy & 69th,5122,W,OP,82,43,125,38,Spring2019
3198,NE Sandy & 70th,5123,E,FS,35,109,144,53,Spring2019
3199,NE Sandy & Fremont,5125,W,FS,64,26,90,38,Spring2019
3200,NE Sandy & 74th,5127,W,NS,34,10,44,7,Spring2019
3201,NE Sandy & 77th,5132,E,NS,2,33,35,2,Spring2019
3202,NE Sandy & 77th,5133,W,NS,32,2,34,1,Spring2019
3203,NE Sandy & 79th,5135,E,FS,4,44,48,7,Spring2019
3204,NE Sandy & 79th,5136,W,FS,46,8,54,6,Spring2019
3205,NE Sandy & 82nd,5138,E,FS,77,135,212,47,Spring2019
3206,NE Sandy & 82nd,5139,W,NS,158,97,255,52,Spring2019
3207,NE Sandy & 86th,5140,W,FS,20,4,24,8,Spring2019
3208,NE Sandy & 88th,5144,W,FS,22,6,28,20,Spring2019
3209,NE Sandy & 91st,5145,W,NS,23,4,27,1,Spring2019
3210,NE Sandy & 92nd,5146,E,NS,0,9,9,1,Spring2019
3211,2500 Block of NE Saratoga,5148,W,AT,103,94,197,18,Spring2019
3212,NE Saratoga & Dekum,5150,S,NS,11,1,12,0,Spring2019
3213,4900 Block SW Scholls Ferry,5152,W,AT,4,18,22,4,Spring2019
3214,5000 Block SW Scholls Ferry,5153,W,AT,18,31,49,7,Spring2019
3215,5900 Block SW Scholls Ferry (Crosswalk),5155,S,OP,0,1,1,0,Spring2019
3216,5900 Block SW Scholls Ferry (Crosswalk),5156,N,AT,1,1,2,0,Spring2019
3217,6700 Block SW Scholls Ferry,5157,S,AT,11,33,44,1,Spring2019
3218,6700 Block SW Scholls Ferry,5158,N,AT,14,10,24,0,Spring2019
3219,7700 Block SW Scholls Ferry,5159,S,AT,3,5,8,13,Spring2019
3220,8600 Block SW Scholls Ferry,5160,N,AT,25,5,30,1,Spring2019
3221,8600 Block SW Scholls Ferry,5161,S,OP,3,38,41,3,Spring2019
3222,SW Scholls Ferry & Allen,5162,N,FS,29,9,38,1,Spring2019
3223,SW Scholls Ferry & Cascade,5164,S,FS,4,5,9,0,Spring2019
3224,SW Scholls Ferry & Conestoga,5165,E,OP,26,26,52,2,Spring2019
3225,SW Scholls Ferry & Conestoga,5166,W,FS,17,17,34,6,Spring2019
3226,SW Scholls Ferry & Crestwood,5167,S,FS,0,3,3,0,Spring2019
3233,SW Scholls Ferry & Crestwood,5168,N,OP,2,0,2,0,Spring2019
3234,SW Scholls Ferry & Crystal,5169,S,NS,1,4,5,0,Spring2019
3235,SW Scholls Ferry & Crystal,5170,N,OP,5,3,8,1,Spring2019
3236,SW Scholls Ferry & Merry,5171,S,OP,3,17,20,3,Spring2019
3237,SW Scholls Ferry & Dogwood Lane,5172,W,NS,0,0,0,0,Spring2019
3238,SW Scholls Ferry & Eagle,5173,N,FS,3,1,4,25,Spring2019
3239,SW Scholls Ferry & Heather,5175,N,FS,26,9,35,1,Spring2019
3240,SW Scholls Ferry & Heather,5176,S,FS,9,22,31,0,Spring2019
3241,SW Scholls Ferry & Marjorie,5180,S,NS,2,13,15,0,Spring2019
3242,SW Scholls Ferry & Marjorie,5181,N,OP,12,4,16,1,Spring2019
3243,SW Scholls Ferry & Merry,5182,N,NS,21,6,27,1,Spring2019
3244,SW Scholls Ferry & BH Hwy,5184,W,FS,20,54,74,10,Spring2019
3245,SW Scholls Ferry & Montclair,5185,E,NS,2,2,4,0,Spring2019
3246,SW Scholls Ferry & Stephen Lane,5186,E,NS,10,7,17,1,Spring2019
3247,SW Scholls Ferry & Nicol,5187,E,FS,15,6,21,1,Spring2019
3248,SW Scholls Ferry & Nicol,5188,W,OP,4,15,19,0,Spring2019
3249,SW Scholls Ferry & Nimbus,5189,W,FS,25,24,49,19,Spring2019
3250,SW Scholls Ferry & Nimbus,5190,E,FS,24,31,55,22,Spring2019
3251,5200 Block SW Scholls Ferry,5192,W,AT,2,2,4,0,Spring2019
3252,5100 Block SW Scholls Ferry,5193,E,AT,32,20,52,3,Spring2019
3253,4400 Block SW Scholls Ferry,5194,N,OP,1,0,1,0,Spring2019
3254,SW Scholls Ferry & Seymour,5195,S,OP,0,0,0,0,Spring2019
3255,SW Scholls Ferry & Seymour,5196,N,FS,1,0,1,0,Spring2019
3256,SW Scholls Ferry & Springwood,5197,E,FS,15,6,21,0,Spring2019
3257,6800 Block SW Scholls Ferry,5198,S,AT,0,0,0,0,Spring2019
3258,4400 Block SW Scholls Ferry,5199,S,AT,0,0,0,0,Spring2019
3259,SW Scholls Ferry & 86th,5200,S,OP,0,1,1,0,Spring2019
3260,SW Scholls Ferry & 86th,5201,N,FS,1,0,1,0,Spring2019
3261,SW Scholls Ferry & 88th,5202,W,OP,0,2,2,0,Spring2019
3262,SW Scholls Ferry & 88th,5203,E,FS,1,0,1,0,Spring2019
3263,SW Scholls Ferry & 90th,5204,E,NS,14,2,16,0,Spring2019
3264,SW Scholls Ferry & 90th,5205,W,OP,1,11,12,0,Spring2019
3265,SW Scholls Ferry & 92nd,5206,E,FS,8,1,9,0,Spring2019
3266,SW Scholls Ferry & 92nd,5207,W,FS,3,26,29,0,Spring2019
3267,SW Shattuck & 60th,5221,N,NS,6,6,12,0,Spring2019
3268,SW Shattuck & 63rd,5222,E,FS,0,0,0,0,Spring2019
3269,NE Shaver & 135th,5223,E,OP,4,11,15,6,Spring2019
3270,NE Shaver & 102nd,5225,W,NS,3,2,5,0,Spring2019
3271,NE Shaver & 105th,5226,E,NS,2,9,11,5,Spring2019
3272,NE Shaver & 105th,5227,W,NS,9,1,10,0,Spring2019
3273,NE Shaver & 109th,5228,E,NS,1,12,13,11,Spring2019
3274,NE Shaver & 109th,5229,W,NS,12,2,14,11,Spring2019
3275,NE Shaver & 112th,5230,E,NS,1,5,6,2,Spring2019
3276,NE Shaver & 112th,5231,W,NS,5,1,6,1,Spring2019
3277,NE Shaver & 114th,5232,E,NS,0,7,7,0,Spring2019
3278,NE Shaver & 122nd,5234,E,NS,14,11,25,9,Spring2019
3279,NE Shaver & 122nd,5235,W,NS,13,13,26,10,Spring2019
3286,NE Shaver & 134th,5236,W,OP,2,0,2,1,Spring2019
3287,NE Shaver & 135th,5237,W,FS,5,0,5,3,Spring2019
3288,NE Shaver & 138th,5238,W,FS,12,1,13,0,Spring2019
3289,SW Sheridan & 4th,5239,E,FS,21,12,33,1,Spring2019
3290,SW Sherwood & Sherwood Middle School,5244,N,AT,5,0,5,0,Spring2019
3291,21900 Block N Sherwood Blvd,5245,S,AT,0,5,5,3,Spring2019
3292,N Sherwood Blvd & NW Gleneagle,5246,S,NS,0,6,6,1,Spring2019
3293,N Sherwood & SW 10th,5247,N,OP,6,0,6,0,Spring2019
3294,SW Sherwood Blvd & NW 12th St,5248,S,NS,3,9,12,3,Spring2019
3295,N Sherwood & SW Century,5249,N,NS,7,1,8,1,Spring2019
3296,NE Skidmore & 122nd,5250,E,NS,59,20,79,6,Spring2019
3297,NE Skidmore & 29th,5253,E,NS,29,1,30,1,Spring2019
3298,1700 Block South Shore,5285,W,AT,0,0,0,0,Spring2019
3299,1800 Block South Shore (Park & Ride),5286,W,AT,0,1,1,0,Spring2019
3300,1800 Block South Shore (Park & Ride),5287,E,OP,0,1,1,0,Spring2019
3301,2500 Block South Shore,5288,W,AT,0,0,0,0,Spring2019
3302,3800 Block South Shore,5289,W,AT,0,0,0,0,Spring2019
3303,4100 Block South Shore,5290,W,AT,0,0,0,0,Spring2019
3304,4100 Block South Shore,5291,S,OP,0,0,0,0,Spring2019
3305,4300 Block South Shore,5292,N,AT,0,1,1,0,Spring2019
3306,South Shore & Blue Heron,5293,N,FS,0,0,0,0,Spring2019
3307,South Shore & Canyon,5294,E,FS,1,0,1,0,Spring2019
3308,South Shore & Cedar Ct,5295,W,FS,0,2,2,0,Spring2019
3309,South Shore & Fernwood,5296,W,OP,0,1,1,0,Spring2019
3310,South Shore & Cedar Rd,5297,W,OP,1,1,2,22,Spring2019
3311,South Shore & Edgecliff,5298,W,FS,0,1,1,0,Spring2019
3312,South Shore & Fernwood,5299,E,NS,1,0,1,0,Spring2019
3313,South Shore & Greenbrier,5300,W,FS,0,0,0,0,Spring2019
3314,South Shore & Greentree,5301,W,OP,1,2,3,0,Spring2019
3315,South Shore & Greentree,5302,E,NS,2,0,2,0,Spring2019
3316,South Shore & Kelok,5303,E,NS,0,0,0,0,Spring2019
3317,South Shore & Lakeridge,5304,E,FS,2,0,2,0,Spring2019
3318,Lakeview & South Shore,5305,E,NS,0,0,0,0,Spring2019
3319,South Shore & Maple,5306,W,FS,0,0,0,0,Spring2019
3320,McVey & Parrish,5307,E,NS,3,1,4,0,Spring2019
3321,South Shore & Patton,5309,W,NS,1,4,5,0,Spring2019
3322,South Shore & Canal Circle,5311,E,FS,0,0,0,0,Spring2019
3323,SE Sparrow & 22nd,5312,E,FS,0,0,0,0,Spring2019
3324,SW Spring & Vista,5313,W,NS,7,0,7,0,Spring2019
3325,SW Spring Garden & 11th,5314,E,NS,1,5,6,0,Spring2019
3326,SW Spring Garden & 14th,5315,E,NS,0,5,5,0,Spring2019
3327,SW Spring Garden & 14th,5316,W,NS,7,0,7,0,Spring2019
3328,SW Spring Garden & 17th,5317,E,NS,0,9,9,0,Spring2019
3329,SW Spring Garden & 17th,5318,W,NS,12,0,12,0,Spring2019
3330,SW 19th & Spring Garden,5319,N,FS,2,0,2,0,Spring2019
3331,6600 Block NW St Helens,5328,S,AT,3,1,4,0,Spring2019
3332,6600 Block NW St Helens,5329,N,OP,0,2,2,0,Spring2019
3339,6800 Block NW St Helens,5330,N,OP,2,1,3,0,Spring2019
3340,NW St Helens & Milepost 8,5332,N,AT,0,0,0,0,Spring2019
3341,NW St Helens & Milepost 8,5333,S,FS,0,0,0,0,Spring2019
3342,NW St Helens & Bridge,5336,S,NS,3,0,3,0,Spring2019
3343,NW St Helens & Doane,5338,N,FS,0,3,3,0,Spring2019
3344,NW St Helens & Doane,5339,S,OP,3,0,3,0,Spring2019
3345,11400 Block NW St Helens,5341,N,AT,2,4,6,0,Spring2019
3346,11400 Block NW St Helens,5342,S,OP,2,0,2,0,Spring2019
3347,NW St Helens & Harbor,5344,S,NS,2,0,2,0,Spring2019
3348,NW St Helens & Hoge,5345,N,OP,0,2,2,0,Spring2019
3349,NW St Helens & Hoge,5346,S,FS,2,0,2,0,Spring2019
3350,9400 Block NW St Helens,5350,N,AT,0,0,0,0,Spring2019
3351,NW St Helens & Front,5352,N,NS,1,4,5,0,Spring2019
3352,NW St Helens & Front,5353,S,OP,5,1,6,0,Spring2019
3353,NW St Helens & 105th,5354,N,FS,0,1,1,0,Spring2019
3354,NW St Helens & 105th,5355,S,FS,1,0,1,0,Spring2019
3355,NW St Helens & 107th,5356,N,NS,0,7,7,2,Spring2019
3356,NW St Helens & 107th,5357,S,OP,8,0,8,5,Spring2019
3357,NW St Helens & 109th,5358,N,NS,0,1,1,0,Spring2019
3358,NW St Helens & 111th,5359,N,OP,2,3,5,0,Spring2019
3359,NW St Helens & 56th,5361,N,OP,1,0,1,0,Spring2019
3360,NW St Helens & 56th,5362,S,NS,1,0,1,0,Spring2019
3361,N St Louis & New York,5373,E,NS,8,2,10,1,Spring2019
3362,N St Louis & Seneca,5374,W,NS,3,11,14,14,Spring2019
3363,N St Louis & Smith,5375,W,NS,2,18,20,2,Spring2019
3364,N St Louis & Smith,5376,E,NS,11,2,13,2,Spring2019
3365,St Vincent Hospital Dr & Barnes,5377,S,NS,12,8,20,5,Spring2019
3366,St Vincent Hospital East Pavilion,5378,W,AT,79,94,173,65,Spring2019
3367,St Vincent Hospital Main Stop,5379,W,AT,74,64,138,61,Spring2019
3368,NE Stanton & 117th,5384,W,NS,3,0,3,0,Spring2019
3369,NE Stanton & 121st,5385,W,NS,2,0,2,0,Spring2019
3370,NE Stanton & 122nd,5386,E,NS,0,4,4,0,Spring2019
3371,SE Stark & 182nd,5390,W,OP,55,56,111,28,Spring2019
3372,21000 Block SE Stark,5391,W,AT,14,6,20,2,Spring2019
3373,21000 Block SE Stark,5392,E,NS,6,15,21,1,Spring2019
3374,SE Stark & 215th,5393,W,OP,15,6,21,1,Spring2019
3375,9200 Block SE Stark,5394,W,AT,36,16,52,13,Spring2019
3376,SE Stark & 139th,5395,W,FS,58,24,82,23,Spring2019
3377,SE Stark & NE Hale,5397,E,NS,12,75,87,20,Spring2019
3378,SE Stark & SW McGinnis,5398,W,FS,49,13,62,17,Spring2019
3379,SE Stark & NE Kelly,5404,E,NS,3,5,8,0,Spring2019
3380,SE Stark & 238th,5407,W,NS,35,9,44,24,Spring2019
3381,SE Stark & Mt Hood Comm College Entrance,5408,E,FS,0,1,1,0,Spring2019
3382,SE Stark & SW Corbeth Lane,5409,W,NS,2,0,2,0,Spring2019
3383,SE Stark & Medical Center,5410,E,NS,25,42,67,41,Spring2019
3384,SE Stark & NE Rene,5411,W,OP,26,9,35,7,Spring2019
3385,SE Stark & 105th,5414,W,FS,44,70,114,26,Spring2019
3392,SE Stark & 108th,5415,W,NS,24,51,75,15,Spring2019
3393,SE Stark & 111th,5416,E,NS,11,13,24,5,Spring2019
3394,SE Stark & 111th,5417,W,NS,13,7,20,4,Spring2019
3395,SE Stark & 113th,5418,E,FS,6,16,22,9,Spring2019
3396,SE Stark & 113th,5419,W,NS,18,6,24,6,Spring2019
3397,SE Stark & 117th,5421,E,NS,8,30,38,3,Spring2019
3398,SE Stark & 117th,5422,W,FS,35,11,46,16,Spring2019
3399,SE Stark & 119th,5423,E,NS,4,24,28,16,Spring2019
3400,SE Stark & 119th,5424,W,NS,20,8,28,12,Spring2019
3401,SE Stark & 122nd,5425,E,FS,146,129,275,62,Spring2019
3402,SE Stark & 122nd,5426,W,NS,120,169,289,80,Spring2019
3403,SE Stark & 126th,5428,W,NS,96,26,122,17,Spring2019
3404,SE Stark & 130th,5431,E,FS,36,65,101,12,Spring2019
3405,SE Stark & 133rd,5432,E,OP,38,62,100,18,Spring2019
3406,SE Stark & 133rd,5433,W,FS,64,39,103,14,Spring2019
3407,SE Stark & 139th,5436,E,FS,23,60,83,23,Spring2019
3408,SE Stark & 143rd,5439,E,OP,17,50,67,4,Spring2019
3409,SE Stark & 146th,5442,W,FS,23,11,34,10,Spring2019
3410,SE Stark & 148th,5443,W,NS,51,36,87,30,Spring2019
3411,SE Stark & 148th,5444,E,FS,51,66,117,33,Spring2019
3412,SE Stark & 151st,5445,E,FS,9,19,28,2,Spring2019
3413,SE Stark & 151st,5446,W,NS,19,10,29,3,Spring2019
3414,SE Stark & 155th,5448,E,FS,7,23,30,4,Spring2019
3415,SE Stark & 160th,5452,E,FS,36,105,141,48,Spring2019
3416,SE Stark & 160th,5453,W,FS,81,31,112,27,Spring2019
3417,SE Stark & 162nd,5454,E,FS,75,77,152,66,Spring2019
3418,SE Stark & 162nd,5455,W,NS,105,67,172,85,Spring2019
3419,SE Stark & 165th,5457,W,FS,18,17,35,3,Spring2019
3420,SE Stark & 166th Pl,5458,E,NS,21,21,42,2,Spring2019
3421,SE Stark & 167th,5459,W,NS,11,7,18,2,Spring2019
3422,SE Stark & 174th,5461,E,NS,24,45,69,5,Spring2019
3423,SE Stark & 174th,5462,W,OP,50,28,78,10,Spring2019
3424,SE Stark & 176th Pl,5463,E,NS,7,17,24,2,Spring2019
3425,SE Stark & 176th Pl,5464,W,OP,12,6,18,6,Spring2019
3426,SE Stark & 179th,5465,E,NS,18,41,59,33,Spring2019
3427,SE Stark & 179th,5466,W,OP,78,29,107,44,Spring2019
3428,SE Stark & 182nd,5467,E,NS,67,85,152,43,Spring2019
3429,SE Stark & 185th,5468,E,FS,19,21,40,8,Spring2019
3430,SE Stark & 185th,5469,W,NS,10,20,30,9,Spring2019
3431,SE Stark & 192nd,5471,E,OP,19,24,43,13,Spring2019
3432,SE Stark & 192nd,5472,W,NS,19,19,38,17,Spring2019
3433,SE Stark & 196th,5475,E,OP,19,24,43,16,Spring2019
3434,SE Stark & 197th Dr,5476,W,NS,11,9,20,8,Spring2019
3435,SE Stark & 199th,5477,E,NS,9,10,19,5,Spring2019
3436,SE Stark & 202nd,5478,E,FS,21,27,48,27,Spring2019
3437,SE Stark & 202nd,5479,W,FS,22,15,37,19,Spring2019
3438,SE Stark & 205th,5480,E,FS,13,15,28,3,Spring2019
3445,SE Stark & 205th Pl,5481,W,FS,21,13,34,25,Spring2019
3446,SE Stark & 212th,5484,W,OP,8,5,13,2,Spring2019
3447,SE Stark & 217th,5487,E,NS,12,22,34,6,Spring2019
3448,SE Stark & 217th,5488,W,OP,29,14,43,4,Spring2019
3449,SE Stark & 220th,5489,E,OP,6,16,22,1,Spring2019
3450,SE Stark & 223rd,5491,E,FS,58,66,124,30,Spring2019
3451,SE Stark & 223rd,5492,W,FS,54,65,119,35,Spring2019
3452,SE Stark & NE Cleveland,5493,W,FS,15,7,22,5,Spring2019
3453,SE Stark & NE Cleveland,5494,E,NS,6,14,20,3,Spring2019
3454,SE Stark & NE 242nd,5495,E,FS,39,94,133,35,Spring2019
3455,SE Stark & 80th,5498,W,NS,48,9,57,4,Spring2019
3456,SE Stark & 82nd,5499,W,FS,134,77,211,49,Spring2019
3457,SE Stark & 88th,5502,W,NS,18,3,21,1,Spring2019
3458,SE Stark & 90th,5503,W,NS,31,6,37,3,Spring2019
3459,N State & B Ave,5505,N,FS,16,1,17,1,Spring2019
3460,N State & B Ave,5506,S,NS,1,33,34,0,Spring2019
3461,N State & D Ave,5507,S,FS,2,10,12,0,Spring2019
3462,N State & E Ave,5508,N,OP,5,0,5,1,Spring2019
3463,N State & Foothills,5509,N,FS,41,7,48,0,Spring2019
3464,N State & Foothills,5510,S,OP,5,22,27,0,Spring2019
3465,S State & Middlecrest,5511,S,NS,6,25,31,0,Spring2019
3466,S State & North Shore,5512,N,OP,16,7,23,2,Spring2019
3467,N State & North Shore,5513,S,NS,7,8,15,3,Spring2019
3468,S State & Wilbur,5514,N,NS,22,6,28,1,Spring2019
3469,SE Steele & 30th,5515,E,OP,9,15,24,0,Spring2019
3470,SE Steele & 30th,5516,W,FS,16,7,23,0,Spring2019
3471,SE Steele & 28th,5517,W,NS,22,10,32,1,Spring2019
3472,SE Steele & 32nd,5518,W,NS,16,5,21,0,Spring2019
3473,SE Steele & 33rd,5519,E,OP,5,19,24,0,Spring2019
3474,SE Steele & 35th,5520,E,NS,1,8,9,0,Spring2019
3475,SE Steele & 34th,5521,W,NS,13,4,17,0,Spring2019
3476,SE Steele & 36th Pl,5522,E,OP,1,4,5,0,Spring2019
3477,SE Steele & 36th Pl,5523,W,FS,11,1,12,0,Spring2019
3478,SE Steele & Cesar Chavez Blvd,5524,E,NS,13,51,64,1,Spring2019
3479,SE Steele & Cesar Chavez Blvd,5525,W,NS,30,17,47,1,Spring2019
3480,SE Steele & 41st,5526,E,NS,2,16,18,0,Spring2019
3481,SE Steele & 41st,5527,W,NS,14,3,17,0,Spring2019
3482,SE Steele & 44th,5529,E,NS,3,20,23,0,Spring2019
3483,SE Steele & 44th,5530,W,NS,17,2,19,0,Spring2019
3484,SE Steele & 47th,5531,E,FS,5,20,25,5,Spring2019
3485,SE Steele & 50th,5532,E,NS,3,16,19,0,Spring2019
3486,SE Steele & 50th,5533,W,FS,12,1,13,3,Spring2019
3487,SE Steele & 52nd,5534,E,NS,12,50,62,2,Spring2019
3488,SE Steele & 52nd,5535,W,FS,26,4,30,1,Spring2019
3489,1500 Block SW Sunset Blvd,5552,N,AT,0,0,0,0,Spring2019
3490,SW Sunset Blvd & Boundary,5553,N,NS,0,0,0,0,Spring2019
3491,SW Sunset Blvd & Boundary,5554,S,NS,1,0,1,0,Spring2019
3498,SW Sunset Blvd & Dosch,5556,W,NS,0,1,1,0,Spring2019
3499,SW Sunset Blvd & Dosch,5557,E,FS,1,0,1,0,Spring2019
3500,SW Sunset Blvd & Dosch Park Ln,5558,E,FS,1,0,1,0,Spring2019
3501,SW Sunset Blvd & Mitchell,5562,W,OP,0,1,1,0,Spring2019
3502,SW Sunset Blvd & Mitchell,5563,E,FS,2,0,2,0,Spring2019
3503,SW Sunset Blvd & Richardson,5564,N,NS,0,0,0,0,Spring2019
3504,SW Sunset Blvd & Richardson,5565,S,FS,1,0,1,0,Spring2019
3505,SW Sunset Blvd & 18th Dr,5566,S,FS,1,0,1,0,Spring2019
3506,SW Sunset Blvd & 18th Dr,5567,N,FS,0,1,1,0,Spring2019
3507,SW Sunset Blvd & 19th,5568,N,FS,0,1,1,0,Spring2019
3508,SW Sunset Blvd & 25th,5569,S,OP,1,0,1,0,Spring2019
3509,SW Sunset Blvd & 26th,5570,E,FS,1,0,1,0,Spring2019
3510,SW Sunset Blvd & 26th Dr,5571,W,OP,0,0,0,0,Spring2019
3511,SW Sunset Blvd & 27th,5572,W,FS,0,1,1,0,Spring2019
3512,SW Sunset Blvd & 27th,5573,E,OP,0,0,0,0,Spring2019
3513,SW Sunset Blvd & 29th,5574,W,NS,0,1,1,0,Spring2019
3514,SW Sunset Blvd & 31st Dr,5575,W,OP,0,0,0,0,Spring2019
3515,SW Sunset Blvd & 31st Dr,5576,E,FS,1,0,1,0,Spring2019
3516,SW Tualatin Valley Hwy & 214th,5586,W,NS,32,30,62,2,Spring2019
3517,SE Tualatin Valley Hwy & Sunset Esplnd,5588,W,AT,71,53,124,42,Spring2019
3518,SW Tualatin Valley Hwy & Market Centre,5590,E,OP,51,38,89,11,Spring2019
3519,SW Tualatin Valley Hwy & Aloha Villa,5592,W,AT,4,11,15,1,Spring2019
3520,18882-19040 SW Tualatin Valley Hwy,5593,E,AT,9,12,21,0,Spring2019
3521,18882-19040 SW Tualatin Valley Hwy,5594,W,OP,25,22,47,4,Spring2019
3522,SW Tualatin Valley Hwy & 141st,5595,W,NS,11,6,17,2,Spring2019
3523,SW Tualatin Valley Hwy & Hocken,5597,E,NS,18,49,67,13,Spring2019
3524,SE Tualatin Valley Hwy & Minter Bridge,5598,E,NS,106,159,265,53,Spring2019
3525,SW Tualatin Valley Hwy & Murray,5599,W,FS,86,27,113,7,Spring2019
3526,SW Tualatin Valley Hwy & Murray,5600,E,NS,18,75,93,9,Spring2019
3527,SW Tualatin Valley Hwy & Market Centre,5601,W,AT,39,69,108,15,Spring2019
3528,SE Tualatin Valley Hwy & River Rd,5602,E,FS,26,24,50,4,Spring2019
3529,SW Tualatin Valley Hwy & St Marys Home,5603,E,OP,7,10,17,0,Spring2019
3530,SW Tualatin Valley Hwy & St Marys Home,5604,W,AT,4,8,12,0,Spring2019
3531,SE Tualatin Valley Hwy & 24th,5606,E,FS,36,23,59,18,Spring2019
3532,SE Tualatin Valley Hwy & 40th,5609,E,OP,2,4,6,0,Spring2019
3533,SE Tualatin Valley Hwy & Sunset Esplnd,5611,E,OP,66,78,144,61,Spring2019
3534,SE Tualatin Valley Hwy & 24th,5612,W,FS,41,83,124,50,Spring2019
3535,SE Tualatin Valley Hwy & Brookwood,5614,E,FS,62,56,118,13,Spring2019
3536,SE Tualatin Valley Hwy & 11th,5615,N,FS,21,40,61,8,Spring2019
3537,SE Tualatin Valley Hwy & 13th,5616,W,NS,32,31,63,9,Spring2019
3538,SW Tualatin Valley Hwy & 142nd,5617,E,NS,6,14,20,1,Spring2019
3539,SW Tualatin Valley Hwy & 160th,5618,E,FS,53,31,84,7,Spring2019
3540,SW Tualatin Valley Hwy & Millikan Blvd,5619,W,NS,36,55,91,8,Spring2019
3541,SW Tualatin Valley Hwy & 170th,5620,E,FS,108,62,170,17,Spring2019
3542,SW Tualatin Valley Hwy & 170th,5621,W,FS,73,113,186,13,Spring2019
3543,SW Tualatin Valley Hwy & 174th,5622,W,NS,7,14,21,0,Spring2019
3544,SW Tualatin Valley Hwy & 174th,5623,E,OP,19,8,27,0,Spring2019
3551,SW Tualatin Valley Hwy & 178th,5624,E,OP,70,48,118,3,Spring2019
3552,SW Tualatin Valley Hwy & 178th,5625,W,FS,45,69,114,3,Spring2019
3553,SW Tualatin Valley Hwy & 185th,5628,E,FS,115,167,282,38,Spring2019
3554,SW Tualatin Valley Hwy & 185th,5629,W,FS,171,116,287,34,Spring2019
3555,SW Tualatin Valley Hwy & 192nd,5633,W,FS,22,28,50,11,Spring2019
3556,SW Tualatin Valley Hwy & 192nd,5634,E,OP,12,11,23,3,Spring2019
3557,SW Tualatin Valley Hwy & 198th,5635,W,FS,78,66,144,17,Spring2019
3558,SW Tualatin Valley Hwy & 209th,5637,E,NS,29,32,61,3,Spring2019
3559,SW Tualatin Valley Hwy & 209th,5638,W,NS,18,19,37,4,Spring2019
3560,SE Tualatin Valley Hwy & Cypress,5639,W,FS,145,97,242,46,Spring2019
3561,SW Tualatin Valley Hwy & 214th,5642,E,OP,11,14,25,0,Spring2019
3562,SE Tualatin Valley Hwy & Cornelius Pass,5643,E,FS,33,38,71,8,Spring2019
3563,SE Tualatin Valley Hwy & 75th,5644,W,NS,35,37,72,6,Spring2019
3564,SE Tualatin Valley Hwy & 67th,5650,W,FS,28,73,101,27,Spring2019
3565,SE Tualatin Valley Hwy & 67th (229th),5651,E,NS,47,24,71,21,Spring2019
3566,SE Tualatin Valley Hwy & SW 234th,5652,E,NS,100,107,207,44,Spring2019
3567,SE Tualatin Valley Hwy & Century,5653,W,NS,98,92,190,40,Spring2019
3568,SE Tualatin Valley Hwy & Imlay,5654,W,NS,11,10,21,4,Spring2019
3569,SE Tualatin Valley Hwy & Imlay,5655,E,OP,6,7,13,0,Spring2019
3570,SE Tacoma & 13th,5664,E,FS,4,45,49,1,Spring2019
3571,SE Tacoma & 13th,5665,W,FS,46,6,52,0,Spring2019
3572,SE Tacoma & 17th,5668,E,FS,5,24,29,0,Spring2019
3573,SE Tacoma & 17th,5669,W,FS,29,4,33,1,Spring2019
3574,SE Tacoma & 7th,5675,W,NS,22,2,24,1,Spring2019
3575,SE Tacoma & 7th,5676,E,FS,4,24,28,1,Spring2019
3576,SW Talbot & Patton,5679,E,FS,2,1,3,0,Spring2019
3577,SW Talbot & Patton,5680,W,NS,6,0,6,0,Spring2019
3578,SW Talbot Terrace & Greenway,5681,E,NS,0,0,0,0,Spring2019
3579,SW Talbot & Talbot Terrace,5682,N,FS,1,0,1,0,Spring2019
3580,SW Taylors Ferry & Dolph,5687,S,FS,0,1,1,0,Spring2019
3581,SW Taylors Ferry & Marigold,5688,N,FS,1,0,1,0,Spring2019
3582,SW Taylors Ferry & Marigold,5689,S,NS,0,0,0,0,Spring2019
3583,1400 Block SW Taylors Ferry,5690,E,AT,1,0,1,0,Spring2019
3584,2200 Block SW Taylors Ferry,5691,E,AT,2,0,2,0,Spring2019
3585,2200 Block SW Taylors Ferry,5692,W,AT,0,0,0,0,Spring2019
3586,7100 Block SW Taylors Ferry,5693,W,OP,0,0,0,0,Spring2019
3587,7100 Block SW Taylors Ferry,5694,E,AT,1,0,1,0,Spring2019
3588,SW Taylors Ferry & 78th Pl,5695,E,FS,1,0,1,0,Spring2019
3589,SW Taylors Ferry & 78th Pl,5696,W,NS,0,1,1,0,Spring2019
3590,SW Taylors Ferry & Capitol Hwy,5697,W,NS,15,2,17,1,Spring2019
3591,SW Taylors Ferry & Dolph,5699,N,OP,1,0,1,0,Spring2019
3592,SW Taylors Ferry & Fulton Park Blvd,5700,S,NS,0,0,0,0,Spring2019
3593,SW Taylors Ferry & Riverview,5703,E,OP,0,1,1,0,Spring2019
3594,SW Taylors Ferry & Riverview,5704,S,AT,0,0,0,0,Spring2019
3595,SW Taylors Ferry & Riverview (2nd),5705,W,AT,0,0,0,0,Spring2019
3596,SW Taylors Ferry & Terwilliger,5706,E,NS,10,7,17,1,Spring2019
3597,SW Taylors Ferry & 10th,5707,E,NS,3,1,4,0,Spring2019
3604,SW Taylors Ferry & 10th,5708,W,NS,1,2,3,0,Spring2019
3605,SW Taylors Ferry & 11th,5709,W,NS,9,3,12,0,Spring2019
3606,SW Taylors Ferry & 11th,5710,E,NS,1,0,1,0,Spring2019
3607,SW Taylors Ferry & Taylors Ferry Ct,5711,W,OP,0,1,1,0,Spring2019
3608,SW Taylors Ferry & Taylors Ferry Ct,5712,E,FS,1,0,1,0,Spring2019
3609,SW Taylors Ferry & 17th,5713,W,FS,0,2,2,0,Spring2019
3610,SW Taylors Ferry & 17th,5714,E,OP,1,0,1,0,Spring2019
3611,SW Taylors Ferry & 19th,5715,W,FS,0,0,0,0,Spring2019
3612,SW Taylors Ferry & 19th,5716,E,OP,1,0,1,0,Spring2019
3613,SW Taylors Ferry & 2nd,5717,E,OP,1,0,1,0,Spring2019
3614,SW Taylors Ferry & 2nd,5718,W,NS,0,2,2,0,Spring2019
3615,SW Taylors Ferry & 23rd Dr,5719,S,FS,0,2,2,0,Spring2019
3616,SW Taylors Ferry & 26th,5720,W,NS,1,2,3,0,Spring2019
3617,SW Taylors Ferry & 26th,5721,E,FS,1,1,2,0,Spring2019
3618,SW Taylors Ferry & 28th,5722,W,FS,0,0,0,0,Spring2019
3619,SW Taylors Ferry & 28th,5723,E,OP,0,0,0,0,Spring2019
3620,SW Taylors Ferry & 30th,5724,W,FS,0,1,1,0,Spring2019
3621,SW Taylors Ferry & 30th,5725,E,OP,1,0,1,0,Spring2019
3622,SW Taylors Ferry & 46th,5726,W,FS,1,1,2,0,Spring2019
3623,SW Taylors Ferry & 46th,5727,E,OP,0,0,0,0,Spring2019
3624,SW Taylors Ferry & 48th,5728,W,NS,0,0,0,0,Spring2019
3625,SW Taylors Ferry & 48th,5729,E,NS,1,1,2,0,Spring2019
3626,SW Taylors Ferry & 49th,5730,W,NS,2,2,4,0,Spring2019
3627,SW Taylors Ferry & 52nd,5732,W,FS,0,2,2,1,Spring2019
3628,SW Taylors Ferry & 52nd,5733,E,FS,1,0,1,0,Spring2019
3629,SW Taylors Ferry & 53rd,5734,W,FS,0,1,1,0,Spring2019
3630,SW Taylors Ferry & 53rd,5735,E,FS,1,0,1,0,Spring2019
3631,SW Taylors Ferry & 55th,5736,W,NS,0,3,3,0,Spring2019
3632,SW Taylors Ferry & 55th,5737,E,FS,3,1,4,0,Spring2019
3633,SW Taylors Ferry & 57th,5738,W,OP,0,1,1,0,Spring2019
3634,SW Taylors Ferry & 57th,5739,E,NS,1,0,1,0,Spring2019
3635,SW Taylors Ferry & 60th,5740,W,OP,0,2,2,0,Spring2019
3636,SW Taylors Ferry & 60th,5741,E,NS,3,0,3,0,Spring2019
3637,SW Taylors Ferry & 62nd,5742,E,FS,5,0,5,0,Spring2019
3638,SW Taylors Ferry & 62nd,5743,W,NS,0,7,7,0,Spring2019
3639,SW Taylors Ferry & 65th,5745,E,FS,0,0,0,0,Spring2019
3640,SW Taylors Ferry & 66th,5746,E,FS,0,0,0,0,Spring2019
3641,SW Taylors Ferry & 69th,5747,W,OP,1,2,3,0,Spring2019
3642,SW Taylors Ferry & 69th,5748,E,FS,2,1,3,1,Spring2019
3643,SW Taylors Ferry & 7th,5749,W,NS,13,15,28,0,Spring2019
3644,SW Taylors Ferry & 74th,5752,E,FS,1,0,1,0,Spring2019
3645,SW Taylors Ferry & 80th,5754,W,NS,0,2,2,0,Spring2019
3646,SW Terwilliger & Maplecrest ,5779,E,NS,1,9,10,0,Spring2019
3647,SW Terwilliger & Alice ,5780,S,FS,0,3,3,0,Spring2019
3648,SW Terwilliger & Alice ,5781,N,OP,3,0,3,0,Spring2019
3649,SW Terwilliger & Bancroft ,5782,S,AT,0,0,0,0,Spring2019
3650,SW Terwilliger & Bancroft Terrace,5783,W,FS,0,0,0,0,Spring2019
3657,SW Terwilliger & Burlingame Terr,5785,S,FS,0,1,1,0,Spring2019
3658,SW Terwilliger & Caldew,5786,N,OP,8,0,8,0,Spring2019
3659,SW Terwilliger & Caldew,5787,S,FS,0,7,7,0,Spring2019
3660,SW Terwilliger & Capitol Hwy,5788,N,NS,7,0,7,0,Spring2019
3661,SW Terwilliger & Capitol Hwy,5789,S,NS,0,2,2,0,Spring2019
3662,SW Terwilliger & Carson,5790,N,NS,5,5,10,0,Spring2019
3663,SW Terwilliger & Chestnut,5791,N,NS,10,0,10,0,Spring2019
3664,SW Terwilliger & Chestnut,5792,S,FS,0,9,9,0,Spring2019
3665,9800 Block SW Terwilliger,5794,S,AT,0,5,5,0,Spring2019
3666,SW Terwilliger & Hamilton,5795,E,FS,0,0,0,0,Spring2019
3667,SW Terwilliger & Hamilton Terrace,5796,N,FS,1,0,1,0,Spring2019
3668,SW Terwilliger & L&C Law School,5797,W,OP,4,0,4,0,Spring2019
3669,SW Terwilliger & Lobelia,5798,N,NS,4,0,4,0,Spring2019
3670,SW Terwilliger & Lobelia,5799,S,NS,0,3,3,0,Spring2019
3671,SW Terwilliger & Nebraska,5800,N,FS,0,0,0,0,Spring2019
3672,SW Terwilliger & Primrose,5801,N,NS,9,0,9,1,Spring2019
3673,SW Terwilliger & Primrose,5802,S,FS,0,9,9,1,Spring2019
3674,SW Terwilliger & Ralston Dr,5803,N,NS,1,0,1,0,Spring2019
3675,SW Terwilliger & Sam Jackson,5804,S,FS,27,7,34,2,Spring2019
3676,SW Terwilliger & Taylors Ferry,5806,N,NS,6,2,8,0,Spring2019
3677,SW Terwilliger & Taylors Ferry,5807,S,FS,2,7,9,0,Spring2019
3678,SW Terwilliger & 6th,5808,S,NS,0,4,4,0,Spring2019
3679,SW Terwilliger & Troy,5809,N,FS,2,0,2,0,Spring2019
3680,SW Terwilliger & Westwood,5811,N,OP,1,0,1,0,Spring2019
3681,SW Terwilliger & Westwood,5812,S,FS,0,0,0,0,Spring2019
3682,SW Terwilliger & 2nd,5813,W,FS,17,3,20,0,Spring2019
3683,SW Terwilliger & 6th,5814,N,OP,4,1,5,0,Spring2019
3684,SW Terwilliger & Carson,5816,S,OP,0,4,4,0,Spring2019
3685,NW Thurman & Gordon,5824,W,NS,9,12,21,1,Spring2019
3686,NW Thurman & 26th,5831,W,NS,1,48,49,10,Spring2019
3687,NW Thurman & 26th,5832,E,FS,46,0,46,4,Spring2019
3688,NW Thurman & 27th,5835,W,FS,1,52,53,3,Spring2019
3689,NW Thurman & 27th,5836,E,FS,59,30,89,4,Spring2019
3690,NW Thurman & 28th,5837,W,FS,12,33,45,1,Spring2019
3691,NW Thurman & 29th,5839,W,OP,1,6,7,0,Spring2019
3692,NW Thurman & 29th,5840,E,NS,8,0,8,0,Spring2019
3693,NW Thurman & 32nd,5841,W,NS,2,8,10,0,Spring2019
3694,NW Thurman & 32nd,5842,E,NS,8,0,8,0,Spring2019
3695,NW Thurman & 34th,5843,W,OP,2,5,7,0,Spring2019
3696,NW Thurman & 34th,5844,E,NS,6,0,6,0,Spring2019
3697,Tigard Transit Center,5846,S,AT,476,357,833,85,Spring2019
3698,SW Towle & 10th Dr,5851,N,FS,1,0,1,0,Spring2019
3699,SW Towle & 10th Ct,5852,S,NS,0,1,1,0,Spring2019
3700,SW Towle & 14th,5853,N,FS,0,0,0,0,Spring2019
3701,SW Towle & 14th,5854,S,OP,0,0,0,0,Spring2019
3702,SW Towle & 19th Dr,5855,S,OP,0,2,2,0,Spring2019
3703,N Trenton & Alaska,5862,W,FS,32,45,77,24,Spring2019
3710,2800 Block S Troutdale,5864,N,OP,0,0,0,0,Spring2019
3711,3000 Block S Troutdale,5865,S,AT,0,0,0,0,Spring2019
3712,S Troutdale & SE Beavercreek,5867,N,FS,0,1,1,0,Spring2019
3713,S Troutdale & SE Beavercreek,5868,S,FS,1,0,1,0,Spring2019
3714,S Troutdale & SE Chapman,5869,N,NS,1,2,3,0,Spring2019
3715,S Troutdale Rd & SW Chapman,5870,S,NS,3,0,3,0,Spring2019
3716,S Troutdale Rd & SE Stark,5871,N,FS,2,4,6,0,Spring2019
3717,S Troutdale & SE Stark,5872,S,NS,6,1,7,0,Spring2019
3718,S Troutdale & SE 19th,5874,N,FS,0,1,1,0,Spring2019
3719,S Troutdale & SE 19th,5875,S,OP,1,0,1,0,Spring2019
3720,S Troutdale & SE 21st,5876,N,FS,0,1,1,0,Spring2019
3721,S Troutdale & SW 21st,5877,S,FS,3,0,3,0,Spring2019
3722,SW Troy & 35th,5878,W,FS,34,103,137,13,Spring2019
3723,SE Umatilla & 16th,5884,E,NS,1,8,9,0,Spring2019
3724,NE M L King & Ainsworth,5886,N,NS,58,108,166,70,Spring2019
3725,NE M L King & Ainsworth,5887,S,NS,89,39,128,53,Spring2019
3726,NE M L King & Alberta,5889,S,FS,193,40,233,35,Spring2019
3727,NE M L King & Alberta,5890,N,FS,143,392,535,94,Spring2019
3728,SE M L King & Ash,5892,S,NS,11,30,41,2,Spring2019
3729,NE M L King & Beech,5893,S,NS,81,36,117,19,Spring2019
3730,NE M L King & Beech,5894,N,NS,37,69,106,21,Spring2019
3731,NE M L King & Brazee,5896,N,NS,23,73,96,15,Spring2019
3732,NE M L King & Broadway,5897,S,NS,31,89,120,62,Spring2019
3733,NE M L King & Bryant,5899,N,NS,78,85,163,50,Spring2019
3734,NE M L King & Bryant,5900,S,NS,34,18,52,5,Spring2019
3735,NE M L King & E Burnside,5901,S,NS,80,226,306,67,Spring2019
3736,NE M L King & Dekum,5903,N,NS,13,76,89,22,Spring2019
3737,NE M L King & Dekum,5904,S,NS,74,16,90,14,Spring2019
3738,NE M L King & Failing,5906,N,FS,28,78,106,39,Spring2019
3739,NE M L King & Failing,5907,S,NS,90,28,118,22,Spring2019
3740,NE M L King & Fargo,5908,S,FS,48,22,70,24,Spring2019
3741,NE M L King & Fargo,5909,N,NS,11,35,46,8,Spring2019
3742,NE M L King & Fremont,5910,N,NS,43,102,145,26,Spring2019
3743,NE M L King & Fremont,5911,S,NS,73,48,121,24,Spring2019
3744,NE M L King & Hoyt,5912,S,NS,59,20,79,7,Spring2019
3745,NE M L King & Hancock,5914,S,NS,13,9,22,6,Spring2019
3746,NE M L King & Holladay,5917,S,NS,99,463,562,101,Spring2019
3747,NE M L King & Holland,5918,N,NS,13,38,51,5,Spring2019
3748,NE M L King & Holland,5919,S,NS,154,90,244,77,Spring2019
3749,NE M L King & Holman,5920,N,FS,3,14,17,2,Spring2019
3750,NE M L King & Jarrett,5923,S,NS,71,23,94,24,Spring2019
3751,NE M L King & Jarrett,5924,N,NS,15,57,72,18,Spring2019
3752,NE M L King & Killingsworth,5927,S,FS,399,330,729,226,Spring2019
3753,NE M L King & Killingsworth,5929,N,NS,84,187,271,92,Spring2019
3754,NE M L King & Knott,5930,N,NS,37,91,128,18,Spring2019
3755,NE M L King & Knott,5931,S,NS,91,40,131,22,Spring2019
3756,NE M L King & Lombard St,5932,N,NS,63,66,129,26,Spring2019
3763,SE M L King & Mill,5933,S,FS,0,0,0,0,Spring2019
3764,NE M L King & Mason,5934,S,FS,82,32,114,80,Spring2019
3765,NE M L King & Mason,5935,N,NS,35,78,113,61,Spring2019
3766,NE M L King & Morgan,5937,N,NS,8,19,27,3,Spring2019
3767,NE M L King & Morris,5938,S,FS,67,25,92,11,Spring2019
3768,NE M L King & Morris,5939,N,FS,36,83,119,17,Spring2019
3769,NE M L King & Rosa Parks Way,5943,S,NS,38,7,45,4,Spring2019
3770,NE M L King & Rosa Parks Way,5944,N,NS,5,25,30,6,Spring2019
3771,NE M L King & Prescott,5946,N,NS,19,43,62,5,Spring2019
3772,NE M L King & Prescott,5947,S,OP,63,20,83,9,Spring2019
3773,NE M L King & Russet,5950,S,FS,41,57,98,26,Spring2019
3774,NE M L King & Sacramento,5951,S,OP,69,23,92,8,Spring2019
3775,NE M L King & Tillamook,5955,S,NS,23,15,38,3,Spring2019
3776,NE M L King & Tillamook,5956,N,NS,23,35,58,6,Spring2019
3777,NE M L King & Wasco,5958,S,NS,24,90,114,23,Spring2019
3778,NE M L King & Weidler,5960,S,FS,47,78,125,34,Spring2019
3779,NE M L King & Wygant,5961,S,FS,26,11,37,2,Spring2019
3780,NE M L King & Wygant,5962,N,NS,13,52,65,9,Spring2019
3781,15800 Block SW 72nd,5973,S,AT,1,2,3,0,Spring2019
3782,US Veterans Hospital,5975,S,AT,471,680,1151,494,Spring2019
3783,N Vancouver & Ainsworth,5976,N,NS,5,12,17,1,Spring2019
3784,N Vancouver & Ainsworth,5977,S,NS,13,3,16,0,Spring2019
3785,N Vancouver & Alberta,5978,S,NS,82,20,102,13,Spring2019
3786,N Vancouver & Beech,5979,S,NS,20,9,29,3,Spring2019
3787,N Vancouver & Fargo,5984,S,OP,64,22,86,43,Spring2019
3788,N Vancouver & Holman,5991,N,NS,2,14,16,1,Spring2019
3789,N Vancouver & Holman,5992,S,NS,11,2,13,0,Spring2019
3790,N Vancouver & Jessup,5995,S,NS,13,3,16,0,Spring2019
3791,N Vancouver & Killingsworth,5996,S,FS,63,43,106,23,Spring2019
3792,N Vancouver & Knott,5997,S,NS,114,61,175,73,Spring2019
3793,N Vancouver & Ivy,6000,S,NS,195,107,302,30,Spring2019
3794,N Vancouver & Page,6001,S,NS,23,18,41,3,Spring2019
3795,N Vancouver & Russell,6003,S,FS,16,11,27,19,Spring2019
3796,N Vancouver & Shaver,6004,S,NS,34,10,44,4,Spring2019
3797,N Vancouver & Skidmore,6005,S,NS,71,9,80,1,Spring2019
3798,N Vancouver & Stanton,6006,S,NS,171,104,275,125,Spring2019
3799,N Vancouver & Tillamook,6008,S,NS,17,7,24,3,Spring2019
3800,N Vancouver & Weidler,6009,S,NS,23,95,118,37,Spring2019
3801,N Vancouver & Wygant,6010,S,NS,24,2,26,0,Spring2019
3802,NW Vaughn & 24th,6013,E,NS,47,3,50,7,Spring2019
3803,NW Vaughn & 24th,6014,W,NS,3,43,46,7,Spring2019
3804,1900 Block SW Vermont,6017,E,AT,4,0,4,0,Spring2019
3805,2200 Block SW Vermont,6018,W,AT,0,3,3,0,Spring2019
3806,5700 Block SW Vermont,6019,W,OP,1,1,2,0,Spring2019
3807,SW Vermont & Bertha,6022,E,NS,11,1,12,0,Spring2019
3808,SW Capitol & Vermont,6023,E,FS,25,8,33,3,Spring2019
3809,SW Vermont & Bertha,6024,W,FS,1,6,7,0,Spring2019
3816,SW Vermont & Chestnut,6025,E,NS,5,48,53,0,Spring2019
3817,SW Vermont & Chestnut,6026,W,OP,34,9,43,0,Spring2019
3818,SW Vermont & Idaho,6027,E,OP,0,0,0,0,Spring2019
3819,SW Vermont & Idaho,6028,W,NS,0,3,3,0,Spring2019
3820,SW Vermont & Idaho Dr,6029,W,FS,12,31,43,1,Spring2019
3821,SW Vermont & Shattuck,6030,W,NS,3,3,6,0,Spring2019
3822,SW Vermont & Capitol Hwy,6031,E,FS,1,0,1,0,Spring2019
3823,SW Vermont & 13th,6032,W,OP,2,1,3,0,Spring2019
3824,SW Vermont & 13th,6033,E,FS,1,2,3,0,Spring2019
3825,SW Vermont & 24th,6034,W,FS,0,1,1,0,Spring2019
3826,SW Vermont & 30th,6035,W,NS,1,9,10,0,Spring2019
3827,SW Vermont & 30th,6036,E,NS,10,2,12,1,Spring2019
3828,SW Vermont & 32nd,6037,W,FS,1,4,5,0,Spring2019
3829,SW Vermont & 37th,6041,W,NS,1,7,8,0,Spring2019
3830,SW Vermont & 37th,6042,E,NS,5,0,5,0,Spring2019
3831,SW Vermont & 42nd,6043,W,FS,0,2,2,0,Spring2019
3832,SW Vermont & 45th,6045,E,FS,23,1,24,1,Spring2019
3833,SW Vermont & 50th,6047,W,NS,0,10,10,0,Spring2019
3834,SW Vermont & 52nd,6048,E,NS,0,0,0,0,Spring2019
3835,SW Vermont & 52nd,6049,W,NS,0,6,6,0,Spring2019
3836,SW Vermont & 55th,6050,W,OP,0,6,6,0,Spring2019
3837,SW Vermont & 60th,6051,W,OP,10,9,19,0,Spring2019
3838,SW Vermont & 63rd,6052,W,OP,0,2,2,0,Spring2019
3839,SW Virginia & California,6053,S,NS,0,2,2,0,Spring2019
3840,SW Virginia & Nebraska,6057,N,NS,4,3,7,0,Spring2019
3841,SW Virginia & Nevada,6059,N,NS,2,2,4,0,Spring2019
3842,SW Virginia & Taylors Ferry,6060,S,NS,2,2,4,0,Spring2019
3843,SW Virginia & Taylors Ferry,6061,N,FS,2,1,3,0,Spring2019
3844,SW Virginia & Vermont,6062,S,NS,1,2,3,0,Spring2019
3845,SW Virginia & Vermont,6063,N,NS,2,1,3,0,Spring2019
3846,SW Vista & Broadway,6068,S,NS,0,18,18,0,Spring2019
3847,SW Vista & Elm St,6074,S,NS,1,12,13,0,Spring2019
3848,SW Vista & Elm St,6075,N,NS,2,0,2,0,Spring2019
3849,SW Vista & Isabella,6077,S,NS,0,2,2,0,Spring2019
3850,SW Vista & Jackson,6078,S,FS,0,6,6,0,Spring2019
3851,SW Vista & Jackson,6079,N,FS,5,0,5,0,Spring2019
3852,SW Vista & Madison,6082,S,NS,0,0,0,0,Spring2019
3853,SW Vista & Main,6083,N,NS,13,2,15,0,Spring2019
3854,SW Vista & Market Street,6084,N,FS,0,0,0,0,Spring2019
3855,SW Vista & Market Street,6085,S,NS,1,1,2,0,Spring2019
3856,SW Vista & Montgomery,6086,S,FS,0,1,1,0,Spring2019
3857,SW Vista & Montgomery,6087,N,NS,1,0,1,0,Spring2019
3858,SW Vista & Myrtle,6088,S,NS,0,4,4,0,Spring2019
3859,SW Vista & Myrtle,6089,N,NS,2,0,2,0,Spring2019
3860,SW Vista & Park Pl,6090,S,FS,2,18,20,0,Spring2019
3861,SW Walnut & Brookside,6103,W,NS,3,1,4,0,Spring2019
3862,SW Walnut & Grant,6104,E,FS,2,10,12,0,Spring2019
3869,SW Walnut & Tiedeman,6105,W,FS,2,1,3,0,Spring2019
3870,SW Walnut & Watkins,6107,E,NS,1,2,3,0,Spring2019
3871,SW Walnut & 112th,6108,W,NS,0,1,1,0,Spring2019
3872,SW Walnut & 112th,6109,E,NS,1,0,1,0,Spring2019
3873,SW Walnut & 116th,6111,E,FS,2,1,3,0,Spring2019
3874,SW Walnut & 121st,6112,W,NS,6,4,10,0,Spring2019
3875,100 Block Warner - Milne,6113,E,AT,1,14,15,1,Spring2019
3876,200 Block Warner - Milne,6114,W,OP,6,1,7,0,Spring2019
3877,300 Block Beavercreek Rd,6115,W,AT,21,2,23,2,Spring2019
3878,Beavercreek & Library Ct,6117,S,FS,8,41,49,10,Spring2019
3879,Warner - Milne & Beavercreek,6118,E,NS,1,15,16,4,Spring2019
3880,Warner - Milne & Linn,6120,E,FS,8,12,20,1,Spring2019
3881,Warner - Milne & Linn,6121,W,NS,11,8,19,2,Spring2019
3882,Beavercreek & Red Soils Ct,6122,E,NS,2,19,21,2,Spring2019
3883,SW Eliander & One Embassy Centre,6125,S,AT,21,78,99,7,Spring2019
3884,9000 Block SW Washington Square Rd,6126,N,AT,14,2,16,0,Spring2019
3885,9000 Block SW Washington Square Rd,6133,S,OP,1,23,24,0,Spring2019
3886,SE Washington & Oak,6140,E,NS,2,0,2,0,Spring2019
3887,SE Washington & Oak,6141,N,FS,1,2,3,0,Spring2019
3888,SE Washington & 105th,6143,E,OP,194,78,272,67,Spring2019
3889,SE Washington & 108th,6144,E,NS,34,23,57,21,Spring2019
3890,SE Washington & 23rd,6151,W,FS,1,15,16,0,Spring2019
3891,SE Washington & 25th,6152,E,OP,2,0,2,0,Spring2019
3892,SE Washington & 25th,6153,W,NS,0,2,2,0,Spring2019
3893,SE Washington & 29th,6156,E,OP,1,0,1,0,Spring2019
3894,SE Washington & 29th,6157,W,NS,0,0,0,0,Spring2019
3895,SW Washington & 3rd,6158,W,NS,66,391,457,31,Spring2019
3896,SE Washington & 34th,6159,E,NS,0,0,0,0,Spring2019
3897,SW Washington & 5th,6160,W,NS,327,672,999,123,Spring2019
3898,SE Washington & 80th,6165,E,FS,10,60,70,7,Spring2019
3899,SE Washington & 82nd,6166,E,FS,67,79,146,51,Spring2019
3900,SE Washington & 86th,6167,E,NS,3,13,16,2,Spring2019
3901,SE Washington & 88th,6168,E,NS,3,15,18,0,Spring2019
3902,SW Washington & 9th,6169,W,FS,49,197,246,25,Spring2019
3903,SE Washington & 90th,6170,E,NS,3,14,17,0,Spring2019
3904,SE Washington & 92nd,6171,E,FS,12,24,36,9,Spring2019
3905,SE Washington & 94th,6173,E,NS,4,4,8,1,Spring2019
3906,SW Eliander & One Embassy Centre,6175,N,OP,66,31,97,7,Spring2019
3907,SW Watson & 1st,6178,S,FS,70,17,87,15,Spring2019
3908,SW Watson & 10th,6179,S,FS,11,19,30,23,Spring2019
3909,SW Watson & 9th,6182,S,NS,4,7,11,2,Spring2019
3910,SE Webster & Bixel,6187,N,OP,3,2,5,1,Spring2019
3911,SE Webster & Cavalier Way,6189,S,NS,0,0,0,0,Spring2019
3912,Webster & Charolais,6190,N,NS,11,8,19,2,Spring2019
3913,SE Webster & Clackamas,6191,N,FS,2,0,2,0,Spring2019
3914,SE Webster & Clackamas,6192,S,FS,1,5,6,0,Spring2019
3915,SE Webster & Lake,6193,S,FS,2,4,6,1,Spring2019
3922,Webster & Clayton,6194,S,NS,2,2,4,1,Spring2019
3923,SE Webster & Cypress,6195,N,NS,2,2,4,0,Spring2019
3924,18000 Block Webster,6196,N,AT,1,2,3,0,Spring2019
3925,17700 Block Webster,6197,N,AT,3,4,7,0,Spring2019
3926,Webster & Kraxberger Middle School,6198,S,AT,1,3,4,0,Spring2019
3927,SE Webster & Lake,6199,N,NS,4,3,7,1,Spring2019
3928,Webster & Los Verdes,6201,S,FS,15,10,25,2,Spring2019
3929,SE Webster & Mabel,6203,S,NS,2,2,4,0,Spring2019
3930,SE Webster & Molt St,6205,S,FS,3,3,6,0,Spring2019
3931,Webster & Oatfield,6206,S,NS,2,5,7,0,Spring2019
3932,SE Webster & Pine Creek,6207,N,OP,0,1,1,1,Spring2019
3933,Webster & Kirkwood,6208,N,NS,3,3,6,1,Spring2019
3934,SE Webster & Savanna,6209,N,FS,0,0,0,0,Spring2019
3935,SE Webster & Strawberry,6210,N,NS,4,4,8,1,Spring2019
3936,SE Webster & Thiessen,6211,N,NS,14,10,24,10,Spring2019
3937,SE Webster & Thiessen,6212,S,FS,9,9,18,4,Spring2019
3938,SE Webster & Tuscany Ct,6213,S,NS,1,0,1,0,Spring2019
3939,SE Webster & Wilshire,6215,S,OP,0,0,0,0,Spring2019
3940,NE Weidler & Lloyd Center,6216,E,AT,177,178,355,257,Spring2019
3941,NE Weidler & M L King,6218,E,FS,25,32,57,33,Spring2019
3942,N Weidler & Williams,6220,E,NS,25,23,48,24,Spring2019
3943,NE Weidler & 106th,6223,W,NS,6,6,12,7,Spring2019
3944,NE Weidler & 111th,6225,W,FS,55,24,79,53,Spring2019
3945,NE Weidler & 17th,6227,E,NS,36,45,81,16,Spring2019
3946,NE Weidler & 2nd,6232,E,NS,7,20,27,40,Spring2019
3947,NE Weidler & 21st,6235,E,NS,35,100,135,49,Spring2019
3948,NE Weidler & 22nd,6237,E,NS,17,42,59,5,Spring2019
3949,NE Weidler & 24th,6239,E,NS,9,23,32,6,Spring2019
3950,NE Weidler & 7th,6240,E,NS,19,31,50,27,Spring2019
3951,NE Weidler & 9th,6242,E,NS,11,33,44,24,Spring2019
3952,N Whitaker & Hayden Meadows,6256,N,FS,6,15,21,8,Spring2019
3953,N Willamette & Alma,6258,W,NS,2,34,36,1,Spring2019
3954,N Willamette & Ida,6259,E,NS,24,2,26,1,Spring2019
3955,N Willamette & Bryant,6260,N,NS,2,13,15,0,Spring2019
3956,N Willamette & Edgewater,6262,E,FS,14,1,15,0,Spring2019
3957,N Willamette & Burr,6263,W,FS,1,11,12,0,Spring2019
3958,N Willamette & Carey,6264,N,NS,1,4,5,1,Spring2019
3959,N Willamette & Carey,6265,E,FS,3,1,4,0,Spring2019
3960,N Willamette & Chautauqua,6266,E,OP,6,1,7,0,Spring2019
3961,N Willamette & Harvard,6269,W,NS,3,18,21,0,Spring2019
3962,N Willamette & Harvard,6270,E,OP,12,5,17,0,Spring2019
3963,N Willamette & Haven,6271,W,NS,8,35,43,0,Spring2019
3964,N Willamette & Hurst,6273,W,NS,0,6,6,1,Spring2019
3965,N Willamette & Macrum,6274,E,OP,7,0,7,1,Spring2019
3966,N Willamette & Macrum,6275,W,NS,1,10,11,1,Spring2019
3967,N Willamette & Menlo,6277,W,NS,2,14,16,0,Spring2019
3968,N Willamette & Menlo,6278,E,OP,6,0,6,0,Spring2019
3975,N Willamette & Mohawk,6279,E,OP,10,0,10,6,Spring2019
3976,N Willamette & Monteith,6280,W,FS,3,10,13,0,Spring2019
3977,N Willamette & Oswego,6282,W,NS,0,15,15,4,Spring2019
3978,N Willamette & Edgewater,6283,W,OP,1,12,13,0,Spring2019
3979,N Willamette & Portsmouth,6284,W,NS,9,19,28,1,Spring2019
3980,N Willamette & Portsmouth,6285,E,FS,13,9,22,1,Spring2019
3981,N Willamette & Saratoga,6286,S,OP,6,2,8,0,Spring2019
3982,N Willamette & Tyler,6288,W,FS,0,11,11,1,Spring2019
3983,N Willamette & Tyler,6289,E,FS,10,1,11,2,Spring2019
3984,N Willamette & University of Portland,6290,E,AT,36,9,45,0,Spring2019
3985,N Willamette & Van Houten,6291,E,NS,14,4,18,0,Spring2019
3986,N Willamette & Wall,6292,W,NS,3,12,15,1,Spring2019
3987,N Willamette & Wall,6293,E,NS,16,2,18,0,Spring2019
3988,N Willamette & Washburne,6294,W,NS,0,8,8,0,Spring2019
3989,N Willamette & Washburne,6295,E,OP,6,0,6,0,Spring2019
3990,N Willamette & Woolsey,6298,W,NS,1,13,14,0,Spring2019
3991,N Willamette & Woolsey,6299,E,OP,7,1,8,0,Spring2019
3992,Willamette Dr & Mapleton Dr,6300,S,FS,3,3,6,0,Spring2019
3993,Willamette Dr & Arbor,6301,N,NS,6,1,7,0,Spring2019
3994,Willamette Dr & Arbor,6302,S,NS,1,6,7,0,Spring2019
3995,Willamette Dr & Barlow,6303,W,OP,1,1,2,0,Spring2019
3996,Willamette Dr & Barlow,6304,E,NS,1,4,5,2,Spring2019
3997,Willamette Dr & Burns,6306,W,NS,19,5,24,0,Spring2019
3998,Willamette Dr & Cedar Oak,6309,N,FS,63,13,76,2,Spring2019
3999,Pacific Hwy & Cherry,6310,N,OP,3,0,3,0,Spring2019
4000,Pacific Hwy (Hwy 43) & Cherry,6311,S,FS,0,3,3,0,Spring2019
4001,Willamette Dr & Elliott,6312,W,FS,13,3,16,0,Spring2019
4002,Willamette Dr & West A,6314,E,NS,3,11,14,0,Spring2019
4003,Pacific Hwy & Glenmorrie,6317,N,FS,1,0,1,0,Spring2019
4004,Pacific Hwy & Glenmorrie,6318,S,FS,0,1,1,0,Spring2019
4005,Willamette Dr & Hidden Springs,6319,S,NS,10,63,73,3,Spring2019
4006,Willamette Dr & Holly,6320,N,NS,11,4,15,0,Spring2019
4007,Willamette Dr & Holmes,6321,N,NS,5,1,6,0,Spring2019
4008,Willamette Dr & Holmes,6322,S,OP,1,5,6,0,Spring2019
4009,Willamette Dr & Hughes,6323,N,NS,5,1,6,0,Spring2019
4010,Willamette Dr & Hughes,6324,S,OP,1,4,5,0,Spring2019
4011,Willamette Dr & Jolie Pointe,6325,N,NS,4,2,6,0,Spring2019
4012,Willamette Dr & Jolie Pointe,6326,S,OP,2,4,6,0,Spring2019
4013,Pacific Hwy & Laurel,6327,N,OP,8,0,8,0,Spring2019
4014,Pacific Hwy & Burnham,6328,S,OP,0,7,7,0,Spring2019
4015,Willamette Dr & Mapleton,6331,N,NS,8,4,12,0,Spring2019
4016,Willamette Dr & Mark Ln,6332,N,NS,5,3,8,0,Spring2019
4017,Willamette Dr & Linnwood,6333,S,NS,4,7,11,0,Spring2019
4018,Pacific Hwy & Furman,6334,N,FS,3,2,5,1,Spring2019
4019,Pacific Hwy & Holy Names Drive,6335,N,FS,9,5,14,1,Spring2019
4020,Pacific Hwy & Brookhurst Dr,6336,S,FS,5,11,16,4,Spring2019
4021,Willamette Dr & Marylhurst Dr,6337,S,FS,4,12,16,1,Spring2019
4028,Pacific Hwy & Marylbrook Dr,6338,S,FS,1,1,2,0,Spring2019
4029,Willamette Dr & McKillican,6339,S,NS,5,21,26,1,Spring2019
4030,Willamette Dr & Pimlico,6344,N,OP,11,1,12,0,Spring2019
4031,Willamette Dr & Pimlico,6345,S,NS,1,6,7,0,Spring2019
4032,Willamette Dr & Shady Hollow,6346,N,NS,3,1,4,0,Spring2019
4033,Willamette Dr & Shady Hollow,6347,S,OP,1,2,3,0,Spring2019
4034,Willamette Dr & Holly (near gas stn),6348,S,FS,1,2,3,0,Spring2019
4035,Willamette Dr & Walling Way,6349,N,FS,6,1,7,1,Spring2019
4036,Willamette Dr & Walling Circle,6350,S,NS,1,4,5,2,Spring2019
4037,Willamette Dr & Webb,6352,S,NS,0,2,2,0,Spring2019
4038,N Williams & NE Russell,6354,N,FS,67,125,192,113,Spring2019
4039,N Williams & NE Alberta,6355,N,NS,9,65,74,13,Spring2019
4040,N Williams & NE Broadway,6357,N,FS,44,27,71,14,Spring2019
4041,N Williams & NE Cook,6359,N,FS,41,200,241,22,Spring2019
4042,N Williams & NE Fremont,6360,N,FS,27,50,77,8,Spring2019
4043,N Williams & NE Graham,6362,N,NS,43,136,179,60,Spring2019
4044,N Williams & NE Morris,6364,N,NS,82,117,199,88,Spring2019
4045,N Williams & NE Shaver,6366,N,NS,11,52,63,4,Spring2019
4046,N Williams & NE Skidmore,6367,N,NS,13,59,72,3,Spring2019
4047,N Williams & NE Tillamook,6370,N,FS,22,64,86,2,Spring2019
4048,N Williams & NE Wygant,6371,N,NS,3,32,35,2,Spring2019
4049,N Willis & Bayard,6373,W,NS,12,39,51,0,Spring2019
4050,N Willis & Chautauqua,6374,E,NS,21,2,23,1,Spring2019
4051,N Willis & Druid,6375,W,FS,0,21,21,0,Spring2019
4052,N Willis & Druid,6376,E,NS,26,0,26,0,Spring2019
4053,N Willis & Emerald,6377,E,NS,49,12,61,3,Spring2019
4054,N Willis & Wabash,6378,W,OP,5,31,36,9,Spring2019
4055,N Willis & Hereford,6379,W,NS,0,18,18,2,Spring2019
4056,N Willis & Hodge,6380,E,FS,16,1,17,5,Spring2019
4057,N Willis & Newman,6381,E,NS,34,1,35,0,Spring2019
4058,N Willis & Newman,6382,W,FS,1,25,26,0,Spring2019
4059,N Willis & Peninsular,6383,E,NS,52,13,65,5,Spring2019
4060,N Willis & Peninsular,6384,W,FS,16,46,62,11,Spring2019
4061,N Willis & Portsmouth,6385,W,NS,0,33,33,1,Spring2019
4062,N Willis & Wabash,6386,E,NS,40,7,47,3,Spring2019
4063,N Willis & Washburne,6387,W,FS,3,18,21,1,Spring2019
4064,N Willis & Washburne,6388,E,NS,35,13,48,2,Spring2019
4065,N Willis & Wayland,6389,W,NS,1,20,21,1,Spring2019
4066,N Willis & Wayland,6390,E,NS,25,1,26,2,Spring2019
4067,N Willis & Woolsey,6391,W,NS,0,25,25,0,Spring2019
4068,N Willis & Woolsey,6392,E,NS,28,1,29,0,Spring2019
4069,SE Woodstock & 94th (I-205 West End),6398,E,FS,32,26,58,11,Spring2019
4070,SE Woodstock & Moreland Ln,6399,E,NS,5,9,14,1,Spring2019
4071,3000 Block SE Woodstock,6400,W,OP,6,3,9,1,Spring2019
4072,SE Woodstock & 32nd,6402,E,NS,4,6,10,0,Spring2019
4073,SE Woodstock & 32nd,6403,W,OP,22,11,33,8,Spring2019
4074,SE Woodstock & 34th,6405,E,NS,9,9,18,2,Spring2019
4081,SE Woodstock & 34th,6406,W,OP,5,5,10,0,Spring2019
4082,SE Woodstock & 36th,6407,E,NS,4,6,10,5,Spring2019
4083,3600 Block SE Woodstock,6408,W,OP,8,6,14,0,Spring2019
4084,SE Woodstock & Cesar Chavez Blvd,6409,W,NS,17,3,20,3,Spring2019
4085,SE Woodstock & 41st,6411,E,NS,8,68,76,37,Spring2019
4086,SE Woodstock & 41st,6412,W,NS,65,13,78,15,Spring2019
4087,SE Woodstock & 43rd,6413,E,NS,19,80,99,61,Spring2019
4088,SE Woodstock & 43rd,6414,W,NS,102,38,140,99,Spring2019
4089,SE Woodstock & 46th,6415,E,NS,152,202,354,202,Spring2019
4090,SE Woodstock & 46th,6416,W,NS,49,56,105,80,Spring2019
4091,SE Woodstock & 49th,6419,E,FS,17,25,42,26,Spring2019
4092,SE Woodstock & 49th,6420,W,NS,24,13,37,20,Spring2019
4093,SE Woodstock & 51st,6421,W,NS,51,6,57,7,Spring2019
4094,SE Woodstock & 92nd,6427,E,NS,42,109,151,28,Spring2019
4095,SE Yamhill & 69th,6442,W,NS,8,6,14,1,Spring2019
4096,SE Yamhill & 71st,6443,E,NS,2,19,21,0,Spring2019
4097,SE Yamhill & 71st,6444,W,NS,13,3,16,0,Spring2019
4098,SE Yamhill & 73rd,6445,E,NS,2,11,13,0,Spring2019
4099,SE Yamhill & 73rd,6446,W,FS,14,2,16,0,Spring2019
4100,SE Yamhill & 76th,6447,E,NS,4,43,47,5,Spring2019
4101,4200 Block NW Yeon,6458,W,AT,0,5,5,0,Spring2019
4102,4000 Block NW Yeon Frontage Rd,6460,E,AT,20,1,21,1,Spring2019
4103,3900 Block NW Yeon Frontage Rd,6463,E,AT,3,0,3,0,Spring2019
4104,3900 Block NW Yeon,6467,W,AT,0,17,17,0,Spring2019
4105,NW Yeon & 44th,6470,E,FS,79,53,132,8,Spring2019
4106,2200 Block SW 1st,6472,N,AT,3,14,17,0,Spring2019
4107,SW 1st & Madison Tower,6473,S,AT,1,0,1,0,Spring2019
4108,SW 1st & Arthur,6474,S,NS,6,1,7,0,Spring2019
4109,SW 1st & Arthur,6475,N,NS,0,6,6,0,Spring2019
4110,SW Washington & Adams,6477,E,NS,44,348,392,114,Spring2019
4111,SW 1st & Hooker,6480,S,NS,2,0,2,0,Spring2019
4112,SW 1st & Hooker,6481,N,NS,0,1,1,0,Spring2019
4113,SW 1st & Woods,6488,S,NS,1,0,1,0,Spring2019
4114,SW 1st & Woods,6489,N,FS,0,1,1,0,Spring2019
4115,SE 10th & Maple,6495,N,NS,73,71,144,31,Spring2019
4116,SE 10th & Maple,6496,S,FS,80,63,143,27,Spring2019
4117,SE Tualatin Valley Hwy & 11th,6498,S,FS,30,24,54,5,Spring2019
4118,SE 10th & Walnut,6499,N,NS,75,94,169,15,Spring2019
4119,SE 10th & Walnut,6500,S,NS,138,74,212,22,Spring2019
4120,SE 10th & Baseline,6502,N,NS,55,3,58,4,Spring2019
4121,100 Block NE 102nd,6503,S,AT,12,5,17,4,Spring2019
4122,NE 102nd & Davis,6504,N,NS,4,7,11,6,Spring2019
4123,NE 102nd & Alton,6505,S,NS,6,2,8,9,Spring2019
4124,NE 102nd & Beech,6506,N,FS,1,5,6,1,Spring2019
4125,NE 102nd & Bell,6507,S,FS,10,5,15,4,Spring2019
4126,NE 102nd & Brazee,6508,N,NS,3,8,11,5,Spring2019
4127,NE 102nd & Brazee,6509,S,FS,13,2,15,11,Spring2019
4134,SE 102nd & E Burnside,6510,N,NS,21,67,88,37,Spring2019
4135,SE 102nd & Burnside,6511,S,FS,261,147,408,140,Spring2019
4136,NE 102nd & Clackamas,6513,S,OP,7,21,28,13,Spring2019
4137,NE 102nd & Fremont,6514,N,NS,3,18,21,6,Spring2019
4138,NE 102nd & Fremont,6515,S,NS,16,4,20,1,Spring2019
4139,NE 102nd & Glisan,6516,N,NS,8,31,39,10,Spring2019
4140,NE 102nd & Glisan,6517,S,FS,29,12,41,12,Spring2019
4141,NE 102nd & Hancock,6518,N,NS,14,9,23,12,Spring2019
4142,NE 102nd & Knott,6519,S,OP,4,1,5,1,Spring2019
4143,102nd & Morris St,6520,S,FS,18,4,22,2,Spring2019
4144,NE 102nd & Morris Ct,6521,N,FS,4,17,21,1,Spring2019
4145,1200 Block NE 102nd,6522,N,OP,65,12,77,30,Spring2019
4146,1200 Block NE 102nd,6523,S,AT,9,41,50,25,Spring2019
4147,NE 102nd & Pacific,6525,S,NS,3,13,16,4,Spring2019
4148,SE 102nd & Pine,6526,S,FS,31,50,81,14,Spring2019
4149,NE 102nd & Shaver,6528,N,NS,2,9,11,5,Spring2019
4150,SE 102nd & Washington,6529,S,NS,28,40,68,34,Spring2019
4151,NE 102nd & Tillamook,6530,N,NS,4,8,12,11,Spring2019
4152,NE 102nd & Weidler,6531,N,NS,29,11,40,14,Spring2019
4153,NE 102nd & Weidler,6532,S,NS,5,17,22,7,Spring2019
4154,NW 107th & Copeland,6535,S,NS,0,0,0,0,Spring2019
4155,NW Cornell & 107th,6536,E,NS,2,0,2,1,Spring2019
4156,NW 107th & Cornell,6537,N,NS,0,1,1,0,Spring2019
4157,NW 107th & Walters,6539,N,NS,0,0,0,0,Spring2019
4158,SE 11th & Ash,6541,S,NS,20,19,39,8,Spring2019
4159,SE 11th & Belmont,6542,S,FS,83,78,161,37,Spring2019
4160,SE 11th & Clay,6543,S,NS,13,20,33,14,Spring2019
4161,SE 11th & Division,6545,S,NS,34,72,106,9,Spring2019
4162,SW 11th & Gibbs,6548,N,NS,67,135,202,31,Spring2019
4163,SE 11th & Madison,6551,S,FS,47,98,145,18,Spring2019
4164,SE 11th & Sherman,6553,S,NS,3,13,16,2,Spring2019
4165,SE 11th & Stark,6554,S,NS,37,37,74,40,Spring2019
4166,SE 11th & Stephens,6555,S,NS,5,20,25,2,Spring2019
4167,NE 111th & Knott,6557,N,NS,0,1,1,0,Spring2019
4168,NE 111th & Knott,6558,S,NS,2,1,3,1,Spring2019
4169,NE 111th & Morris,6559,N,NS,0,3,3,0,Spring2019
4170,NE 111th & Sacramento,6561,N,NS,0,3,3,1,Spring2019
4171,NE 111th & Sacramento,6562,S,NS,3,0,3,0,Spring2019
4172,NE 111th & San Rafael,6563,N,NS,0,4,4,1,Spring2019
4173,NE 111th & San Rafael,6564,S,OP,4,0,4,0,Spring2019
4174,NE 111th & Weidler,6565,N,NS,3,4,7,3,Spring2019
4175,NE 111th & Weidler,6566,S,NS,5,3,8,2,Spring2019
4176,SE 112th & Mt Scott Blvd,6567,N,FS,10,15,25,3,Spring2019
4177,SE 12th & Clay,6576,N,NS,19,42,61,11,Spring2019
4178,NE 12th & Couch,6577,S,FS,115,71,186,58,Spring2019
4179,SE 12th & Division,6578,N,NS,75,39,114,14,Spring2019
4180,NE 12th & Glisan,6580,S,NS,62,42,104,1,Spring2019
4187,SE 12th & Harrison,6581,N,NS,21,7,28,2,Spring2019
4188,NE 12th & Irving,6582,N,NS,56,71,127,2,Spring2019
4189,NE 12th & Irving,6583,S,NS,7,4,11,0,Spring2019
4190,SE 12th & Madison,6585,N,FS,102,29,131,14,Spring2019
4191,SE 12th & Morrison,6588,N,NS,71,87,158,37,Spring2019
4192,SE 12th & Pine,6589,N,NS,8,10,18,3,Spring2019
4193,NE 12th & E Burnside,6592,N,FS,78,145,223,69,Spring2019
4194,SE 12th & Stark,6594,N,NS,46,40,86,34,Spring2019
4195,SW 121st & North Dakota,6597,N,NS,6,2,8,0,Spring2019
4196,SW 121st & Katherine,6598,S,FS,4,6,10,0,Spring2019
4197,SW 121st & Lynn,6599,N,NS,8,5,13,0,Spring2019
4198,SW 121st & Merestone,6601,N,NS,2,1,3,0,Spring2019
4199,SW 121st & Merestone,6602,S,NS,2,1,3,0,Spring2019
4200,SW 121st & North Dakota,6603,S,NS,1,6,7,0,Spring2019
4201,NE 121st Pl & Prescott,6604,N,NS,45,46,91,5,Spring2019
4202,SW 121st & Scholls Ferry,6606,S,FS,12,24,36,2,Spring2019
4203,SW 121st & Springwood,6607,N,NS,14,7,21,2,Spring2019
4204,SW 121st & Summer,6608,S,FS,0,1,1,0,Spring2019
4205,NE 122nd & Davis,6610,S,NS,68,24,92,42,Spring2019
4206,300 Block NE 122nd,6611,N,AT,17,50,67,21,Spring2019
4207,3600 Block NE 122nd,6613,S,OP,39,11,50,1,Spring2019
4208,NE 122nd & Halsey,6617,S,NS,118,55,173,84,Spring2019
4209,SE 122nd & Boise,6618,N,NS,49,7,56,3,Spring2019
4210,SE 122nd & Boise,6619,S,NS,46,63,109,7,Spring2019
4211,NE 122nd & Brazee,6620,N,NS,16,17,33,11,Spring2019
4212,SE 122nd & E Burnside,6621,N,NS,183,366,549,182,Spring2019
4213,SE 122nd & Burnside,6623,S,FS,360,178,538,178,Spring2019
4214,SE 122nd & Bush,6624,N,FS,42,30,72,6,Spring2019
4215,SE 122nd & Bush,6625,S,FS,25,36,61,2,Spring2019
4216,SE 122nd & Foster,6626,N,FS,76,28,104,31,Spring2019
4217,NE 122nd & Halsey,6628,N,FS,54,78,132,63,Spring2019
4218,SE 122nd & Division,6630,N,FS,300,145,445,121,Spring2019
4219,SE 122nd & Division,6631,S,FS,151,299,450,127,Spring2019
4220,SE 122nd & Harold,6633,N,NS,64,10,74,43,Spring2019
4221,SE 122nd & Harold,6634,S,NS,5,55,60,18,Spring2019
4222,SE 122nd & Holgate,6635,N,NS,148,25,173,42,Spring2019
4223,SE 122nd & Holgate,6636,S,FS,28,96,124,47,Spring2019
4224,SE 122nd & Lincoln,6640,N,FS,56,33,89,10,Spring2019
4225,SE 122nd & Lincoln,6641,S,NS,36,64,100,16,Spring2019
4226,SE 122nd & Madison,6642,N,NS,53,22,75,24,Spring2019
4227,1300 Block SE 122nd,6643,S,OP,25,51,76,23,Spring2019
4228,SE 122nd & Market,6645,N,NS,66,71,137,16,Spring2019
4229,SE 122nd & Market,6646,S,NS,87,69,156,19,Spring2019
4230,500 Block NE 122nd Ave,6648,N,OP,41,80,121,63,Spring2019
4231,700 Block NE 122nd,6649,S,AT,64,38,102,49,Spring2019
4232,SE 122nd & Midland Library (Morrison),6650,S,AT,65,42,107,32,Spring2019
4233,NE 122nd & Multnomah,6651,N,NS,10,24,34,8,Spring2019
4240,SE 122nd & Oak,6652,N,OP,93,167,260,76,Spring2019
4241,SE 122nd & Oak,6653,S,NS,46,40,86,30,Spring2019
4242,NE 122nd & Shaver,6654,N,NS,14,111,125,26,Spring2019
4243,SE 122nd & Powell,6655,N,FS,285,87,372,109,Spring2019
4244,SE 122nd & Ramona,6657,N,NS,45,10,55,3,Spring2019
4245,SE 122nd & Ramona,6658,S,OP,10,36,46,2,Spring2019
4246,SE 122nd & Raymond,6660,N,FS,33,5,38,21,Spring2019
4247,SE 122nd & Reedway,6662,S,NS,4,13,17,30,Spring2019
4248,NE 122nd & Sacramento,6667,S,NS,19,19,38,1,Spring2019
4249,SE 122nd & Rhone,6668,S,NS,162,120,282,80,Spring2019
4250,SE 122nd & Salmon,6669,N,FS,11,23,34,2,Spring2019
4251,NE 122nd & San Rafael,6670,N,NS,51,78,129,49,Spring2019
4252,NE 122nd & San Rafael,6671,S,FS,70,52,122,49,Spring2019
4253,NE 122nd & Shaver,6672,S,NS,103,36,139,27,Spring2019
4254,NE 122nd & Stanton,6673,N,NS,11,26,37,2,Spring2019
4255,NE 122nd & Stanton,6674,S,NS,31,16,47,6,Spring2019
4256,SE 122nd & Woodward Pl,6675,N,OP,24,16,40,16,Spring2019
4257,SE 122nd & Woodward Pl,6676,S,FS,10,19,29,10,Spring2019
4258,NE 125th Pl & Riverwood 40,6682,E,NS,1,7,8,3,Spring2019
4259,NE 125th Pl & Shaver,6683,N,FS,1,2,3,0,Spring2019
4260,SE 13th & Clatsop,6688,N,NS,11,1,12,0,Spring2019
4261,SW 13th & Custer,6689,N,NS,3,8,11,0,Spring2019
4262,SE 13th & Knapp,6691,N,NS,9,1,10,1,Spring2019
4263,SE 13th & Lambert,6693,N,NS,31,4,35,1,Spring2019
4264,SE 13th & Lambert,6694,S,NS,2,24,26,1,Spring2019
4265,SE 13th & Sellwood,6707,S,NS,1,8,9,0,Spring2019
4266,SE 13th & Tacoma,6708,N,NS,48,7,55,7,Spring2019
4267,SE 13th & Tacoma,6709,S,FS,11,50,61,14,Spring2019
4268,SE 13th & Umatilla,6711,N,NS,11,2,13,0,Spring2019
4269,NE 132nd & Brazee,6713,S,NS,1,0,1,0,Spring2019
4270,NE 132nd & Eugene,6714,N,FS,0,1,1,0,Spring2019
4271,NE 132nd & Eugene,6715,S,NS,1,0,1,0,Spring2019
4272,NE 132nd & Knott,6716,N,OP,1,5,6,0,Spring2019
4273,NE 132nd & San Rafael,6718,S,NS,2,0,2,0,Spring2019
4274,NE 133rd & Shaver,6719,S,NS,0,8,8,2,Spring2019
4275,NE 135th & Fremont,6720,S,FS,5,5,10,1,Spring2019
4276,NE 135th & Rose Parkway,6722,S,NS,3,3,6,0,Spring2019
4277,6000 Block SE 136th,6723,N,AT,11,2,13,0,Spring2019
4278,SE 136th & Center,6725,N,FS,12,2,14,1,Spring2019
4279,SE 136th & Mall,6728,N,NS,15,2,17,12,Spring2019
4280,SE 136th & Ramona,6729,N,OP,14,5,19,0,Spring2019
4281,SE 136th & Ramona,6730,S,NS,6,17,23,1,Spring2019
4282,SE 136th & Rhone,6731,N,FS,22,3,25,2,Spring2019
4283,SW 14th Dr & Battaglia,6735,E,NS,0,0,0,0,Spring2019
4284,SW 14th Dr & Battaglia,6736,W,OP,0,0,0,0,Spring2019
4285,SW 14th Dr & Binford,6737,E,NS,2,1,3,0,Spring2019
4286,SW 14th Dr & Binford,6738,W,OP,2,1,3,0,Spring2019
4293,SW 14th Dr & Birdsdale,6739,E,NS,1,0,1,0,Spring2019
4294,SW 14th Dr & Birdsdale,6740,W,OP,1,1,2,0,Spring2019
4295,SW 14th Dr & Tegart,6742,E,FS,2,1,3,14,Spring2019
4296,SW 14th Dr & Tegart,6743,W,OP,1,1,2,4,Spring2019
4297,SW 14th Dr & Pleasant View Dr,6744,E,NS,3,1,4,1,Spring2019
4298,SW 14th Dr & Pleasant View,6745,W,NS,1,2,3,3,Spring2019
4299,NE 141st & Failing,6746,N,NS,8,1,9,1,Spring2019
4300,NE 141st & Beech,6747,S,FS,2,8,10,2,Spring2019
4301,NE 141st & Failing,6748,S,FS,6,3,9,1,Spring2019
4302,NE 141st & Fremont,6749,S,NS,3,4,7,2,Spring2019
4303,NE 141st & Milton Ct,6750,N,FS,6,0,6,2,Spring2019
4304,NE 143rd & Fremont Ct,6755,N,NS,0,1,1,0,Spring2019
4305,NE 145th & Fremont,6765,N,NS,7,4,11,0,Spring2019
4306,NE 15th & Ainsworth,6771,N,NS,1,37,38,13,Spring2019
4307,NE 15th & Ainsworth,6772,S,NS,45,2,47,6,Spring2019
4308,NE 15th & Alberta,6773,N,NS,31,245,276,61,Spring2019
4309,NE 15th & Alberta,6774,S,FS,180,38,218,30,Spring2019
4310,NE 15th & Brazee,6777,N,NS,8,32,40,13,Spring2019
4311,NE 15th & Brazee,6778,S,NS,25,6,31,10,Spring2019
4312,NE 15th & Weidler,6779,S,NS,55,77,132,24,Spring2019
4313,NE 15th & Dekum,6780,N,NS,2,87,89,33,Spring2019
4314,NE 15th & Failing,6783,N,NS,9,40,49,2,Spring2019
4315,NE 15th & Failing,6784,S,NS,47,4,51,1,Spring2019
4316,NE 15th & Fremont,6785,N,NS,36,124,160,15,Spring2019
4317,NE 15th & Fremont,6786,S,NS,113,38,151,13,Spring2019
4318,NE 15th & Going,6787,N,NS,2,45,47,4,Spring2019
4319,NE 15th & Going,6788,S,NS,52,4,56,2,Spring2019
4320,NE 15th & Halsey,6789,S,FS,30,18,48,5,Spring2019
4321,NE 15th & Holman,6790,N,NS,1,43,44,14,Spring2019
4322,NE 15th & Jarrett,6792,N,NS,2,34,36,7,Spring2019
4323,NE 15th & Jarrett,6793,S,NS,39,2,41,5,Spring2019
4324,NE 15th & Junior,6794,S,NS,79,4,83,34,Spring2019
4325,NE 15th & Killingsworth,6795,N,NS,11,88,99,11,Spring2019
4326,NE 15th & Killingsworth,6796,S,NS,78,10,88,3,Spring2019
4327,NE 15th & Holman,6797,S,FS,39,2,41,35,Spring2019
4328,NE 15th & Knott,6799,N,NS,6,43,49,2,Spring2019
4329,NE 15th & Knott,6800,S,NS,44,6,50,2,Spring2019
4330,NE 15th & Mason,6801,N,NS,5,33,38,5,Spring2019
4331,NE 15th & Mason,6802,S,NS,39,3,42,3,Spring2019
4332,NE 15th & Rosa Parks Way,6803,N,NS,1,25,26,6,Spring2019
4333,NE 15th & Rosa Parks Way,6804,S,NS,37,2,39,3,Spring2019
4334,NE 15th & Prescott,6805,S,FS,46,2,48,2,Spring2019
4335,NE 15th & Siskiyou,6808,N,NS,5,42,47,0,Spring2019
4336,NE 15th & Siskiyou,6809,S,NS,37,4,41,0,Spring2019
4337,NE 15th & Prescott,6810,N,NS,2,57,59,5,Spring2019
4338,NE 15th & Sumner,6813,S,NS,49,3,52,5,Spring2019
4339,NE 15th & Sumner,6814,N,NS,3,24,27,1,Spring2019
4346,NE 15th & Thompson,6815,N,NS,7,29,36,1,Spring2019
4347,NE 15th & Thompson,6816,S,NS,24,3,27,0,Spring2019
4348,NE 15th & Tillamook,6817,S,FS,55,18,73,24,Spring2019
4349,NE 16th & Multnomah,6818,S,NS,36,27,63,10,Spring2019
4350,NW 158th & Greenbrier Pkwy,6828,N,FS,3,18,21,1,Spring2019
4351,NW 158th & Greenbrier Pkwy,6829,S,OP,20,4,24,1,Spring2019
4352,SW 158th & Jay,6830,N,FS,2,0,2,0,Spring2019
4353,SW 158th & Walker,6832,N,FS,9,26,35,1,Spring2019
4354,SW 158th & Walker,6833,S,FS,16,12,28,2,Spring2019
4355,NE 15th & Hancock,6834,N,NS,27,60,87,44,Spring2019
4356,16th & Harrison,6835,W,NS,1,0,1,0,Spring2019
4357,16th & Harrison,6836,E,NS,1,2,3,0,Spring2019
4358,16th & Jackson,6837,W,NS,0,0,0,0,Spring2019
4359,NE 16th & Sandy,6839,N,NS,84,144,228,26,Spring2019
4360,16th & Taylor,6840,E,NS,1,1,2,0,Spring2019
4361,16th & Taylor,6841,W,NS,0,0,0,1,Spring2019
4362,NE 16th & Multnomah,6842,N,FS,21,50,71,11,Spring2019
4363,NE 15th & Broadway,6843,N,NS,82,72,154,47,Spring2019
4364,SE 17th & Mitchell,6846,S,FS,8,16,24,4,Spring2019
4365,SE 17th & Bybee,6847,S,NS,20,38,58,6,Spring2019
4366,SE 17th & Bybee,6848,N,NS,9,15,24,3,Spring2019
4367,SE 17th & Center,6849,N,NS,155,97,252,38,Spring2019
4368,SE 17th & Center,6850,S,NS,102,133,235,18,Spring2019
4369,SE 17th & Clatsop,6852,S,NS,5,31,36,7,Spring2019
4370,SE 17th & Marion,6853,N,NS,13,2,15,4,Spring2019
4371,SE 17th & Claybourne,6856,N,NS,21,9,30,4,Spring2019
4372,SE 17th & Claybourne,6857,S,NS,9,16,25,5,Spring2019
4373,SE 17th & Harney,6860,N,NS,5,1,6,0,Spring2019
4374,SE 17th & Harold,6861,N,NS,14,4,18,0,Spring2019
4375,SE 17th & Harold,6862,S,NS,4,12,16,1,Spring2019
4376,SE 17th & Knight,6867,N,NS,15,3,18,1,Spring2019
4377,SE 17th & Knight,6868,S,NS,4,14,18,1,Spring2019
4378,SE 17th & Lava,6871,N,OP,12,1,13,2,Spring2019
4379,SE 17th & Lava,6872,S,FS,1,10,11,0,Spring2019
4380,SE 17th & Lexington,6873,N,NS,17,3,20,0,Spring2019
4381,SE 17th & Lexington,6874,S,NS,2,23,25,0,Spring2019
4382,SE 17th & Mall,6876,N,OP,51,124,175,28,Spring2019
4383,SE 17th & Mall,6877,S,NS,104,40,144,34,Spring2019
4384,SE 17th & McLoughlin,6882,N,NS,21,8,29,3,Spring2019
4385,SE 17th & Ochoco St,6885,N,NS,35,21,56,6,Spring2019
4386,SE 17th & Ochoco St,6886,S,NS,14,32,46,6,Spring2019
4387,SE 17th & Rex,6889,N,NS,8,3,11,0,Spring2019
4388,SE 17th & Rex,6890,S,NS,2,16,18,1,Spring2019
4389,SE 17th & Schiller,6893,N,FS,6,3,9,0,Spring2019
4390,SE 17th & Schiller,6894,S,NS,3,7,10,0,Spring2019
4391,SE 17th & Tacoma,6896,S,NS,5,45,50,22,Spring2019
4392,SE 17th & Tenino,6897,N,NS,40,6,46,29,Spring2019
4399,SE 17th & Tolman,6898,N,NS,17,6,23,2,Spring2019
4400,SE 17th & Tolman,6899,S,NS,6,23,29,6,Spring2019
4401,SE 17th & Umatilla,6900,S,FS,5,37,42,17,Spring2019
4402,SE 17th & Waverly,6901,N,NS,4,3,7,1,Spring2019
4403,SE 17th & Waverly,6902,S,NS,1,5,6,1,Spring2019
4404,NW 174th & Santiam,6904,N,OP,2,5,7,0,Spring2019
4405,NW 174th & Santiam,6905,S,FS,9,1,10,0,Spring2019
4406,SW 18th & Elizabeth,6908,N,FS,4,0,4,0,Spring2019
4407,NE 181st & Davis,6912,S,NS,2,8,10,1,Spring2019
4408,SE 181st & Yamhill,6913,N,FS,6,5,11,1,Spring2019
4409,NE 181st & E Burnside,6914,N,FS,64,48,112,18,Spring2019
4410,800 Block NE 181st,6916,N,AT,7,7,14,1,Spring2019
4411,NE 181st & Everett Ct,6918,N,NS,2,3,5,2,Spring2019
4412,NE 181st & Glisan,6919,N,NS,8,9,17,5,Spring2019
4413,NE 181st & Glisan,6920,S,FS,12,19,31,9,Spring2019
4414,SE 181st & Oak,6921,N,NS,33,27,60,14,Spring2019
4415,NE 181st & Wasco,6922,N,OP,2,5,7,1,Spring2019
4416,NE 181st & Wasco,6923,S,NS,13,4,17,2,Spring2019
4417,1900 Block SE 182nd,6924,N,AT,9,3,12,3,Spring2019
4418,SE 182nd & 3rd,6926,N,FS,3,1,4,1,Spring2019
4419,SE 182nd & SW 5th Dr,6928,N,NS,3,0,3,0,Spring2019
4420,SE 181st & Yamhill,6929,S,NS,6,5,11,1,Spring2019
4421,SE 182nd & Brooklyn Ct,6930,N,NS,6,2,8,1,Spring2019
4422,SE 182nd & Haig,6931,N,NS,20,2,22,3,Spring2019
4423,SE 182nd & Clinton,6934,N,NS,2,2,4,1,Spring2019
4424,SE 182nd & Division,6935,S,FS,10,45,55,13,Spring2019
4425,SE 182nd & Division,6936,N,FS,58,10,68,16,Spring2019
4426,SE 182nd & Lincoln,6937,S,FS,1,10,11,6,Spring2019
4427,SE 182nd & Market,6938,S,NS,3,5,8,2,Spring2019
4428,SE 182nd & Market,6939,N,OP,8,3,11,2,Spring2019
4429,SE 182nd & Mill,6940,N,NS,4,1,5,0,Spring2019
4430,SE 182nd & W Powell,6942,N,FS,37,0,37,4,Spring2019
4431,SE 182nd & Stephens,6943,S,NS,2,4,6,1,Spring2019
4432,SE 182nd & Tibbetts,6944,S,NS,4,9,13,0,Spring2019
4433,2800 Block SW 185th,6945,N,AT,18,9,27,0,Spring2019
4434,3000 Block SW 185th,6946,S,AT,11,14,25,0,Spring2019
4435,SW 185th & Aloha High School Drive,6952,S,NS,12,13,25,2,Spring2019
4436,NW 185th & Adrian,6953,N,OP,1,5,6,1,Spring2019
4437,NW 185th & Adrian,6954,S,FS,6,2,8,0,Spring2019
4438,SW 185th & Aloha Park Apts,6955,N,OP,7,19,26,1,Spring2019
4439,SW 185th & Aloha Park Apts,6956,S,AT,13,12,25,4,Spring2019
4440,SW 185th & Alexander,6957,N,FS,49,12,61,8,Spring2019
4441,SW 185th & Blanton,6959,S,FS,12,7,19,12,Spring2019
4442,SW 185th & Blanton,6960,N,OP,10,12,22,2,Spring2019
4443,NW 185th & Cornell,6961,N,FS,26,183,209,29,Spring2019
4444,NW 185th & Cornell,6964,S,FS,166,38,204,26,Spring2019
4445,SW 185th & Ewen,6968,N,FS,9,3,12,0,Spring2019
4452,SW 185th & Ewen,6969,S,OP,5,8,13,0,Spring2019
4453,SW 185th & Farmington,6970,N,FS,104,87,191,16,Spring2019
4454,NW 185th & Heritage Pkwy,6972,N,FS,23,20,43,3,Spring2019
4455,NW 185th & Heritage Pkwy,6975,S,FS,15,34,49,5,Spring2019
4456,SW 185th & Honeywood,6976,S,FS,4,2,6,0,Spring2019
4457,SW 185th & Jay,6977,N,FS,4,6,10,0,Spring2019
4458,SW 185th & Johnson,6978,N,FS,40,22,62,1,Spring2019
4459,SW 185th & Johnson,6979,S,FS,20,36,56,1,Spring2019
4460,SW 185th & Kinnaman,6980,N,NS,72,68,140,8,Spring2019
4461,SW 185th & Kinnaman,6981,S,FS,67,68,135,7,Spring2019
4462,SW 185th & Longacre,6982,N,FS,2,5,7,1,Spring2019
4463,SW 185th & Longacre,6983,S,FS,3,2,5,0,Spring2019
4464,SW 185th & Madeline,6984,N,NS,15,10,25,2,Spring2019
4465,NW 185th & McKinley School,6986,N,NS,13,41,54,11,Spring2019
4466,NW 185th & Sunset Square,6987,S,AT,72,28,100,25,Spring2019
4467,NW 185th & Holly,6990,N,OP,5,9,14,0,Spring2019
4468,NW 185th & Holly,6991,S,FS,8,7,15,0,Spring2019
4469,NW 185th & Parkview,6992,N,FS,6,26,32,1,Spring2019
4470,SW 185th & Pheasant,6993,N,FS,5,2,7,0,Spring2019
4471,SW 185th & Pheasant,6994,S,OP,1,2,3,0,Spring2019
4472,SW 185th & Pike,6995,N,NS,6,6,12,0,Spring2019
4473,SW 185th & Pike,6996,S,FS,6,7,13,2,Spring2019
4474,NW 185th & Bronson,6999,S,OP,16,3,19,0,Spring2019
4475,NW 185th & Westview HS,7000,N,AT,9,46,55,4,Spring2019
4476,NW 185th & Rock Creek School,7001,S,AT,55,10,65,7,Spring2019
4477,SW 185th & Rosa,7002,N,FS,12,16,28,1,Spring2019
4478,SW 185th & Rosa,7003,S,NS,24,25,49,3,Spring2019
4479,SW 185th & Edgeway Dr,7006,S,NS,1,9,10,1,Spring2019
4480,SW 185th & Salix Terrace,7007,N,FS,13,2,15,1,Spring2019
4481,SW 185th & Sandra,7009,S,OP,15,12,27,0,Spring2019
4482,SW 185th & Sandra,7010,N,FS,11,6,17,1,Spring2019
4483,NW 185th & Springville,7011,N,NS,0,14,14,5,Spring2019
4484,SW 185th & Tualatin Valley Hwy,7012,N,NS,94,70,164,23,Spring2019
4485,SW 185th & Tualatin Valley Hwy,7013,S,FS,68,64,132,16,Spring2019
4486,NW 185th & Tamarack,7014,N,FS,0,6,6,0,Spring2019
4487,NW 185th & Tamarack,7015,S,OP,7,1,8,0,Spring2019
4488,700 Block NW 185th,7020,N,AT,12,40,52,17,Spring2019
4489,700 Block NW 185th,7021,S,AT,29,11,40,28,Spring2019
4490,SW 185th & W Baseline,7023,S,FS,24,17,41,8,Spring2019
4491,NW 185th & Walker,7024,N,FS,40,82,122,19,Spring2019
4492,NW 185th & NE Walker,7025,S,FS,89,38,127,12,Spring2019
4493,NW 185th & West Union,7026,N,FS,7,70,77,25,Spring2019
4494,NW 185th & West Union,7027,S,NS,84,8,92,30,Spring2019
4495,SW 19th & Barbur,7036,S,FS,5,6,11,0,Spring2019
4496,19th & Birch,7038,E,NS,38,2,40,4,Spring2019
4497,19th & Cedar,7041,E,NS,64,2,66,2,Spring2019
4498,19th & Elm ,7043,E,NS,77,4,81,37,Spring2019
4505,19th & Hawthorne,7044,E,NS,54,4,58,20,Spring2019
4506,19th & Main ,7046,E,FS,93,1,94,19,Spring2019
4507,SW 19th & Multnomah,7047,N,FS,4,11,15,0,Spring2019
4508,19th Way & 19th Ave,7048,E,FS,127,39,166,43,Spring2019
4509,SW 19th & Spring Garden,7049,S,NS,0,3,3,0,Spring2019
4510,700 Block SW 197th,7052,S,OP,4,4,8,0,Spring2019
4511,SW 197th & W Baseline,7053,N,NS,7,6,13,1,Spring2019
4512,SW 197th & Frances,7054,S,FS,3,6,9,10,Spring2019
4513,SW 198th & Blanton,7060,N,NS,6,2,8,0,Spring2019
4514,SW 198th & Blanton,7061,S,NS,9,8,17,3,Spring2019
4515,SW 198th & Butternut,7062,N,FS,3,0,3,7,Spring2019
4516,SW 198th & Butternut,7063,S,OP,1,1,2,7,Spring2019
4517,SW 198th & Carlin,7064,S,FS,16,17,33,0,Spring2019
4518,SW 198th & Carlin,7065,N,OP,17,17,34,1,Spring2019
4519,SW 198th & Celebrity,7066,S,NS,2,4,6,1,Spring2019
4520,SW 198th & Celebrity,7067,N,FS,3,3,6,0,Spring2019
4521,SW 198th & Deline,7068,S,FS,4,4,8,0,Spring2019
4522,SW 198th & Deline,7069,N,OP,4,4,8,0,Spring2019
4523,SW 198th & Farmington,7070,S,NS,23,19,42,0,Spring2019
4524,SW 198th & Farmington,7071,N,FS,21,25,46,1,Spring2019
4525,SW 198th & Imperial,7072,S,NS,2,3,5,3,Spring2019
4526,SW 198th & Johnson,7073,S,FS,3,2,5,0,Spring2019
4527,SW 198th & Johnson,7074,N,NS,3,4,7,0,Spring2019
4528,SW 198th & Kinnaman,7075,S,NS,7,7,14,0,Spring2019
4529,SW 198th & Kinnaman,7076,N,NS,7,7,14,0,Spring2019
4530,SW 198th & Prospect,7077,N,FS,4,4,8,1,Spring2019
4531,SW 198th & Prospect,7078,S,OP,2,2,4,4,Spring2019
4532,SW 198th & Rock Dr,7079,S,NS,8,8,16,0,Spring2019
4533,SW 198th & Rosa,7082,N,FS,13,10,23,10,Spring2019
4534,SW 198th & Rosa,7083,S,FS,9,10,19,10,Spring2019
4535,SW 198th & Sandra,7084,N,NS,3,4,7,1,Spring2019
4536,SW 198th & Southview,7086,S,FS,3,10,13,1,Spring2019
4537,SW 198th & Southview,7087,N,NS,9,5,14,1,Spring2019
4538,SW 198th & Trelane,7089,S,OP,2,2,4,0,Spring2019
4539,SW 198th & Trelane,7090,N,FS,2,1,3,0,Spring2019
4540,SW 198th & Oak,7092,N,FS,5,4,9,0,Spring2019
4541,SW 198th & York,7093,S,NS,4,5,9,0,Spring2019
4542,SW 198th & York,7094,N,FS,5,4,9,0,Spring2019
4543,SW 2nd & Alder,7095,N,NS,370,37,407,27,Spring2019
4544,SW 2nd & Taylor,7098,N,NS,176,73,249,10,Spring2019
4545,S 2nd & Tumwater,7101,W,FS,6,3,9,1,Spring2019
4546,NE 21st & Argyle,7105,N,NS,0,17,17,0,Spring2019
4547,NE 21st & Clackamas,7106,S,NS,11,2,13,1,Spring2019
4548,NE 21st & Clackamas,7107,N,NS,7,11,18,3,Spring2019
4549,SE 21st & Clinton,7108,S,NS,13,8,21,0,Spring2019
4550,SE 21st & Division,7110,N,NS,9,18,27,3,Spring2019
4551,NW 21st & Glisan,7112,S,NS,109,14,123,23,Spring2019
4558,NW 21st & Irving,7113,N,NS,7,60,67,24,Spring2019
4559,NW 21st & Irving,7114,S,NS,81,5,86,15,Spring2019
4560,NW 21st & Lovejoy,7121,S,NS,110,6,116,43,Spring2019
4561,NW 21st & Lovejoy,7122,N,FS,6,102,108,51,Spring2019
4562,NW 21st & Northrup,7127,S,NS,71,3,74,17,Spring2019
4563,NW 21st & Northrup,7128,N,NS,5,50,55,30,Spring2019
4564,NW 21st & Pettygrove,7130,N,FS,4,55,59,4,Spring2019
4565,SE 21st & Washington,7136,S,NS,33,4,37,3,Spring2019
4566,NE 21st & Weidler,7138,N,NS,15,26,41,5,Spring2019
4567,NE 21st & Weidler,7139,S,NS,23,12,35,13,Spring2019
4568,SE 22nd & Bluebird,7141,S,NS,1,1,2,0,Spring2019
4569,SE 22nd & Wren,7144,S,FS,0,0,0,0,Spring2019
4570,SE 223rd & Ankeny,7145,N,OP,1,1,2,0,Spring2019
4571,SE 223rd & Ankeny,7146,S,FS,3,2,5,1,Spring2019
4572,SE 223rd & Oak,7149,S,NS,4,30,34,8,Spring2019
4573,SE 223rd & Salmon,7150,N,NS,3,3,6,1,Spring2019
4574,SE 223rd & Salmon,7151,S,OP,2,2,4,4,Spring2019
4575,SE 223rd & Stark,7152,N,FS,89,10,99,19,Spring2019
4576,SE 223rd & Yamhill,7153,N,OP,2,3,5,0,Spring2019
4577,SE 223rd & Yamhill,7154,S,NS,4,5,9,1,Spring2019
4578,SE 23rd & Bybee,7156,S,NS,0,1,1,0,Spring2019
4579,NW 23rd & Flanders,7157,N,NS,18,55,73,20,Spring2019
4580,NW 23rd & Irving,7161,N,NS,11,74,85,12,Spring2019
4581,NW 23rd & Irving,7162,S,NS,134,14,148,20,Spring2019
4582,NW 23rd & Lovejoy,7163,N,NS,15,169,184,101,Spring2019
4583,NW 23rd & Thurman,7169,N,FS,36,89,125,20,Spring2019
4584,SE 23rd & Tolman (Union Manor),7172,N,NS,26,18,44,187,Spring2019
4585,NW 23rd & Westover,7174,S,NS,37,25,62,8,Spring2019
4586,NE 24th & Broadway,7188,N,FS,14,45,59,25,Spring2019
4587,NE 24th & Fremont,7190,N,FS,6,26,32,0,Spring2019
4588,NE 24th & Fremont,7191,S,NS,28,7,35,1,Spring2019
4589,NE 24th & Hancock,7193,S,NS,16,3,19,0,Spring2019
4590,NE 24th & Klickitat,7194,N,NS,1,18,19,0,Spring2019
4591,NE 24th & Klickitat,7196,S,NS,20,1,21,0,Spring2019
4592,NE 24th & Knott,7197,N,NS,1,32,33,1,Spring2019
4593,NE 24th & Knott,7198,S,NS,32,2,34,1,Spring2019
4594,NE 24th & Siskiyou,7201,N,NS,2,27,29,0,Spring2019
4595,NE 24th & Siskiyou,7202,S,NS,28,2,30,0,Spring2019
4596,NE 24th & Thompson,7205,S,NS,15,2,17,1,Spring2019
4597,NE 24th & Thompson,7206,N,NS,2,10,12,1,Spring2019
4598,NE 24th & Tillamook,7208,N,NS,2,10,12,0,Spring2019
4599,SE 25th & Morrison,7216,N,NS,47,7,54,1,Spring2019
4600,SE Clinton & 26th,7223,W,FS,16,21,37,1,Spring2019
4601,SE 26th & Gladstone,7224,S,NS,4,11,15,0,Spring2019
4602,SE 26th & Kelly,7226,S,OP,29,11,40,0,Spring2019
4603,SE 26th & Powell,7227,N,FS,67,148,215,6,Spring2019
4604,SE 26th & Powell,7228,S,NS,108,53,161,10,Spring2019
4611,SE 26th & Rhone,7230,S,OP,8,9,17,1,Spring2019
4612,SE 26th & Rhone,7231,N,NS,11,6,17,1,Spring2019
4613,SE 26th & Tibbetts,7232,N,NS,11,2,13,0,Spring2019
4614,SE 26th & Woodward,7233,S,NS,20,6,26,0,Spring2019
4615,SE 26th & Woodward,7234,N,NS,8,2,10,0,Spring2019
4616,NE 27th & Ainsworth,7235,N,NS,0,42,42,26,Spring2019
4617,NE 27th & Ainsworth,7236,S,NS,47,1,48,25,Spring2019
4618,NE 27th & Alberta,7237,S,FS,75,21,96,6,Spring2019
4619,NE 27th & Alberta,7238,N,NS,7,78,85,9,Spring2019
4620,NE 27th & Dekum,7240,N,NS,0,23,23,2,Spring2019
4621,NE 27th & Highland,7245,S,NS,17,0,17,3,Spring2019
4622,NE 27th & Holman,7246,N,NS,0,33,33,4,Spring2019
4623,NE 27th & Holman,7247,S,NS,45,1,46,3,Spring2019
4624,NE 27th & Jarrett,7248,N,NS,1,20,21,10,Spring2019
4625,NE 27th & Jarrett,7249,S,NS,17,1,18,0,Spring2019
4626,NE 27th & Killingsworth,7250,N,NS,2,30,32,4,Spring2019
4627,NE 27th & Killingsworth,7251,S,NS,43,3,46,2,Spring2019
4628,NE 27th & Prescott,7256,N,NS,2,22,24,1,Spring2019
4629,NE 27th & Prescott,7257,S,NS,23,2,25,0,Spring2019
4630,NE 27th & Sumner,7260,N,NS,1,28,29,5,Spring2019
4631,NE 27th & Sumner,7261,S,NS,44,2,46,1,Spring2019
4632,NE 27th & Wygant,7266,S,FS,16,0,16,0,Spring2019
4633,NE 27th & Wygant,7267,N,NS,0,18,18,0,Spring2019
4634,SE 28th & Bybee,7270,N,NS,2,1,3,0,Spring2019
4635,SE 28th & Gladstone,7277,N,NS,27,6,33,0,Spring2019
4636,SE 28th & Holgate,7281,S,FS,13,26,39,1,Spring2019
4637,SE 28th & Holgate,7282,N,NS,31,20,51,4,Spring2019
4638,SE 28th & Martins,7286,N,NS,1,2,3,1,Spring2019
4639,SE 28th & Raymond,7288,S,NS,8,23,31,1,Spring2019
4640,SE 28th & Raymond,7289,N,OP,37,7,44,2,Spring2019
4641,28th & Rex,7290,S,NS,1,5,6,0,Spring2019
4642,SE 28th & Steele,7293,S,NS,14,22,36,1,Spring2019
4643,SE 28th & Tolman,7294,N,NS,0,2,2,0,Spring2019
4644,SE 28th & Tolman,7295,S,NS,2,0,2,0,Spring2019
4645,SE 282nd & Chase,7297,N,NS,0,1,1,0,Spring2019
4646,SE 282nd & Chase,7298,S,NS,3,1,4,0,Spring2019
4647,SE 282nd & Orient,7303,S,NS,1,0,1,0,Spring2019
4648,NE 29th & Alameda,7306,N,NS,1,17,18,0,Spring2019
4649,NE 29th & Alameda,7307,S,NS,11,1,12,0,Spring2019
4650,NE 29th & Bryce,7309,N,NS,0,23,23,0,Spring2019
4651,NE 29th & Bryce,7310,S,NS,21,1,22,0,Spring2019
4652,NW 29th & Industrial,7311,N,NS,1,18,19,1,Spring2019
4653,NW 29th & Industrial,7313,S,NS,34,1,35,1,Spring2019
4654,NW 29th & Nela,7314,N,NS,2,11,13,0,Spring2019
4655,NW 29th & Nela,7315,S,OP,15,2,17,0,Spring2019
4656,NW 29th & Nicolai,7316,S,NS,12,0,12,0,Spring2019
4657,NE 29th & Skidmore,7317,N,NS,0,30,30,6,Spring2019
4664,NW 29th & 31st,7320,N,OP,0,21,21,1,Spring2019
4665,NE 30th & Alberta,7326,S,NS,21,20,41,6,Spring2019
4666,NE 30th & Emerson,7327,N,NS,6,8,14,6,Spring2019
4667,NE 30th & Emerson,7328,S,NS,9,11,20,2,Spring2019
4668,NE 30th & Killingsworth,7329,N,NS,24,19,43,3,Spring2019
4669,SE 32nd & Floss,7334,S,OP,8,5,13,0,Spring2019
4670,SE 32nd & Bybee,7335,N,NS,2,2,4,0,Spring2019
4671,SE 32nd & Bybee,7336,S,NS,3,2,5,0,Spring2019
4672,SE 32nd & Hillside,7339,N,OP,21,11,32,19,Spring2019
4673,SE 32nd & Harvey,7340,S,OP,2,5,7,1,Spring2019
4674,SE 32nd & Harvey,7341,N,NS,6,4,10,0,Spring2019
4675,SE 32nd & Hillside,7342,S,NS,12,19,31,22,Spring2019
4676,SE 32nd & Knapp,7344,N,NS,0,3,3,0,Spring2019
4677,SE 32nd & Knapp,7345,S,NS,5,0,5,0,Spring2019
4678,SE 32nd & Malcolm,7346,N,OP,4,3,7,0,Spring2019
4679,SE 32nd & Malcolm,7347,S,FS,3,4,7,1,Spring2019
4680,SE 32nd & Meek,7349,S,NS,5,10,15,5,Spring2019
4681,SE 32nd & Olsen,7350,N,NS,8,6,14,3,Spring2019
4682,SE 32nd & Olsen,7351,S,FS,5,7,12,2,Spring2019
4683,SE 32nd & Rex,7352,S,NS,18,4,22,0,Spring2019
4684,SE 32nd & Tolman,7357,N,NS,1,2,3,0,Spring2019
4685,SE 32nd & Tolman,7358,S,NS,4,1,5,0,Spring2019
4686,SE 32nd & Van Water,7359,N,OP,3,3,6,0,Spring2019
4687,SE 32nd & Woodstock,7360,N,NS,4,11,15,1,Spring2019
4688,NE 33rd & Ainsworth,7361,S,FS,8,1,9,2,Spring2019
4689,NE 33rd & Ainsworth,7362,N,NS,1,8,9,0,Spring2019
4690,NE 33rd & Alberta,7363,S,NS,27,1,28,6,Spring2019
4691,NE 33rd & Alberta Ct,7364,N,NS,1,19,20,1,Spring2019
4692,NE 33rd & Brazee,7365,N,OP,3,5,8,0,Spring2019
4693,NE 33rd & Brazee,7366,S,NS,10,2,12,0,Spring2019
4694,NE 33rd & Bryce,7368,S,NS,4,0,4,0,Spring2019
4695,NE 33rd & Dekum,7369,N,NS,13,11,24,1,Spring2019
4696,NE 33rd & Dekum,7370,S,NS,15,17,32,2,Spring2019
4697,NE 33rd & Emerson,7371,N,NS,5,39,44,7,Spring2019
4698,NE 33rd & Emerson,7372,S,NS,27,4,31,5,Spring2019
4699,NE 33rd & Alameda,7373,N,NS,5,16,21,1,Spring2019
4700,NE 33rd & Fremont,7374,S,NS,12,5,17,0,Spring2019
4701,NE 33rd & Going,7375,N,NS,1,8,9,3,Spring2019
4702,NE 33rd & Hancock,7377,S,NS,3,3,6,0,Spring2019
4703,NE 33rd & Holman,7378,N,NS,1,15,16,0,Spring2019
4704,NE 33rd & Holman,7379,S,FS,17,1,18,1,Spring2019
4705,NE 33rd & Jarrett,7380,N,OP,3,11,14,10,Spring2019
4706,NE 33rd & Jarrett,7381,S,NS,12,1,13,4,Spring2019
4707,NE 33rd & Killingsworth,7382,S,NS,41,43,84,5,Spring2019
4708,NE 33rd & Killingsworth,7383,N,NS,32,40,72,4,Spring2019
4709,NE 33rd & Knott,7385,N,FS,3,7,10,2,Spring2019
4710,NE 33rd & Knott,7386,S,FS,8,2,10,0,Spring2019
4717,NE 33rd & Rosa Parks Way,7388,S,NS,11,1,12,0,Spring2019
4718,NE 33rd & Rosa Parks Way,7389,N,NS,1,10,11,1,Spring2019
4719,NE 33rd & Prescott,7390,N,NS,1,8,9,2,Spring2019
4720,NE 33rd & Prescott,7391,S,NS,17,1,18,2,Spring2019
4721,NE 33rd & Schuyler,7392,N,NS,17,8,25,1,Spring2019
4722,NE 33rd & Shaver,7393,N,NS,1,8,9,0,Spring2019
4723,NE 33rd & Shaver,7394,S,NS,7,1,8,0,Spring2019
4724,NE 33rd & Siskiyou,7395,N,NS,1,6,7,1,Spring2019
4725,NE 33rd & Siskiyou,7396,S,NS,11,1,12,1,Spring2019
4726,NE 33rd & Skidmore,7397,S,NS,7,0,7,0,Spring2019
4727,NE 33rd & Skidmore,7398,N,NS,1,10,11,0,Spring2019
4728,NE 33rd & Stanton,7399,N,FS,1,9,10,0,Spring2019
4729,NE 33rd & Stanton,7400,S,NS,8,0,8,0,Spring2019
4730,NE 33rd & US Grant Pl,7402,N,FS,6,6,12,0,Spring2019
4731,NE 33rd & US Grant Pl,7403,S,NS,3,2,5,0,Spring2019
4732,SE 34th & Sellwood,7407,N,NS,1,1,2,0,Spring2019
4733,SE 34th & Sellwood,7408,S,NS,0,1,1,0,Spring2019
4734,SE 34th & Washington,7409,N,NS,0,0,0,0,Spring2019
4735,SE 34th & Wister,7410,N,NS,1,1,2,0,Spring2019
4736,SE 34th & Wister,7411,S,NS,0,0,0,0,Spring2019
4737,SW 35th & Caldew,7412,S,NS,0,2,2,0,Spring2019
4738,SW 35th & Caldew,7413,N,OP,2,0,2,0,Spring2019
4739,SW 35th & California,7414,S,NS,0,2,2,0,Spring2019
4740,SW 35th & California,7415,N,OP,1,0,1,0,Spring2019
4741,SW 35th & Canby,7417,N,NS,1,1,2,0,Spring2019
4742,SW 35th & Huber,7419,S,NS,1,5,6,0,Spring2019
4743,SW 35th & Indian Hills Apts,7420,N,AT,8,1,9,0,Spring2019
4744,SW 35th & Indian Hills Apts,7421,S,OP,2,3,5,0,Spring2019
4745,SW 35th & Logan,7422,S,NS,0,2,2,0,Spring2019
4746,SW 35th & Logan,7423,N,OP,2,0,2,0,Spring2019
4747,SW 35th & Nevada,7425,S,NS,0,5,5,0,Spring2019
4748,SW 35th & Nevada,7426,N,NS,4,0,4,0,Spring2019
4749,SW 35th & Ridge Dr,7427,N,NS,2,2,4,0,Spring2019
4750,SW 35th & Ridge Dr,7428,S,OP,2,2,4,0,Spring2019
4751,SW 35th & Texas,7429,S,FS,0,1,1,0,Spring2019
4752,SW 35th & Texas,7430,N,OP,1,0,1,0,Spring2019
4753,SE Cesar Chavez Blvd & Alder,7434,S,NS,5,9,14,4,Spring2019
4754,SE Cesar Chavez Blvd & Ash,7435,N,NS,4,5,9,3,Spring2019
4755,SE Cesar Chavez Blvd & Ash,7436,S,OP,10,8,18,6,Spring2019
4756,SE Cesar Chavez Blvd & Belmont,7437,N,NS,109,149,258,59,Spring2019
4757,SE Cesar Chavez Blvd & Belmont,7438,S,NS,119,99,218,37,Spring2019
4758,SE Cesar Chavez Blvd & Brooklyn,7439,N,NS,12,2,14,1,Spring2019
4759,SE Cesar Chavez Blvd & E Burnside,7440,N,NS,58,127,185,57,Spring2019
4760,NE Cesar Chavez Blvd & E Burnside,7441,S,NS,139,48,187,56,Spring2019
4761,SE Cesar Chavez Blvd & Clinton,7442,N,NS,11,9,20,3,Spring2019
4762,SE Cesar Chavez Blvd & Clinton,7443,S,NS,6,14,20,1,Spring2019
4763,SE Cesar Chavez Blvd & Cora,7444,S,NS,3,11,14,1,Spring2019
4770,SE Cesar Chavez Blvd & Division,7445,N,FS,214,149,363,88,Spring2019
4771,SE Cesar Chavez Blvd & Division,7446,S,NS,176,209,385,107,Spring2019
4772,SE Cesar Chavez Blvd & Francis,7447,S,NS,13,27,40,5,Spring2019
4773,SE Cesar Chavez Blvd & Franklin,7448,S,NS,5,15,20,0,Spring2019
4774,SE Cesar Chavez Blvd & Gladstone,7449,N,FS,107,25,132,29,Spring2019
4775,SE Cesar Chavez Blvd & Gladstone,7450,S,NS,23,72,95,31,Spring2019
4776,NE Cesar Chavez Blvd & Glisan,7451,N,NS,26,76,102,49,Spring2019
4777,NE Cesar Chavez Blvd & Glisan,7452,S,AT,71,22,93,33,Spring2019
4778,SE Cesar Chavez Blvd & Harold,7456,N,NS,6,1,7,0,Spring2019
4779,SE Cesar Chavez Blvd & Harold,7457,S,NS,1,5,6,0,Spring2019
4780,SE Cesar Chavez Blvd & Hawthorne,7459,N,NS,197,215,412,124,Spring2019
4781,SE Cesar Chavez Blvd & Hawthorne,7460,S,NS,238,213,451,174,Spring2019
4782,NE Cesar Chavez Blvd & Hazelfern,7461,N,NS,1,4,5,1,Spring2019
4783,SE Cesar Chavez Blvd & Holgate,7463,S,NS,38,92,130,108,Spring2019
4784,SE Cesar Chavez Blvd & Kelly,7464,N,NS,13,3,16,1,Spring2019
4785,SE Cesar Chavez Blvd & Knight,7465,N,NS,36,4,40,1,Spring2019
4786,SE Cesar Chavez Blvd & Knight,7466,S,NS,2,34,36,3,Spring2019
4787,SE Cesar Chavez Blvd & Lafayette,7467,N,OP,25,37,62,14,Spring2019
4788,SE Cesar Chavez Blvd & Lincoln,7468,N,NS,19,9,28,1,Spring2019
4789,SE Cesar Chavez Blvd  & Lincoln,7469,S,NS,10,16,26,2,Spring2019
4790,SE Cesar Chavez Blvd & Long,7470,S,OP,29,43,72,59,Spring2019
4791,SE Cesar Chavez Blvd & Long,7471,N,OP,18,11,29,15,Spring2019
4792,SE Cesar Chavez Blvd & Main,7472,N,NS,45,15,60,11,Spring2019
4793,SE Cesar Chavez Blvd & Main,7473,S,NS,16,60,76,12,Spring2019
4794,SE Cesar Chavez Blvd & Mall,7474,N,NS,134,47,181,105,Spring2019
4795,NE Cesar Chavez Blvd & Multnomah,7475,N,NS,3,7,10,2,Spring2019
4796,SE Cesar Chavez Blvd & Powell,7476,S,NS,138,214,352,93,Spring2019
4797,SE Cesar Chavez Blvd & Powell,7477,N,FS,191,103,294,76,Spring2019
4798,SE Cesar Chavez Blvd & Raymond,7478,N,FS,11,3,14,0,Spring2019
4799,SE Cesar Chavez Blvd & Raymond,7479,S,FS,4,9,13,1,Spring2019
4800,NE Cesar Chavez Blvd & Royal,7482,N,NS,5,5,10,0,Spring2019
4801,NE Cesar Chavez Blvd & Royal Ct,7483,S,NS,6,4,10,1,Spring2019
4802,NE Cesar Chavez Blvd & Sandy,7484,N,NS,34,10,44,13,Spring2019
4803,SE Cesar Chavez Blvd & Stark,7485,N,NS,35,26,61,13,Spring2019
4804,SE Cesar Chavez Blvd & Stark,7486,S,NS,24,30,54,13,Spring2019
4805,SE Cesar Chavez Blvd & Steele,7487,N,NS,31,23,54,2,Spring2019
4806,SE Cesar Chavez Blvd & Steele,7488,S,NS,34,32,66,2,Spring2019
4807,SE Cesar Chavez Blvd & Stephens,7489,N,OP,8,3,11,2,Spring2019
4808,SE Cesar Chavez Blvd & Stephens,7490,S,NS,8,7,15,3,Spring2019
4809,SE Cesar Chavez Blvd & Taylor,7491,N,FS,19,27,46,9,Spring2019
4810,SE Cesar Chavez Blvd & Taylor,7492,S,NS,25,24,49,7,Spring2019
4811,SE Cesar Chavez Blvd & Tibbetts,7493,S,NS,2,12,14,3,Spring2019
4812,NE Cesar Chavez Blvd & Wasco,7494,S,NS,19,4,23,1,Spring2019
4813,NE 41st & Alameda,7497,N,OP,1,18,19,1,Spring2019
4814,NE 41st & Wistaria,7498,S,NS,11,2,13,0,Spring2019
4815,NE 41st & Klickitat,7499,N,FS,2,40,42,0,Spring2019
4816,NE 41st & Klickitat,7500,S,NS,22,3,25,0,Spring2019
4823,NE 42nd & Fremont,7501,N,FS,33,66,99,6,Spring2019
4824,NE 42nd & Alberta Ct,7504,S,NS,68,22,90,5,Spring2019
4825,NE 42nd & Alberta St,7505,N,NS,22,69,91,4,Spring2019
4826,NE 42nd & Beech,7506,N,NS,7,19,26,0,Spring2019
4827,NE 42nd & Brazee,7507,N,NS,5,8,13,0,Spring2019
4828,NE 42nd & Brazee,7508,S,NS,5,3,8,1,Spring2019
4829,NE 42nd & Broadway,7509,N,NS,107,68,175,70,Spring2019
4830,NE 42nd & Broadway,7510,S,FS,85,85,170,67,Spring2019
4831,NE 42nd & Failing,7511,S,NS,14,5,19,0,Spring2019
4832,NE 42nd & Fremont,7512,S,NS,66,41,107,6,Spring2019
4833,NE 42nd & Holman,7516,N,NS,12,37,49,3,Spring2019
4834,NE 42nd & Holman,7517,S,FS,43,12,55,2,Spring2019
4835,NE 42nd & Killingsworth,7519,S,NS,136,97,233,27,Spring2019
4836,NE 42nd & Killingsworth,7520,N,FS,98,155,253,27,Spring2019
4837,NE 42nd & Knott,7521,N,NS,4,9,13,1,Spring2019
4838,NE 42nd & Knott,7522,S,NS,9,2,11,0,Spring2019
4839,SE 42nd & Llewellyn,7523,N,OP,49,61,110,41,Spring2019
4840,SE 42nd & Llewellyn,7524,S,NS,56,57,113,49,Spring2019
4841,NE 42nd & Prescott,7525,S,FS,55,19,74,0,Spring2019
4842,NE 42nd & Prescott,7526,N,NS,18,48,66,3,Spring2019
4843,NE 42nd & Sandy,7527,S,NS,78,135,213,60,Spring2019
4844,NE 42nd & Sandy,7528,N,FS,134,84,218,56,Spring2019
4845,NE 42nd & Shaver,7529,N,NS,3,18,21,6,Spring2019
4846,NE 42nd & Shaver,7530,S,NS,14,3,17,9,Spring2019
4847,NE 42nd & Simpson St,7531,N,NS,7,8,15,0,Spring2019
4848,NE 42nd & Simpson St,7532,S,OP,13,12,25,0,Spring2019
4849,NE 42nd & Skidmore,7533,N,NS,3,24,27,2,Spring2019
4850,NE 42nd & Skidmore,7534,S,NS,19,3,22,1,Spring2019
4851,NE 42nd & Sumner,7535,N,NS,5,33,38,2,Spring2019
4852,NE 42nd & Sumner,7536,S,NS,36,5,41,1,Spring2019
4853,NE 42nd & Tillamook,7537,N,FS,38,19,57,5,Spring2019
4854,NE 42nd & Tillamook,7538,S,NS,16,32,48,4,Spring2019
4855,SW 45th & Caldew,7540,S,FS,0,0,0,0,Spring2019
4856,SE 45th & Evergreen,7542,N,OP,7,2,9,1,Spring2019
4857,SE 45th & Evergreen,7543,S,NS,2,14,16,2,Spring2019
4858,SW 45th & Flower Pl,7544,S,FS,1,1,2,0,Spring2019
4859,SE 45th & Harney,7546,N,OP,32,6,38,18,Spring2019
4860,SE 45th & Harney St,7548,S,NS,7,26,33,13,Spring2019
4861,SW 45th & Illinois,7549,S,NS,6,2,8,0,Spring2019
4862,SE 45th & Knapp,7551,S,NS,5,27,32,4,Spring2019
4863,SE 45th & Knapp,7552,N,FS,26,7,33,1,Spring2019
4864,SE 45th & Malden Dr,7554,N,NS,29,2,31,1,Spring2019
4865,SW 45th & Pendleton,7555,S,NS,8,3,11,0,Spring2019
4866,SE 45th & Rex,7556,S,NS,2,25,27,1,Spring2019
4867,SE 45th & Rural,7557,N,FS,17,3,20,1,Spring2019
4868,SE 45th & Rural,7558,S,NS,3,19,22,1,Spring2019
4869,SW 45th & Vermont,7559,S,NS,0,0,0,0,Spring2019
4876,SE 45th & 46th/Nehalem,7560,N,FS,16,2,18,6,Spring2019
4877,SE 45th & 46th/Nehalem,7561,S,OP,1,8,9,6,Spring2019
4878,SE 46th & Henry,7563,N,FS,17,3,20,1,Spring2019
4879,SE 46th & Henry,7564,S,NS,5,15,20,4,Spring2019
4880,SE 46th & Woodstock,7565,N,NS,64,61,125,43,Spring2019
4881,NE 47th & Halsey,7571,N,FS,4,9,13,1,Spring2019
4882,SW 49th & Coronado,7577,S,NS,1,22,23,0,Spring2019
4883,SW 49th & Coronado,7578,N,NS,25,0,25,0,Spring2019
4884,SW 49th & Hidalgo,7579,N,FS,24,1,25,0,Spring2019
4885,SW 5th & Alder,7586,S,NS,624,257,881,95,Spring2019
4886,SW 5th & Broadway,7588,S,NS,163,60,223,22,Spring2019
4887,SW 5th & Caruthers,7591,S,FS,38,30,68,4,Spring2019
4888,SW 5th & Columbia,7594,S,NS,395,223,618,86,Spring2019
4889,Union Station/NW 5th & Glisan MAX Stn,7601,S,NS,813,1066,1879,0,Spring2019
4890,SW 5th & Harrison,7602,S,NS,720,395,1115,78,Spring2019
4891,5th & High,7604,W,NS,9,5,14,11,Spring2019
4892,NE 5th & Hood,7605,W,NS,6,1,7,0,Spring2019
4893,PSU South/SW 5th & Jackson MAX Stn,7606,S,NS,474,1475,1949,0,Spring2019
4894,City Hall/SW 5th & Jefferson MAX Station,7608,S,NS,816,1335,2151,0,Spring2019
4895,5th & Jefferson,7609,E,NS,10,11,21,4,Spring2019
4896,5th & Jefferson,7610,W,NS,7,9,16,17,Spring2019
4897,SW 5th & Madison,7612,S,NS,601,327,928,126,Spring2019
4898,SW 5th & Main,7614,S,NS,574,211,785,56,Spring2019
4899,SW 5th & Market,7616,S,NS,353,311,664,47,Spring2019
4900,PSU Urban Center/SW 5th & Mill MAX Station,7618,S,FS,685,2359,3044,0,Spring2019
4901,5th & Monroe,7620,E,NS,15,20,35,3,Spring2019
4902,5th & Monroe,7621,W,NS,14,14,28,13,Spring2019
4903,SW 5th & Morrison,7625,S,NS,1120,489,1609,229,Spring2019
4904,SW 5th & Oak MAX Station,7627,S,NS,1004,1349,2353,1,Spring2019
4905,SW 5th & Pine,7631,S,OP,1274,1124,2398,434,Spring2019
4906,SW 5th & Salmon,7634,S,NS,521,252,773,126,Spring2019
4907,SW 5th & Harvey Milk (Stark),7636,S,NS,490,185,675,127,Spring2019
4908,SW 5th & Taylor,7640,S,NS,916,365,1281,197,Spring2019
4909,SW 5th & Washington,7642,S,NS,311,164,475,110,Spring2019
4910,5th & Washington (Oregon City),7643,E,NS,9,16,25,17,Spring2019
4911,Washington & 16th,7644,S,NS,0,6,6,2,Spring2019
4912,Pioneer Place/SW 5th Ave MAX Station,7646,S,NS,2739,2329,5068,2,Spring2019
4913,SE 50th & Clay,7651,S,NS,14,51,65,2,Spring2019
4914,SE 50th & Clinton,7653,S,NS,39,30,69,7,Spring2019
4915,SE 50th & Division,7654,N,NS,106,46,152,23,Spring2019
4916,SE 50th & Division,7655,S,NS,58,92,150,16,Spring2019
4917,SE 50th & Haig,7656,N,NS,92,49,141,19,Spring2019
4918,SE 50th & Hawthorne,7658,N,NS,58,23,81,2,Spring2019
4919,SE 50th & Lincoln,7659,N,NS,53,7,60,6,Spring2019
4920,SE 50th & Lincoln,7660,S,NS,12,41,53,4,Spring2019
4921,SE 50th & Tibbetts,7665,N,NS,21,8,29,1,Spring2019
4922,SE 50th & Kelly,7666,S,FS,2,18,20,1,Spring2019
4929,SW 51st & Custer,7667,N,NS,3,3,6,0,Spring2019
4930,SW 51st & Moss,7668,N,NS,0,0,0,6,Spring2019
4931,SE 52nd & Boise,7669,N,NS,11,4,15,2,Spring2019
4932,SE 52nd & Clinton,7672,N,FS,15,4,19,0,Spring2019
4933,SE 52nd & Clinton,7673,S,FS,28,10,38,1,Spring2019
4934,SE 52nd & Cooper,7675,N,FS,14,3,17,4,Spring2019
4935,SE 52nd & Cooper,7676,S,NS,5,13,18,3,Spring2019
4936,SE 52nd & Division,7678,N,NS,41,54,95,22,Spring2019
4937,SE 52nd & Division,7679,S,FS,72,45,117,11,Spring2019
4938,SE 52nd & Duke,7680,N,NS,13,3,16,2,Spring2019
4939,SE 52nd & Duke,7682,S,NS,4,12,16,1,Spring2019
4940,SE 52nd & Foster,7683,N,NS,19,52,71,11,Spring2019
4941,SE 52nd & Bush,7684,S,FS,49,33,82,15,Spring2019
4942,SE 52nd & Franklin,7685,N,FS,13,2,15,0,Spring2019
4943,SE 52nd & Franklin,7687,S,FS,6,15,21,0,Spring2019
4944,SE 52nd & Gladstone,7688,S,NS,8,15,23,13,Spring2019
4945,SE 52nd & Harold,7690,N,NS,13,22,35,0,Spring2019
4946,SE 52nd & Harold,7691,S,NS,8,7,15,0,Spring2019
4947,SE 52nd & Holgate,7692,N,NS,42,51,93,7,Spring2019
4948,SE 52nd & Holgate,7693,S,NS,50,48,98,20,Spring2019
4949,SE 52nd & Lincoln,7695,N,NS,21,6,27,0,Spring2019
4950,SE 52nd & Lincoln,7696,S,FS,12,18,30,3,Spring2019
4951,SW 52nd & Maplewood School,7698,N,AT,4,3,7,0,Spring2019
4952,SW 52nd & Nevada Ct,7700,N,NS,4,1,5,0,Spring2019
4953,SE 52nd & Ogden,7702,N,NS,17,5,22,1,Spring2019
4954,SE 52nd & Ogden,7703,S,FS,6,20,26,3,Spring2019
4955,SE 52nd & Powell,7704,N,NS,73,95,168,23,Spring2019
4956,SE 52nd & Powell,7706,S,FS,90,69,159,24,Spring2019
4957,SE 52nd & Reedway,7708,N,NS,6,4,10,1,Spring2019
4958,SE 52nd & Reedway,7709,S,NS,2,6,8,0,Spring2019
4959,SE 52nd & Schiller,7711,S,OP,4,9,13,1,Spring2019
4960,SE 52nd & Schiller,7713,N,NS,11,3,14,0,Spring2019
4961,SE 52nd & Steele,7714,N,NS,19,11,30,1,Spring2019
4962,SE 52nd & Steele,7716,S,FS,30,30,60,1,Spring2019
4963,SE 52nd & Carlton,7718,S,NS,80,90,170,42,Spring2019
4964,SE 52nd & Tolman,7719,N,NS,66,49,115,20,Spring2019
4965,SE 52nd & Woodstock,7721,N,FS,55,31,86,17,Spring2019
4966,SE 52nd & Taggart Ct,7722,N,NS,78,89,167,4,Spring2019
4967,SE 52nd & Woodward,7723,S,FS,73,75,148,3,Spring2019
4968,SW 55th & Texas,7728,N,NS,3,1,4,0,Spring2019
4969,SW 55th & Vermont,7729,N,NS,2,0,2,0,Spring2019
4970,NE 57th & Fremont,7732,N,NS,7,26,33,6,Spring2019
4971,NE 57th & Fremont,7733,S,FS,26,10,36,5,Spring2019
4972,NE 57th & Hancock,7734,N,NS,3,8,11,1,Spring2019
4973,NE 57th & Hancock,7735,S,NS,14,3,17,0,Spring2019
4974,NE 57th & Sandy,7737,N,FS,37,56,93,42,Spring2019
4975,NE 57th & Sandy,7738,S,NS,49,39,88,29,Spring2019
4982,NE 57th & Siskiyou,7740,N,NS,2,12,14,0,Spring2019
4983,NE 57th & Siskiyou,7741,S,NS,9,1,10,0,Spring2019
4984,NE 57th & Thompson,7743,N,FS,3,13,16,0,Spring2019
4985,NE 57th & Thompson,7744,S,NS,13,2,15,1,Spring2019
4986,29900 Block SE Eagle Creek Rd,7745,N,AT,2,0,2,0,Spring2019
4987,SW 6th & Alder,7747,N,NS,509,989,1498,293,Spring2019
4988,SW 6th & Broadway,7749,N,NS,15,64,79,17,Spring2019
4989,NE 6th & N Broadway,7750,W,NS,24,1,25,1,Spring2019
4990,SW 6th & W Burnside,7751,N,NS,631,757,1388,281,Spring2019
4991,SW 6th & Clay,7756,N,NS,144,298,442,63,Spring2019
4992,NW Broadway & Davis,7759,N,NS,103,90,193,60,Spring2019
4993,Union Station/NW 6th & Hoyt MAX Stn,7763,N,AT,977,956,1933,0,Spring2019
4994,SW 6th & Jefferson,7765,N,NS,217,461,678,77,Spring2019
4995,SW 6th & Main,7767,N,NS,293,492,785,149,Spring2019
4996,NE 6th & Main,7770,E,NS,1,21,22,2,Spring2019
4997,SW 6th & Market,7772,N,NS,417,658,1075,100,Spring2019
4998,SW 6th & Mill,7773,N,NS,322,582,904,149,Spring2019
4999,PSU Urban Center/SW 6th & Montgomery MAX Stn,7774,N,OP,2111,584,2695,0,Spring2019
5000,Pioneer Courthouse/SW 6th Ave MAX Stn,7777,N,NS,2257,2510,4767,0,Spring2019
5001,SW 6th & Oak,7782,N,NS,263,415,678,88,Spring2019
5002,SW 6th & Pine MAX Station,7787,N,OP,1402,925,2327,0,Spring2019
5003,SW 6th & Salmon,7789,N,NS,207,593,800,68,Spring2019
5004,SW 6th & Sheridan,7793,N,FS,45,45,90,21,Spring2019
5005,SW 6th & Sheridan,7794,S,OP,40,54,94,19,Spring2019
5006,SW 6th & Harvey Milk (Stark),7797,N,NS,181,296,477,78,Spring2019
5007,SW 6th & Taylor,7800,N,NS,270,638,908,145,Spring2019
5008,SW 6th & Washington,7803,N,NS,278,427,705,59,Spring2019
5009,SW 6th & Yamhill,7807,N,NS,508,881,1389,182,Spring2019
5010,SE 60th & Belmont,7812,N,FS,41,70,111,19,Spring2019
5011,SE 60th & Belmont,7813,S,NS,58,50,108,15,Spring2019
5012,SE 60th & E Burnside,7814,S,FS,97,42,139,8,Spring2019
5013,SE 60th & E Burnside,7815,N,NS,40,93,133,19,Spring2019
5014,NE 60th & Everett,7816,N,OP,3,6,9,1,Spring2019
5015,NE 60th & Everett,7817,S,NS,14,2,16,1,Spring2019
5016,NE 60th & Glisan,7818,N,NS,18,48,66,29,Spring2019
5017,NE 60th & Glisan,7819,S,NS,57,20,77,29,Spring2019
5018,NE 60th & Halsey,7820,N,NS,14,36,50,22,Spring2019
5019,NE 60th & Hassalo,7821,N,FS,3,6,9,0,Spring2019
5020,SE 60th & Hawthorne,7823,N,OP,7,7,14,0,Spring2019
5021,SE 60th & Hawthorne,7824,S,NS,7,9,16,0,Spring2019
5022,NE 60th & 60th Ave MAX Stn/I-84,7827,N,AT,144,219,363,53,Spring2019
5023,NE 60th & 60th Ave MAX Stn/I-84,7828,S,AT,211,151,362,53,Spring2019
5024,SE 60th & Salmon,7830,N,NS,3,6,9,0,Spring2019
5025,SE 60th & Salmon,7831,S,OP,4,7,11,0,Spring2019
5026,SE 60th & Stark,7832,N,NS,9,12,21,0,Spring2019
5027,SE 60th & Stark,7833,S,NS,10,10,20,0,Spring2019
5028,SE 60th & Stephens,7835,S,OP,3,16,19,1,Spring2019
5035,NE 60th & Wasco,7837,S,NS,23,3,26,4,Spring2019
5036,SW 65th & Borland,7839,N,NS,0,23,23,1,Spring2019
5037,SW 68th & Baylor,7844,N,NS,1,2,3,0,Spring2019
5038,SW 68th & Clinton,7846,S,FS,3,2,5,0,Spring2019
5039,SW 68th & Franklin,7847,N,NS,6,18,24,8,Spring2019
5040,SW 68th & Franklin,7848,S,NS,5,6,11,1,Spring2019
5041,SW 68th & Freeway Entrance/Dartmouth,7849,N,FS,1,5,6,0,Spring2019
5042,SE 69th & Yamhill,7853,S,NS,4,33,37,0,Spring2019
5043,SE 7th & Clay,7855,S,NS,29,26,55,6,Spring2019
5044,SE 7th & Clay,7856,N,FS,16,37,53,8,Spring2019
5045,SE 7th & Grant,7857,S,NS,5,7,12,1,Spring2019
5046,SE 7th & Grant,7858,N,FS,9,13,22,1,Spring2019
5047,SE 7th & Harrison,7859,S,FS,41,57,98,15,Spring2019
5048,SE 7th & Harrison,7860,N,FS,43,34,77,7,Spring2019
5049,16500 Block SW 72nd,7865,N,OP,1,0,1,0,Spring2019
5050,16500 Block SW 72nd,7866,S,AT,0,2,2,0,Spring2019
5051,SW 72nd & Bonita,7867,N,NS,2,1,3,0,Spring2019
5052,SW 72nd & Bonita,7868,S,NS,2,2,4,0,Spring2019
5053,SE 72nd & Luther,7874,S,OP,16,14,30,11,Spring2019
5054,SE 72nd & Flavel,7875,S,FS,15,53,68,21,Spring2019
5055,SW 72nd & Hunziker,7876,S,FS,10,11,21,14,Spring2019
5056,SW 72nd & Kable,7877,N,OP,1,1,2,0,Spring2019
5057,SW 72nd & Kable,7878,S,FS,1,3,4,0,Spring2019
5058,Tualatin Park & Ride,7879,N,AT,276,80,356,13,Spring2019
5059,Tualatin Park & Ride,7880,S,AT,42,225,267,10,Spring2019
5060,SE 72nd & Lexington,7881,N,FS,35,8,43,11,Spring2019
5061,SE 72nd & Lexington,7882,S,NS,8,31,39,9,Spring2019
5062,SW 72nd & Cardinal,7885,N,NS,3,3,6,0,Spring2019
5063,SW 72nd & Sandburg,7887,N,NS,1,0,1,0,Spring2019
5064,SE 72nd & Tenino,7891,N,NS,20,7,27,2,Spring2019
5065,SE 72nd & Tenino,7892,S,FS,6,22,28,8,Spring2019
5066,SW 72nd & Upper Boones Ferry,7893,N,NS,35,9,44,0,Spring2019
5067,SW 72nd & Varns,7894,N,FS,9,4,13,0,Spring2019
5068,14100 Block SW 72nd,7895,N,AT,1,0,1,0,Spring2019
5069,14100 Block SW 72nd,7896,S,OP,0,1,1,0,Spring2019
5070,SE 76th & Washington,7897,N,NS,7,37,44,2,Spring2019
5071,SE 76th & Washington,7898,S,NS,29,7,36,2,Spring2019
5072,SE 76th & Yamhill,7899,S,NS,50,8,58,5,Spring2019
5073,SW 78th & Beaverton-Hillsdale Hwy,7900,S,NS,0,0,0,0,Spring2019
5074,SW 78th & Westmoor,7901,S,NS,0,0,0,0,Spring2019
5075,SW 80th & Birch,7904,S,OP,1,1,2,0,Spring2019
5076,SW 80th & Birch,7905,N,FS,0,0,0,0,Spring2019
5077,SW 80th & Cedarcrest,7906,S,FS,1,1,2,10,Spring2019
5078,SW 80th & Cedarcrest,7907,N,NS,1,1,2,4,Spring2019
5079,SW 80th & Elmwood,7910,S,NS,0,0,0,0,Spring2019
5080,SW 80th & Elmwood,7911,N,NS,0,0,0,0,Spring2019
5081,SW 80th & Landau,7912,S,OP,0,0,0,0,Spring2019
5088,SW 80th & Landau,7913,N,NS,0,0,0,0,Spring2019
5089,SW 80th & Locust,7914,S,NS,1,1,2,0,Spring2019
5090,SW 80th & Taylors Ferry,7915,N,NS,2,0,2,0,Spring2019
5091,NE 81st & Clackamas,7916,N,OP,8,5,13,4,Spring2019
5092,SE 82nd & King,7918,N,FS,183,34,217,53,Spring2019
5093,SE 82nd & Boyer Drive,7920,N,NS,236,92,328,147,Spring2019
5094,SE 82nd & Boyer Drive,7921,S,OP,48,160,208,91,Spring2019
5095,2200 Block SE 82nd,7923,S,OP,26,114,140,10,Spring2019
5096,NE 82nd & Alberta,7927,N,NS,18,41,59,5,Spring2019
5097,SE 82nd & Washington,7928,N,NS,43,82,125,39,Spring2019
5098,SE 82nd & Alder,7929,S,NS,39,24,63,15,Spring2019
5099,SE 82nd & Ash,7930,N,NS,13,14,27,5,Spring2019
5100,SE 82nd & Ash,7931,S,FS,16,20,36,6,Spring2019
5101,NE 82nd & Pacific,7932,S,FS,28,19,47,12,Spring2019
5102,NE 82nd & Beech,7933,N,NS,14,48,62,22,Spring2019
5103,NE 82nd & Beech,7934,S,NS,31,17,48,17,Spring2019
5104,SE 82nd & Boise,7935,N,FS,163,51,214,71,Spring2019
5105,SE 82nd & E Burnside,7936,N,NS,150,250,400,87,Spring2019
5106,NE 82nd & E Burnside,7937,S,NS,264,153,417,91,Spring2019
5107,SE 82nd & Causey,7941,N,NS,186,46,232,44,Spring2019
5108,SE 82nd & Causey,7942,S,NS,36,154,190,40,Spring2019
5109,SE 82nd & Francis,7943,N,NS,126,42,168,40,Spring2019
5110,SE 82nd & Clatsop,7945,S,OP,9,20,29,3,Spring2019
5111,SE 82nd & Clatsop,7946,N,NS,19,13,32,5,Spring2019
5112,SE 82nd & Clinton,7947,N,NS,32,39,71,9,Spring2019
5113,SE 82nd & Clinton,7948,S,NS,25,17,42,4,Spring2019
5114,SE 82nd & Cooper,7950,S,NS,10,41,51,21,Spring2019
5115,SE 82nd & Cornwell,7951,N,NS,19,9,28,9,Spring2019
5116,SE 82nd & Cornwell,7952,S,FS,17,42,59,30,Spring2019
5117,SE 82nd & Crystal Springs,7953,N,NS,62,28,90,38,Spring2019
5118,SE 82nd & Crystal Springs,7954,S,FS,29,59,88,33,Spring2019
5119,NE 82nd & Davis,7955,N,NS,17,21,38,5,Spring2019
5120,NE 82nd & Davis,7956,S,OP,22,20,42,5,Spring2019
5121,SE 82nd & Division,7957,N,FS,365,366,731,98,Spring2019
5122,SE 82nd & Division,7958,S,NS,375,310,685,95,Spring2019
5123,SE 82nd & Duke,7960,N,NS,157,50,207,74,Spring2019
5124,SE 82nd & Duke,7961,S,FS,63,149,212,52,Spring2019
5125,SE 82nd & Flavel,7962,N,FS,110,65,175,61,Spring2019
5126,SE 82nd & Flavel,7963,S,NS,51,121,172,41,Spring2019
5127,SE 82nd & Foster,7964,N,FS,328,160,488,90,Spring2019
5128,SE 82nd & Insley,7965,S,OP,115,285,400,75,Spring2019
5129,NE 82nd & Fremont,7966,S,NS,125,39,164,39,Spring2019
5130,NE 82nd & Fremont,7967,N,NS,51,117,168,34,Spring2019
5131,SE 82nd & Glenwood,7970,N,NS,28,12,40,21,Spring2019
5132,NE 82nd & Glisan,7972,N,FS,98,119,217,62,Spring2019
5133,NE 82nd & Glisan,7973,S,NS,129,96,225,61,Spring2019
5134,SE 82nd & Harmony,7975,S,FS,18,4,22,5,Spring2019
5141,NE 82nd & Hassalo,7978,S,OP,39,27,66,11,Spring2019
5142,SE 82nd & Hawthorne,7979,N,NS,30,22,52,5,Spring2019
5143,SE 82nd & Hawthorne,7980,S,NS,22,20,42,4,Spring2019
5144,SE 82nd & Ogden,7982,N,OP,82,27,109,32,Spring2019
5145,SE 82nd & Holgate,7984,N,FS,311,231,542,182,Spring2019
5146,SE 82nd & Holgate,7986,S,NS,239,269,508,162,Spring2019
5147,NE 82nd & Holladay,7987,N,NS,15,17,32,7,Spring2019
5148,SE 82nd & Johnson Creek,7988,S,FS,36,45,81,37,Spring2019
5149,SE 82nd & King,7990,S,FS,45,367,412,108,Spring2019
5150,NE 82nd & Klickitat,7991,N,NS,10,52,62,8,Spring2019
5151,NE 82nd & Klickitat,7992,S,NS,65,20,85,11,Spring2019
5152,SE 82nd & Lambert,7993,N,FS,37,22,59,32,Spring2019
5153,SE 82nd & Lambert,7994,S,NS,21,35,56,50,Spring2019
5154,SE 82nd & Lindy,7995,N,NS,162,85,247,121,Spring2019
5155,SE 82nd & Lindy,7996,S,FS,67,120,187,82,Spring2019
5156,NE 82nd & 82nd Ave MAX Stn/I-84,7999,N,AT,944,837,1781,261,Spring2019
5157,NE 82nd & 82nd Ave MAX Stn/I-84,8000,S,AT,686,641,1327,176,Spring2019
5158,NE 82nd & Madison HS,8001,N,OP,115,215,330,14,Spring2019
5159,NE 82nd & Madison HS,8002,S,AT,197,180,377,8,Spring2019
5160,SE 82nd & Main,8004,S,NS,12,15,27,3,Spring2019
5161,SE 82nd & McBride,8005,N,OP,4,15,19,6,Spring2019
5162,SE 82nd & McBride,8006,S,NS,18,6,24,4,Spring2019
5163,SE 82nd & Mill,8007,N,NS,50,34,84,9,Spring2019
5164,SE 82nd & Mill,8008,S,FS,38,66,104,5,Spring2019
5165,SE 82nd & Mitchell,8009,S,FS,11,26,37,11,Spring2019
5166,NE 82nd & Multnomah,8010,N,NS,25,31,56,9,Spring2019
5167,SE 82nd & Ogden,8013,S,NS,21,63,84,23,Spring2019
5168,NE 82nd & Oregon,8014,N,OP,7,8,15,3,Spring2019
5169,SE 82nd & Otty,8016,S,FS,52,91,143,63,Spring2019
5170,SE 82nd & Overland,8017,N,FS,80,62,142,48,Spring2019
5171,SE 82nd & Overland,8018,S,NS,34,47,81,15,Spring2019
5172,SE 82nd & Powell,8023,N,FS,373,328,701,135,Spring2019
5173,SE 82nd & Powell,8024,S,FS,339,364,703,125,Spring2019
5174,NE 82nd & Prescott,8025,S,FS,54,43,97,28,Spring2019
5175,NE 82nd & Prescott,8026,N,NS,41,53,94,12,Spring2019
5176,SE 82nd & Ramona,8027,N,OP,24,19,43,9,Spring2019
5177,SE 82nd & Ramona,8028,S,NS,49,37,86,20,Spring2019
5178,SE 82nd & Raymond Ct,8029,N,NS,71,32,103,40,Spring2019
5179,SE 82nd & Raymond,8030,S,NS,31,71,102,35,Spring2019
5180,SE 82nd & Rhone,8031,N,NS,25,21,46,6,Spring2019
5181,NE 82nd & Russell,8033,N,NS,42,29,71,18,Spring2019
5182,NE 82nd & Russell,8034,S,OP,46,12,58,16,Spring2019
5183,NE 82nd & Thompson,8035,S,FS,35,22,57,7,Spring2019
5184,NE 82nd & Sacramento,8036,N,NS,23,26,49,11,Spring2019
5185,SE 82nd & Salmon,8037,N,OP,15,13,28,2,Spring2019
5186,NE 82nd & Sandy,8038,S,NS,188,109,297,63,Spring2019
5187,NE 82nd & Sandy,8039,N,FS,117,205,322,58,Spring2019
5194,SE 82nd & Schiller,8040,N,NS,29,13,42,12,Spring2019
5195,SE 82nd & Schiller,8041,S,OP,5,13,18,4,Spring2019
5196,NE 82nd & Schuyler,8042,N,FS,15,11,26,6,Spring2019
5197,NE 82nd & Schuyler,8043,S,NS,16,9,25,4,Spring2019
5198,NE 82nd & Siskiyou,8045,S,NS,82,19,101,6,Spring2019
5199,NE 82nd & Siskiyou,8046,N,FS,25,48,73,10,Spring2019
5200,SE 82nd & Stark,8047,N,FS,72,105,177,48,Spring2019
5201,SE 82nd & Stark,8048,S,NS,140,124,264,61,Spring2019
5202,SE 82nd & Sunnyside,8049,N,FS,11,15,26,5,Spring2019
5203,SE 82nd & Sunnyside Dr,8050,S,NS,9,12,21,1,Spring2019
5204,SE 82nd & Tibbetts,8052,N,OP,47,23,70,8,Spring2019
5205,SE 82nd & Tibbetts,8053,S,NS,20,52,72,17,Spring2019
5206,NE 82nd & Tillamook,8055,N,NS,43,33,76,6,Spring2019
5207,NE 82nd & Tillamook,8056,S,NS,29,21,50,6,Spring2019
5208,SE 82nd & Tolman,8057,N,NS,21,11,32,2,Spring2019
5209,SE 82nd & Tolman,8058,S,NS,8,28,36,1,Spring2019
5210,SE 82nd & Woodstock,8059,N,NS,52,27,79,16,Spring2019
5211,SE 82nd & Woodstock,8060,S,NS,28,60,88,14,Spring2019
5212,SE 82nd & Woodward,8061,N,NS,64,47,111,12,Spring2019
5213,SE 82nd & Woodward,8062,S,FS,46,81,127,15,Spring2019
5214,NE 82nd & Wygant,8063,N,NS,5,24,29,11,Spring2019
5215,NE 82nd & Wygant,8064,S,NS,48,10,58,11,Spring2019
5216,SE 82nd & Yamhill,8065,N,NS,24,17,41,10,Spring2019
5217,SE 82nd & Yamhill,8066,S,FS,19,27,46,17,Spring2019
5218,SE 82nd Dr & Beaverlake Dr,8067,S,FS,5,13,18,5,Spring2019
5219,SE 82nd Dr & Scotts Tree Way,8070,N,OP,15,7,22,2,Spring2019
5220,SE 82nd Dr & Clackamas,8071,N,NS,6,1,7,0,Spring2019
5221,SE 82nd Dr & Greenhouse Square,8072,S,OP,28,41,69,17,Spring2019
5222,SE 82nd Dr & Greenhouse Square,8073,N,AT,34,24,58,12,Spring2019
5223,SE 82nd Dr & Enoch Ct,8074,N,NS,6,4,10,1,Spring2019
5224,SE 82nd Dr & Herbert Ct,8075,S,NS,4,8,12,1,Spring2019
5225,SE 82nd Dr & Jannsen,8076,N,FS,10,5,15,3,Spring2019
5226,SE 82nd Dr & Jannsen,8077,S,NS,8,16,24,2,Spring2019
5227,SE 82nd Dr & Manfield Ct,8078,S,FS,4,5,9,1,Spring2019
5228,15900 Block SE 82nd Dr,8079,N,AT,54,11,65,9,Spring2019
5229,SE 82nd Dr & Scotts Tree Way,8080,S,NS,8,15,23,3,Spring2019
5230,SE 82nd Dr & Tolbert,8082,S,FS,3,11,14,1,Spring2019
5231,SE 82nd Dr & Tolbert,8083,N,FS,14,4,18,3,Spring2019
5232,16700 Block SE 82nd Dr,8084,N,AT,12,6,18,2,Spring2019
5233,16700 Block SE 82nd Dr,8085,S,OP,10,6,16,1,Spring2019
5234,15900 Block SE 82nd Dr,8086,S,OP,15,48,63,6,Spring2019
5235,9th & Jackson,8092,E,NS,1,2,3,0,Spring2019
5236,9th & Jefferson,8093,E,NS,1,2,3,0,Spring2019
5237,9th & Jefferson,8094,W,NS,0,1,1,1,Spring2019
5238,9th & Main,8096,W,NS,4,7,11,1,Spring2019
5239,9th & Monroe,8097,S,NS,3,2,5,1,Spring2019
5240,9th & Monroe,8098,W,NS,1,1,2,1,Spring2019
5247,9th & Washington,8100,W,NS,2,3,5,3,Spring2019
5248,NW 90th & W Stark,8105,N,FS,0,1,1,0,Spring2019
5249,SW 90th & Taylor,8106,S,NS,2,0,2,0,Spring2019
5250,SW 90th & Washington,8108,S,FS,1,0,1,0,Spring2019
5251,NE 92nd & Russell,8114,S,FS,3,3,6,14,Spring2019
5252,NE 92nd & Russell,8115,N,OP,3,2,5,12,Spring2019
5253,NE 92nd & Sacramento,8116,N,NS,2,5,7,0,Spring2019
5254,NE 92nd & Schuyler,8118,S,NS,5,2,7,0,Spring2019
5255,NE 92nd & Schuyler,8119,N,OP,3,3,6,1,Spring2019
5256,NE 92nd & Thompson,8124,S,FS,10,5,15,0,Spring2019
5257,NE 92nd & Tillamook,8125,N,OP,4,5,9,0,Spring2019
5258,NE 92nd & Tillamook,8126,S,NS,2,2,4,0,Spring2019
5259,SE 97th & Foster,8134,N,NS,7,72,79,3,Spring2019
5260,NE 99th & Glisan,8140,N,FS,7,31,38,16,Spring2019
5261,NE 99th & Glisan,8141,S,NS,32,10,42,19,Spring2019
5262,NE 102nd & Knott,8149,N,NS,2,7,9,1,Spring2019
5263,SE International Way & 40th,8152,E,FS,5,7,12,1,Spring2019
5264,4400 Block SE International Way,8153,E,AT,5,4,9,1,Spring2019
5265,4900 Block SE International Way (Blount),8154,E,OP,5,5,10,0,Spring2019
5266,SE International Way & Mallard,8155,E,OP,2,4,6,0,Spring2019
5267,5600 Block SE International Way,8156,S,OP,1,3,4,0,Spring2019
5268,SE International Way & Mallard,8164,W,NS,3,3,6,0,Spring2019
5269,4900 Block SE International Way (Blount),8165,W,AT,7,3,10,0,Spring2019
5270,4500 Block SE International Way,8166,W,OP,3,4,7,2,Spring2019
5271,SE International Way & 40th,8167,W,OP,8,7,15,0,Spring2019
5272,SE 32nd & Johnson Creek,8168,N,NS,12,8,20,9,Spring2019
5273,Hillsboro Transit Center,8181,E,AT,458,183,641,110,Spring2019
5274,Gateway Transit Center,8190,S,AT,93,11,104,29,Spring2019
5275,Gateway TC (Drop off only stop),8194,N,AT,174,680,854,176,Spring2019
5276,Gresham Transit Center,8199,E,AT,2,220,222,9,Spring2019
5277,Lake Oswego Transit Center,8207,S,AT,130,68,198,17,Spring2019
5278,Lake Oswego Transit Center,8208,S,AT,95,166,261,80,Spring2019
5279,Tigard Transit Center,8209,S,AT,221,309,530,67,Spring2019
5280,Tigard Transit Center,8210,S,AT,63,67,130,11,Spring2019
5281,Tigard Transit Center,8211,S,AT,229,229,458,95,Spring2019
5282,Tigard Transit Center,8212,S,AT,148,90,238,37,Spring2019
5283,Barbur Transit Center,8213,E,AT,77,588,665,19,Spring2019
5284,SE Jackson & Main St,8223,W,NS,460,257,717,222,Spring2019
5285,SE Jackson & 21st,8225,E,NS,423,319,742,232,Spring2019
5286,SW Troy & 37th,8227,W,FS,0,0,0,0,Spring2019
5287,SW Hamilton & 54th Pl,8229,E,FS,0,0,0,0,Spring2019
5288,NW 158th & Schendel,8230,S,NS,30,16,46,3,Spring2019
5289,158th & Baseline,8231,S,FS,3,5,8,7,Spring2019
5290,SW 158th & W Baseline,8232,N,FS,5,5,10,1,Spring2019
5291,NW 158th & Schendel,8233,N,FS,15,19,34,2,Spring2019
5292,SW 158th & Jenkins,8234,N,NS,2,1,3,0,Spring2019
5293,SE 82nd & Boise,8237,S,NS,31,141,172,51,Spring2019
5300,SE 50th & Brooklyn,8241,S,FS,70,72,142,2,Spring2019
5301,SE 50th & Woodward,8242,N,FS,89,134,223,5,Spring2019
5302,SE Woodstock & 38th,8243,E,NS,1,12,13,1,Spring2019
5303,SW Martinazzi & Martinazzi Square,8249,N,OP,12,3,15,0,Spring2019
5304,SW Martinazzi & Tualatin-Sherwood,8250,N,FS,11,8,19,1,Spring2019
5305,SW Martinazzi & Martinazzi Square,8252,S,AT,4,10,14,1,Spring2019
5306,13300 Block SW Pacific Hwy,8260,E,AT,14,5,19,3,Spring2019
5307,SW Watson & Broadway,8262,S,NS,88,6,94,9,Spring2019
5308,SW Canyon & Red Robin,8265,W,AT,1,15,16,1,Spring2019
5309,SW Canyon & Watson,8270,E,NS,3,93,96,10,Spring2019
5310,SW Canyon & Broadway,8271,E,NS,18,3,21,8,Spring2019
5311,SW Canyon & Hall,8272,W,NS,43,3,46,4,Spring2019
5312,12900 Block SW Canyon,8273,W,AT,33,9,42,6,Spring2019
5313,SW Sagert & Tillamook,8276,W,OP,1,1,2,0,Spring2019
5314,SW Sagert & Tillamook,8278,E,FS,0,0,0,0,Spring2019
5315,SW 65th & Borland,8279,S,OP,8,0,8,0,Spring2019
5316,SW Sagert & 68th,8281,W,FS,39,1,40,0,Spring2019
5317,SW Sagert & 72nd,8282,W,NS,10,0,10,0,Spring2019
5318,7800 Block SW Sagert,8283,W,OP,4,1,5,0,Spring2019
5319,SW Sagert & Martinazzi,8284,W,FS,2,50,52,3,Spring2019
5320,SW Martinazzi & Mohawk,8285,N,NS,126,43,169,18,Spring2019
5321,SE 32nd & Van Water,8301,S,FS,2,4,6,0,Spring2019
5322,7500 Block NE 21st,8303,N,OP,0,12,12,1,Spring2019
5323,7500 Block NE 21st,8304,S,AT,11,0,11,1,Spring2019
5324,16400 Block SW Langer,8306,N,OP,9,1,10,0,Spring2019
5325,Washington & 16th,8309,N,OP,5,2,7,0,Spring2019
5326,S Holcomb & Front Ave,8310,E,OP,2,5,7,0,Spring2019
5327,S Holcomb & Hunter Ave,8311,E,NS,0,1,1,0,Spring2019
5328,Longview & Holcomb,8312,N,FS,2,5,7,0,Spring2019
5329,900 Block Abernethy,8313,W,OP,0,0,0,0,Spring2019
5330,SE Main & 3rd,8315,N,NS,6,0,6,1,Spring2019
5331,3900 Block SW Murray,8316,S,OP,1,9,10,0,Spring2019
5332,9800 Block NE Pacific St,8321,W,OP,0,77,77,23,Spring2019
5333,SE 32nd & Floss,8326,N,NS,6,5,11,1,Spring2019
5334,N Rosa Parks Way & Knowles,8329,W,NS,2,9,11,0,Spring2019
5335,Library/SW 9th Ave MAX Station,8333,E,AT,1284,1855,3139,0,Spring2019
5336,Pioneer Square South MAX Station,8334,E,AT,1956,3516,5472,0,Spring2019
5337,Mall/SW 4th Ave MAX Station,8335,E,AT,1101,1424,2525,0,Spring2019
5338,Yamhill District MAX Station,8336,E,AT,1228,1014,2242,0,Spring2019
5339,Oak/ SW 1st Ave MAX Station,8337,N,NS,637,490,1127,0,Spring2019
5340,Skidmore Fountain MAX Station,8338,N,AT,585,610,1195,0,Spring2019
5341,Old Town/Chinatown MAX Station,8339,N,AT,1018,638,1656,0,Spring2019
5342,Rose Quarter TC MAX Station,8340,E,AT,2560,1692,4252,0,Spring2019
5343,Convention Center MAX Station,8341,E,AT,829,830,1659,0,Spring2019
5344,NE 7th Ave MAX Station,8342,E,FS,1053,1080,2133,0,Spring2019
5345,Lloyd Center/NE 11th Ave MAX Station,8343,E,AT,1891,1882,3773,0,Spring2019
5346,Hollywood/NE 42nd Ave TC MAX Station,8344,E,AT,1038,1476,2514,0,Spring2019
5353,NE 60th Ave MAX Station,8345,E,AT,457,1122,1579,0,Spring2019
5354,NE 82nd Ave MAX Station,8346,E,AT,921,1378,2299,0,Spring2019
5355,Gateway/NE 99th Ave TC MAX Station,8347,S,AT,3793,3561,7354,0,Spring2019
5356,E 102nd Ave MAX Station,8348,E,FS,465,628,1093,0,Spring2019
5357,E 122nd Ave MAX Station,8349,E,FS,504,1167,1671,0,Spring2019
5358,E 148th Ave MAX Station,8350,E,FS,212,642,854,0,Spring2019
5359,E 162nd Ave MAX Station,8351,E,FS,316,1020,1336,0,Spring2019
5360,E 172nd Ave MAX Station,8352,E,FS,110,366,476,0,Spring2019
5361,E 181st Ave MAX Station,8353,E,FS,224,728,952,0,Spring2019
5362,Rockwood/E 188th Ave MAX Station,8354,E,NS,155,575,730,0,Spring2019
5363,Ruby Junction/E 197th Ave MAX Station,8355,E,FS,197,469,666,0,Spring2019
5364,Gresham City Hall MAX Station,8356,E,OP,66,533,599,0,Spring2019
5365,Gresham Central TC MAX Station,8357,E,AT,73,865,938,0,Spring2019
5366,Cleveland Ave MAX Station,8359,W,NS,1030,1083,2113,0,Spring2019
5367,Gresham Central TC MAX Station,8360,W,AT,871,90,961,0,Spring2019
5368,Gresham City Hall MAX Station,8361,W,AT,563,62,625,0,Spring2019
5369,Ruby Junction/E 197th Ave MAX Station,8362,W,FS,303,123,426,0,Spring2019
5370,Rockwood/E 188th Ave MAX Station,8363,W,FS,634,158,792,0,Spring2019
5371,E 181st Ave MAX Station,8364,W,FS,750,233,983,0,Spring2019
5372,E 172nd Ave MAX Station,8365,W,FS,339,107,446,0,Spring2019
5373,E 162nd Ave MAX Station,8366,W,FS,1041,358,1399,0,Spring2019
5374,E 148th Ave MAX Station,8367,W,FS,622,215,837,0,Spring2019
5375,E 122nd Ave MAX Station,8368,W,FS,1150,499,1649,0,Spring2019
5376,E 102nd Ave MAX Station,8369,W,FS,635,503,1138,0,Spring2019
5377,Gateway/NE 99th Ave TC MAX Station,8370,N,AT,3078,3620,6698,0,Spring2019
5378,NE 82nd Ave MAX Station,8371,W,AT,1383,859,2242,0,Spring2019
5379,NE 60th Ave MAX Station,8372,W,AT,1095,479,1574,0,Spring2019
5380,Hollywood/NE 42nd Ave TC MAX Station,8373,W,AT,1287,1034,2321,0,Spring2019
5381,Lloyd Center/NE 11th Ave MAX Station,8374,W,AT,1644,2168,3812,0,Spring2019
5382,NE 7th Ave MAX Station,8375,W,NS,1144,1493,2637,0,Spring2019
5383,Convention Center MAX Station,8376,W,AT,1424,743,2167,0,Spring2019
5384,Rose Quarter TC MAX Station,8377,W,AT,1899,2575,4474,0,Spring2019
5385,Old Town/Chinatown MAX Station,8378,S,AT,656,1212,1868,0,Spring2019
5386,Skidmore Fountain MAX Station,8379,S,AT,548,605,1153,0,Spring2019
5387,Oak/ SW 1st Ave MAX Station,8380,S,FS,591,629,1220,0,Spring2019
5388,Morrison/SW 3rd Ave MAX Station,8381,W,NS,1419,1243,2662,0,Spring2019
5389,Mall/SW 5th Ave MAX Station,8382,W,AT,1839,1683,3522,0,Spring2019
5390,Pioneer Square North MAX Station,8383,W,AT,3226,1250,4476,0,Spring2019
5391,Galleria/SW 10th Ave MAX Station,8384,W,AT,1553,1657,3210,0,Spring2019
5392,NW Vaughn & 26th,8385,E,NS,57,1,58,3,Spring2019
5393,SW Taylors Ferry & 76th Pl,8387,W,NS,0,0,0,0,Spring2019
5394,SW Taylors Ferry & 75th,8388,E,NS,2,0,2,0,Spring2019
5395,SW 95th & Commerce Circle,8389,N,NS,4,0,4,0,Spring2019
5396,9900 Block SW Commerce Circle,8391,S,AT,1,3,4,0,Spring2019
5397,NW Everett & Park,8402,E,NS,20,15,35,7,Spring2019
5398,NW St Helens & Newberry Rd,8403,S,NS,0,0,0,0,Spring2019
5399,SE Harold & 67th,8404,W,NS,27,2,29,1,Spring2019
5406,NW Evergreen Pkwy & Tanasbourne Terr,8406,W,OP,3,1,4,0,Spring2019
5407,NW Evergreen Pkwy & NE Amberglen (NW 194th),8408,E,FS,9,28,37,15,Spring2019
5408,NW Evergreen Pkwy & Tanasbourne Terr,8409,E,AT,3,6,9,1,Spring2019
5409,NW Vaughn & 26th,8414,W,NS,2,52,54,9,Spring2019
5410,3300 Block SW Dosch,8416,N,AT,0,0,0,0,Spring2019
5411,SE Hwy 224 & 232nd Dr,8420,W,NS,2,0,2,0,Spring2019
5412,SE Hwy 224 & 232nd Dr,8421,E,NS,0,2,2,0,Spring2019
5413,SE Harold & 64th,8422,W,NS,25,2,27,0,Spring2019
5414,16500 Block SE 82nd Dr,8430,N,OP,12,7,19,4,Spring2019
5415,Gillihan Rd & Sauvie Island,8437,N,AT,55,54,109,2,Spring2019
5416,NW St Helens & Harborton Dr,8438,S,NS,1,0,1,0,Spring2019
5417,NW St Helens & Larson,8439,S,OP,1,0,1,0,Spring2019
5418,S Holcomb & Front Ave,8441,W,NS,9,3,12,1,Spring2019
5419,SE Eagle Creek Rd & River Mill Rd,8442,S,NS,0,3,3,0,Spring2019
5420,SW Jenkins & Meridian,8443,W,FS,2,7,9,39,Spring2019
5421,Abernethy & Redland Rd,8446,W,FS,0,0,0,0,Spring2019
5422,Abernethy & Redland Rd,8447,E,NS,0,1,1,0,Spring2019
5423,8300 Block SE Causey,8448,E,AT,18,21,39,17,Spring2019
5424,SW Terwilliger & Cheltenham,8450,S,NS,0,1,1,0,Spring2019
5425,SW Dennis & Baseline,8452,N,NS,16,29,45,10,Spring2019
5426,SW US Veterans Rd & Bldg 16,8455,N,AT,73,95,168,12,Spring2019
5427,SE Bell & Sandview,8457,S,NS,13,48,61,33,Spring2019
5428,E Powell & NE Liberty,8461,W,NS,2,3,5,1,Spring2019
5429,SE Stark & SW 257th Dr,8464,W,FS,129,63,192,85,Spring2019
5430,NE 102nd & Thompson,8465,S,NS,2,1,3,4,Spring2019
5431,SE 90th & Monterey,8467,S,NS,2,8,10,15,Spring2019
5432,NE Shaver & Parkrose Middle School,8471,E,AT,3,33,36,0,Spring2019
5433,NW 158th & Blueridge,8474,S,FS,15,3,18,1,Spring2019
5434,NW 158th & Blueridge,8475,N,NS,5,22,27,1,Spring2019
5435,N Lombard & Baltimore,8480,N,NS,60,131,191,85,Spring2019
5436,NW Wardway & Montgomery Pk,8481,W,AT,2,42,44,2,Spring2019
5437,NW Nicolai & Wardway,8482,E,FS,3,32,35,2,Spring2019
5438,NW 27th & Vaughn at Montgomery Park,8484,S,NS,275,81,356,31,Spring2019
5439,SW Lombard & 2nd,8491,S,NS,16,11,27,8,Spring2019
5440,SE McLoughlin & Naef,8494,S,NS,13,40,53,3,Spring2019
5441,15700 Block SW 72nd,8495,N,AT,0,0,0,0,Spring2019
5442,5500 Block N Channel Ave (Shipyards),8496,E,AT,11,12,23,0,Spring2019
5443,NE Columbia Blvd & 24th,8498,W,OP,0,1,1,0,Spring2019
5444,NE Columbia Blvd & 29th,8499,E,NS,4,0,4,0,Spring2019
5445,NE Columbia Blvd & 27th,8500,E,NS,1,0,1,0,Spring2019
5446,NE Evergreen Pkwy & Cornelius Pass Rd,8505,E,NS,1,5,6,0,Spring2019
5447,SW Sagert & Martinazzi,8506,E,FS,2,20,22,5,Spring2019
5448,NE Columbia Blvd & 24th,8507,E,FS,1,0,1,0,Spring2019
5449,NE Columbia Blvd & 29th,8508,W,FS,0,11,11,1,Spring2019
5450,Jackson & 9th,8509,S,NS,2,0,2,0,Spring2019
5451,W Burnside & SW 20th,8511,E,NS,481,168,649,229,Spring2019
5452,E Burnside & NE 20th,8512,W,NS,79,41,120,21,Spring2019
5459,NE 11th & Holladay,8513,N,NS,69,231,300,37,Spring2019
5460,E Main & NE 14th,8514,E,OP,1,1,2,0,Spring2019
5461,E Main & NE 14th,8537,W,FS,1,1,2,0,Spring2019
5462,NE Evergreen Pkwy & NW Atkeson Ln,8539,E,NS,1,10,11,0,Spring2019
5463,NW Evergreen Pkwy & NE John Olsen,8540,W,FS,20,9,29,2,Spring2019
5464,NW Evergreen Pkwy & NE Aloclek Ct,8541,W,FS,13,4,17,0,Spring2019
5465,NE Century (NW 229th) & Butler,8542,S,NS,6,5,11,0,Spring2019
5466,NE Cornell & Century (NW 229th),8543,W,FS,7,13,20,4,Spring2019
5467,NE Cornell & Elam Young West,8545,W,OP,3,6,9,1,Spring2019
5468,3300 Block NE Cornell,8546,W,AT,5,6,11,0,Spring2019
5469,NE Cornell & 25th,8547,W,FS,14,25,39,5,Spring2019
5470,NE Cornell & Hillaire Dr,8548,W,NS,15,12,27,0,Spring2019
5471,NE Cornell & Arrington,8549,W,NS,22,11,33,1,Spring2019
5472,NE Cornell & Grant,8550,S,NS,8,4,12,3,Spring2019
5473,NE Cornell & Jackson,8551,S,NS,2,2,4,0,Spring2019
5474,SE 10th & E Main,8552,N,NS,17,2,19,4,Spring2019
5475,NE Cornell & Jackson,8553,N,OP,2,1,3,0,Spring2019
5476,NE Cornell & Grant,8554,N,NS,7,8,15,1,Spring2019
5477,NE Cornell & Arrington,8555,E,OP,9,21,30,0,Spring2019
5478,NE Cornell & Hillaire Dr,8556,E,FS,18,13,31,1,Spring2019
5479,NE 25th & Cornell,8557,N,FS,2,3,5,1,Spring2019
5480,NE Cornell & 34th,8558,E,NS,4,4,8,0,Spring2019
5481,NE Cornell & Elam Young West,8559,E,FS,5,4,9,0,Spring2019
5482,NE Cornell & Century (NW 231st),8561,E,FS,8,7,15,2,Spring2019
5483,NW Evergreen Pkwy & NE Aloclek Dr,8562,E,FS,4,19,23,0,Spring2019
5484,NW Evergreen Pkwy & NE John Olsen,8563,E,NS,9,19,28,5,Spring2019
5485,NE 148th & Sacramento,8564,N,NS,1,2,3,0,Spring2019
5486,NE 148th & Fremont,8567,N,NS,4,3,7,5,Spring2019
5487,NE Sandy & 152nd,8569,E,FS,5,16,21,4,Spring2019
5488,NE Sandy & 158th,8570,E,NS,14,33,47,2,Spring2019
5489,NE Sandy & 162nd,8571,E,NS,49,39,88,36,Spring2019
5490,NE Sandy & 165th,8572,E,FS,5,11,16,1,Spring2019
5491,NE 181st & Halsey,8580,S,NS,36,11,47,24,Spring2019
5492,NE 181st & Halsey,8581,N,NS,12,39,51,16,Spring2019
5493,NE 181st & San Rafael,8582,N,NS,2,9,11,2,Spring2019
5494,NE Sandy & 165th,8584,W,FS,11,3,14,1,Spring2019
5495,NE Sandy & 162nd,8585,W,OP,24,14,38,4,Spring2019
5496,NE Sandy & 152nd,8587,W,OP,15,4,19,3,Spring2019
5497,NE 148th & 147th,8589,S,FS,1,0,1,0,Spring2019
5498,NE 148th & Sacramento,8592,S,OP,2,0,2,0,Spring2019
5499,SW 257th & Hensley Rd,8595,S,FS,4,1,5,0,Spring2019
5500,SW 257th & 28th,8597,S,FS,1,4,5,1,Spring2019
5501,SW 257th & SE Stark,8598,N,FS,20,12,32,6,Spring2019
5502,SW 257th & 28th,8599,N,OP,1,1,2,0,Spring2019
5503,SW 185th & Alexander,8603,S,NS,10,94,104,16,Spring2019
5504,SW Murray & Allen,8604,S,FS,51,81,132,17,Spring2019
5505,SW Murray & Davis,8605,S,NS,5,6,11,6,Spring2019
5512,SW Murray & Kilchis,8606,S,FS,1,2,3,0,Spring2019
5513,SW Murray & Hart,8607,S,FS,15,8,23,0,Spring2019
5514,SW Murray & Sexton Mtn Dr,8608,S,FS,4,9,13,0,Spring2019
5515,SW Murray & Maverick Terr,8609,S,FS,8,27,35,14,Spring2019
5516,SW Murray & Beard,8610,S,FS,11,29,40,4,Spring2019
5517,SW Murray & Weir Rd,8611,S,FS,6,15,21,4,Spring2019
5518,SW Murray & Osprey Dr,8612,S,NS,17,62,79,3,Spring2019
5519,SW Murray & Teal Blvd,8613,S,NS,19,47,66,0,Spring2019
5520,SW Scholls Ferry & 135th,8614,E,NS,24,21,45,0,Spring2019
5521,SW Scholls Ferry & 130th,8615,E,FS,3,12,15,1,Spring2019
5522,SW Scholls Ferry & North Dakota,8616,E,NS,18,48,66,7,Spring2019
5523,SW Scholls Ferry & 121st,8617,E,FS,36,28,64,10,Spring2019
5524,SW Scholls Ferry & Murray,8618,E,FS,42,47,89,4,Spring2019
5525,SW Scholls Ferry & Boones Bend Dr,8619,W,FS,28,23,51,1,Spring2019
5526,SW Scholls Ferry & 125th,8620,W,FS,47,21,68,14,Spring2019
5527,SW Scholls Ferry & 130th,8621,W,FS,10,6,16,1,Spring2019
5528,SW Scholls Ferry & 135th,8622,W,FS,25,20,45,1,Spring2019
5529,SW Murray & Teal Blvd,8625,N,NS,31,18,49,2,Spring2019
5530,SW Murray & Osprey Dr,8626,N,FS,55,18,73,3,Spring2019
5531,SW Murray & Weir Rd,8627,N,OP,17,4,21,1,Spring2019
5532,SW Brockman & Stallion,8628,E,NS,5,0,5,0,Spring2019
5533,SW Murray & Maverick Terr,8629,N,FS,17,10,27,13,Spring2019
5534,SW Murray & Sexton Mtn Dr,8630,N,FS,9,3,12,0,Spring2019
5535,SW Murray & Hargis,8631,N,NS,2,1,3,0,Spring2019
5536,SW Murray & Hart,8632,N,FS,14,18,32,1,Spring2019
5537,SW Murray & Barlow,8633,N,NS,5,2,7,0,Spring2019
5538,SW Murray & 22nd,8634,N,FS,8,6,14,2,Spring2019
5539,SW Murray & Allen,8635,N,NS,52,49,101,8,Spring2019
5540,SW Murray & Hargis,8636,S,FS,0,1,1,0,Spring2019
5541,NE Century (NW 229th) & Cornell,8643,N,FS,7,3,10,2,Spring2019
5542,SW Pacific Hwy & Durham,8644,S,NS,21,75,96,24,Spring2019
5543,20500 Block NW Evergreen Pkwy,8646,W,OP,6,4,10,0,Spring2019
5544,20500 Block NW Evergreen Pkwy,8647,E,AT,2,7,9,0,Spring2019
5545,NE Evergreen Pkwy & NW Atkeson Ln,8648,W,OP,10,0,10,0,Spring2019
5546,NE Cornell & Orenco Station Pkwy,8649,E,NS,19,9,28,2,Spring2019
5547,NE Cornell & Orenco Station Pkwy,8650,W,FS,10,22,32,4,Spring2019
5548,NW St Helens & Riverview Drive,8654,S,NS,1,0,1,0,Spring2019
5549,SE 90th & Monterey,8659,N,FS,8,4,12,16,Spring2019
5550,SW Pacific Hwy & Home Street Bank,8663,N,AT,13,8,21,7,Spring2019
5551,SE Harold & Foster,8664,E,NS,40,45,85,14,Spring2019
5552,SW Scholls Ferry & Davies,8665,E,FS,12,8,20,0,Spring2019
5553,SW Talbot & Talbot Terrace,8672,S,NS,0,1,1,0,Spring2019
5554,SW Scholls Ferry & Davies,8673,W,FS,13,9,22,0,Spring2019
5555,SE 90th & Causey,8677,N,NS,20,10,30,25,Spring2019
5556,SE 45th & Lexington,8678,S,NS,0,11,11,0,Spring2019
5557,29600 Block SE Eagle Creek Rd,8685,S,AT,0,0,0,0,Spring2019
5558,NE 181st & San Rafael,8714,S,NS,4,1,5,1,Spring2019
5565,21700 Block SE Hwy 224,8720,E,AT,0,2,2,0,Spring2019
5566,21700 Block SE Hwy 224,8721,W,OP,1,0,1,0,Spring2019
5567,600 Block NW Wade,8722,N,AT,0,0,0,0,Spring2019
5568,800 Block NW Wade (at Library),8723,S,AT,1,8,9,2,Spring2019
5569,12700 Block SE McLoughlin,8726,N,AT,8,8,16,1,Spring2019
5570,NE 27th & Highland,8727,N,FS,0,14,14,6,Spring2019
5571,SW Pacific Hwy & Royalty Parkway,8728,S,FS,8,55,63,21,Spring2019
5572,5th & Washington (Oregon City),8732,W,NS,10,11,21,32,Spring2019
5573,20000 Block SE Hwy 224,8735,W,AT,0,0,0,0,Spring2019
5574,17300 Block SE Hwy 224,8736,W,OP,0,0,0,0,Spring2019
5575,17400 Block SE Hwy 224,8737,E,AT,0,0,0,0,Spring2019
5576,NE Vancouver Way & 3rd,8740,S,NS,2,1,3,0,Spring2019
5577,2700 Block W Powell,8742,E,AT,57,89,146,42,Spring2019
5578,2700 Block W Powell,8743,W,OP,94,49,143,47,Spring2019
5579,NW St Helens & Harborton Dr,8744,N,NS,0,0,0,0,Spring2019
5580,E Burnside & NE 97th,8745,W,NS,10,16,26,2,Spring2019
5581,W Columbia River Hwy & NW Graham,8746,W,FS,52,3,55,4,Spring2019
5582,20000 Block SE Hwy 224,8755,S,AT,0,0,0,0,Spring2019
5583,Oregon City Transit Center,8758,N,AT,281,178,459,102,Spring2019
5584,Oregon City Transit Center,8759,N,AT,67,112,179,19,Spring2019
5585,Oregon City Transit Center,8760,S,AT,243,243,486,66,Spring2019
5586,Oregon City Transit Center,8761,S,AT,281,268,549,138,Spring2019
5587,Oregon City Transit Center,8762,W,AT,214,197,411,37,Spring2019
5588,Webster & Cason,8763,N,NS,5,1,6,4,Spring2019
5589,17100 Block SE Webster,8764,N,AT,0,3,3,0,Spring2019
5590,SW Naito Parkway & Sheridan,8770,S,NS,36,3,39,1,Spring2019
5591,SE Kane & Powell Valley,8776,S,NS,16,5,21,0,Spring2019
5592,NW Bethany & Bronson,8779,S,NS,16,5,21,0,Spring2019
5593,SW Sagert & 86th,8788,W,OP,2,6,8,0,Spring2019
5594,SW Pacific Hwy & Durham,8792,N,FS,56,11,67,14,Spring2019
5595,SE Hwy 224 & Tong,8794,E,OP,0,0,0,0,Spring2019
5596,17700 Block SE Hwy 224,8795,W,AT,0,0,0,0,Spring2019
5597,SW Barnes & Barnes,8798,W,FS,3,18,21,0,Spring2019
5598,W Burnside & SW Barnes,8799,E,NS,20,3,23,1,Spring2019
5599,4100 Block SE 182nd,8800,S,AT,0,21,21,3,Spring2019
5600,NW Vaughn & 27th,8802,W,NS,5,106,111,11,Spring2019
5601,2400 Block NW 29th,8808,N,AT,1,11,12,3,Spring2019
5602,2500 Block NW 29th,8809,S,OP,2,0,2,2,Spring2019
5603,4700 Block W Powell,8812,E,OP,17,35,52,26,Spring2019
5604,N Rosa Parks Way & Albina,8814,W,NS,15,18,33,10,Spring2019
5605,SE McLoughlin & Meldrum,8819,N,FS,12,5,17,7,Spring2019
5606,SW Council Crest & Tualatin (north leg),8821,N,NS,2,0,2,0,Spring2019
5607,SE Hwy 224 & Glover Rd,8823,S,FS,0,0,0,0,Spring2019
5608,SE Hwy 224 & Hwy 211,8824,N,AT,3,2,5,1,Spring2019
5609,19800 Block NE Halsey,8825,W,OP,9,3,12,0,Spring2019
5610,13000 Block NW Cornell,8828,E,AT,8,6,14,0,Spring2019
5611,SE Hwy 224 & 135th,8830,W,NS,14,3,17,0,Spring2019
5618,SW Greenburg & Lehman,8832,S,OP,3,5,8,1,Spring2019
5619,SW Greenburg & Lehman,8835,N,NS,5,7,12,1,Spring2019
5620,NE Main & 3rd,8837,S,NS,0,3,3,0,Spring2019
5621,NE Main & 3rd,8838,N,FS,2,1,3,0,Spring2019
5622,NW Springville & 178th,8839,E,FS,0,9,9,0,Spring2019
5623,SE 122nd & Powell,8843,S,NS,15,230,245,55,Spring2019
5624,SE Harold & 101st,8844,W,NS,22,1,23,0,Spring2019
5625,SW Park Way & 135th,8845,E,OP,0,1,1,0,Spring2019
5626,NW Springville & 181st,8850,E,NS,2,6,8,1,Spring2019
5627,SE Stark & NE Kelly,8851,W,OP,3,2,5,0,Spring2019
5628,NW Springville & 181st,8852,W,FS,6,1,7,0,Spring2019
5629,2500 Block NE Riverside Way,8854,E,AT,0,6,6,0,Spring2019
5630,800 Block NW Wade,8857,N,AT,6,1,7,2,Spring2019
5631,NE Halsey & 181st,8860,W,FS,73,57,130,17,Spring2019
5632,NW Front & Kittridge,8875,E,FS,5,5,10,0,Spring2019
5633,4500 Block NW Front,8877,E,OP,3,1,4,0,Spring2019
5634,4300 Block NW Front,8878,E,OP,4,1,5,0,Spring2019
5635,3600 Block NW Front,8879,E,OP,15,3,18,0,Spring2019
5636,W Burnside & NW Maywood Dr,8880,W,NS,0,3,3,0,Spring2019
5637,W Burnside & NW Maywood Dr,8881,E,OP,2,0,2,0,Spring2019
5638,NE 21st & Riverside Way,8883,N,NS,0,6,6,0,Spring2019
5639,NW 185th & Tanasbourne Rd,8884,N,FS,34,159,193,38,Spring2019
5640,NW Everett & 5th,8886,E,NS,472,362,834,182,Spring2019
5641,SW Garden Home & Capitol Hwy,8888,E,NS,1,5,6,0,Spring2019
5642,NE 82nd & Webster,8889,S,OP,18,12,30,3,Spring2019
5643,24300 Block SW Boones Ferry Rd,8891,S,AT,0,1,1,0,Spring2019
5644,24300 Block SW Boones Ferry Rd,8892,N,AT,1,0,1,0,Spring2019
5645,SE 32nd & Meek,8894,N,OP,40,12,52,19,Spring2019
5646,Division & Warren St,8899,W,OP,1,2,3,1,Spring2019
5647,7th & Taylor,8900,W,NS,1,1,2,0,Spring2019
5648,4200 Block NW Front,8901,E,OP,3,0,3,0,Spring2019
5649,4200 Block NW Front,8902,W,AT,0,5,5,0,Spring2019
5650,3800 Block NW Front,8903,E,OP,0,0,0,0,Spring2019
5651,3800 Block NW Front,8904,W,AT,0,0,0,0,Spring2019
5652,NE 122nd & Fremont,8907,N,FS,9,38,47,1,Spring2019
5653,SW 40th & Garden Home,8911,S,NS,5,1,6,0,Spring2019
5654,SE 96th & Mall 205,8912,S,OP,10,35,45,14,Spring2019
5655,SE Main & 96th,8913,E,FS,23,13,36,11,Spring2019
5656,10000 Block SE Main,8914,E,AT,19,17,36,36,Spring2019
5657,10500 Block SE Cherry Blossom,8915,W,AT,12,7,19,14,Spring2019
5658,10200 Block SE Main,8917,W,AT,23,22,45,28,Spring2019
5659,SE 96th & Main,8918,N,FS,32,42,74,23,Spring2019
5660,SE 96th & Mall 205 Dr,8919,N,NS,26,13,39,20,Spring2019
5661,SW Walker & Butner,8920,W,NS,3,2,5,0,Spring2019
5662,SW Walker & Meadow Dr,8921,W,NS,1,2,3,0,Spring2019
5663,SW Walker & 150th,8922,W,NS,2,4,6,0,Spring2019
5664,SW Walker & Greystone Ct,8923,W,OP,1,0,1,0,Spring2019
5671,SW Walker & 158th,8924,E,NS,3,2,5,0,Spring2019
5672,SW Walker & Greystone Ct,8925,E,FS,0,0,0,0,Spring2019
5673,SW Walker & Koll Parkway,8926,E,NS,3,1,4,0,Spring2019
5674,SW Walker & Meadow Dr,8927,E,NS,2,1,3,0,Spring2019
5675,SW Walker & Murray,8928,E,NS,2,3,5,0,Spring2019
5676,SE Washington & 99th,8935,E,NS,6,32,38,12,Spring2019
5677,SE 99th & Washington,8936,N,NS,19,5,24,5,Spring2019
5678,NE Holladay & 11th,8937,E,NS,209,32,241,49,Spring2019
5679,NE 11th & Multnomah,8938,N,NS,23,93,116,28,Spring2019
5680,SE 122nd & Midland Library,8940,N,OP,27,52,79,30,Spring2019
5681,19500 Block SW 65th,8944,S,AT,36,0,36,0,Spring2019
5682,SE Powell Valley & Greenway,8945,W,FS,0,0,0,0,Spring2019
5683,SE Powell Valley & Greenway,8946,E,OP,0,0,0,0,Spring2019
5684,28400 Block SE Hwy 224,8947,N,AT,0,0,0,0,Spring2019
5685,28400 Block SE Hwy 224,8948,E,OP,0,1,1,1,Spring2019
5686,SE Division & 96th,8949,E,NS,10,27,37,5,Spring2019
5687,SW Canyon & Watson,8950,W,NS,17,4,21,4,Spring2019
5688,SW 49th & PCC Entrance,8951,S,NS,1,34,35,1,Spring2019
5689,20200 Block SW Pacific Hwy,8954,E,AT,3,0,3,1,Spring2019
5690,I-5 Off Ramp & SW Lower Boones Ferry,8956,S,AT,1,154,155,1,Spring2019
5691,NW Leahy & Leahy Terrace,8961,W,NS,0,1,1,0,Spring2019
5692,NW Leahy & Leahy Terrace,8962,S,OP,1,0,1,0,Spring2019
5693,NW 23rd & Flanders,8963,S,NS,70,20,90,9,Spring2019
5694,NW 23rd & Overton,8981,N,FS,12,72,84,18,Spring2019
5695,NW Thurman & 23rd Pl,8984,W,NS,3,42,45,7,Spring2019
5696,NW 23rd & Thurman,8986,S,FS,108,6,114,25,Spring2019
5697,NW 23rd & Marshall,8989,S,NS,167,30,197,80,Spring2019
5698,SE Sunnyside & 105th,8991,E,NS,3,8,11,1,Spring2019
5699,SE Sunnyside & Valley View Terr,8993,E,NS,3,15,18,2,Spring2019
5700,SE Sunnyside & 119th,8995,E,FS,6,31,37,12,Spring2019
5701,SE Mather & 122nd,8998,W,FS,4,1,5,0,Spring2019
5702,SE Mather & 119th Ct,8999,W,NS,0,0,0,0,Spring2019
5703,SE Mather & Cranberry Loop,9000,S,FS,8,0,8,0,Spring2019
5704,11000 Block SE Mather,9001,W,AT,0,0,0,0,Spring2019
5705,10500 Block SE Mather,9002,W,AT,5,1,6,4,Spring2019
5706,SE 97th & Lawnfield,9004,N,NS,8,1,9,0,Spring2019
5707,SE 97th & Talbert Dr,9005,N,NS,2,1,3,0,Spring2019
5708,14000 Block SE 97th,9007,W,AT,9,1,10,0,Spring2019
5709,SE Hubbard & 128th,9008,W,OP,0,0,0,0,Spring2019
5710,SE Hubbard & 128th,9009,E,NS,0,1,1,0,Spring2019
5711,NW Cornell & 185th,9010,E,FS,69,25,94,16,Spring2019
5712,NE Cornell & NW 185th,9012,W,FS,41,77,118,24,Spring2019
5713,NW Cornell & 188th,9013,W,FS,11,10,21,1,Spring2019
5714,NE Cornell & Stucki,9014,W,FS,23,46,69,13,Spring2019
5715,NW 185th & Evergreen,9022,S,FS,159,55,214,35,Spring2019
5716,SW Martinazzi & Tualatin-Sherwood,9026,S,NS,1,14,15,1,Spring2019
5717,NE 122nd & Wasco,9027,N,FS,9,89,98,29,Spring2019
5724,SW Tualatin Valley Hwy & 153rd,9029,E,NS,2,6,8,0,Spring2019
5725,NW 23rd & Raleigh,9030,S,FS,84,5,89,4,Spring2019
5726,NW 23rd & Raleigh,9031,N,NS,4,92,96,5,Spring2019
5727,SW Bertha & Chestnut,9033,N,NS,9,3,12,0,Spring2019
5728,SW Scholls Ferry & Springwood,9038,W,OP,16,22,38,1,Spring2019
5729,Molalla & Char Diaz Dr,9041,N,OP,2,0,2,0,Spring2019
5730,Molalla & Oregon City Post Office,9042,N,AT,5,1,6,4,Spring2019
5731,SW Columbia & 10th,9044,E,NS,194,71,265,45,Spring2019
5732,SW 257th & Hensley Rd,9046,N,FS,1,4,5,1,Spring2019
5733,SW 72nd & Durham Rd,9047,S,NS,0,0,0,0,Spring2019
5734,SW 72nd & Durham Rd,9048,N,OP,1,0,1,0,Spring2019
5735,NW Cornell & Bethany,9050,W,FS,25,26,51,4,Spring2019
5736,NW Cornell & Evergreen Pkwy,9051,W,FS,11,19,30,3,Spring2019
5737,NW Cornell & 167th Pl,9052,W,FS,7,9,16,11,Spring2019
5738,NW Cornell & 173rd Pl,9053,W,NS,21,33,54,5,Spring2019
5739,NW Cornell & 167th Pl,9054,E,NS,6,5,11,10,Spring2019
5740,NW Cornell & 173rd Ave,9055,E,FS,30,21,51,6,Spring2019
5741,NW Cornell & Bethany Ct,9056,E,NS,34,41,75,8,Spring2019
5742,NW Cornell & 179th,9059,E,NS,16,9,25,4,Spring2019
5743,SE 181st & E Burnside,9061,S,FS,33,64,97,21,Spring2019
5744,SW Hall & Tigard City Hall,9065,S,AT,1,4,5,2,Spring2019
5745,SW Hall & Fanno Creek Ct,9067,S,OP,3,5,8,0,Spring2019
5746,SW Hall & Bonita,9068,S,NS,8,25,33,0,Spring2019
5747,SW Hall & Murdock,9069,S,OP,1,6,7,0,Spring2019
5748,SW Hall & Sattler,9070,S,FS,2,8,10,0,Spring2019
5749,SW Hall & Avon,9071,N,FS,37,5,42,0,Spring2019
5750,8300 Block SW Durham,9072,E,OP,4,10,14,0,Spring2019
5751,SW Durham & 76th,9073,E,OP,0,3,3,0,Spring2019
5752,SW Durham & Upper Boones Ferry,9076,S,FS,6,28,34,1,Spring2019
5753,7200 Block SW Durham,9077,W,OP,7,1,8,0,Spring2019
5754,SW Durham & Upper Boones Ferry,9078,N,FS,19,3,22,1,Spring2019
5755,SW Durham & 76th,9079,W,NS,2,1,3,0,Spring2019
5756,8200 Block SW Durham,9080,W,AT,5,5,10,0,Spring2019
5757,SW Hall & Ashford,9082,N,NS,3,3,6,0,Spring2019
5758,SW Hall & Murdock,9083,N,NS,4,0,4,0,Spring2019
5759,SW Hall & Bonita,9084,N,NS,26,8,34,0,Spring2019
5760,SW Hall & McDonald,9085,N,NS,5,2,7,0,Spring2019
5761,SW Hall & Omara,9086,N,OP,22,5,27,14,Spring2019
5762,SW 257th & 16th Way,9092,N,NS,6,21,27,10,Spring2019
5763,SW 257th & Cherry Park,9094,N,NS,1,9,10,2,Spring2019
5764,17600 Block NE Sandy,9095,E,AT,12,27,39,1,Spring2019
5765,SW 257th & Sturges,9101,S,NS,5,1,6,1,Spring2019
5766,SW 257th & Cherry Park,9103,S,NS,22,7,29,11,Spring2019
5767,NE 105th & Killingsworth,9105,N,FS,4,3,7,1,Spring2019
5768,NE 105th & Simpson,9106,N,FS,1,2,3,0,Spring2019
5769,11000 Block NE Holman,9107,E,AT,3,11,14,4,Spring2019
5770,NE Airport Way & Ainsworth Circle,9108,E,NS,3,12,15,1,Spring2019
5777,NE Airport Way & 122nd,9110,E,NS,10,20,30,4,Spring2019
5778,NE Airport Way & 138th,9112,E,NS,7,14,21,3,Spring2019
5779,SW 18th & Morrison,9122,N,NS,116,68,184,33,Spring2019
5780,NW 25th & Lovejoy,9125,N,NS,0,4,4,0,Spring2019
5781,NW Cornell & Marshall,9126,N,AT,0,1,1,0,Spring2019
5782,NW Cornell & Summit Ct,9127,N,OP,1,1,2,0,Spring2019
5783,NW Cornell & Westover,9129,S,NS,1,2,3,0,Spring2019
5784,NW Cumberland & Fairfax,9130,S,FS,1,1,2,0,Spring2019
5785,NW Cumberland & Shenandoah,9131,W,NS,2,1,3,0,Spring2019
5786,NW Cumberland & Ariel,9132,W,FS,0,0,0,0,Spring2019
5787,NW Powhatan & Greenbrier Terr,9133,S,FS,0,1,1,0,Spring2019
5788,NW Macleay & Hermosa,9135,E,FS,2,3,5,0,Spring2019
5789,NW Macleay & Lomita Terrace,9136,E,NS,1,0,1,0,Spring2019
5790,NW Macleay & Beuhla Vista,9137,S,NS,0,1,1,0,Spring2019
5791,NW Macleay & W Burnside,9139,S,NS,0,0,0,0,Spring2019
5792,SW Walker & 158th,9145,W,FS,1,2,3,0,Spring2019
5793,SW Walker & Schendel,9146,W,NS,6,3,9,0,Spring2019
5794,NW Walker & 167th,9147,W,NS,0,0,0,0,Spring2019
5795,NW Walker & 173rd,9148,W,NS,0,0,0,0,Spring2019
5796,NW Walker & 185th,9150,E,FS,3,1,4,0,Spring2019
5797,NW Walker & 173rd,9151,E,NS,0,0,0,0,Spring2019
5798,SW Walker & Schendel,9152,E,NS,4,3,7,0,Spring2019
5799,NW Walker & SW 167th,9153,E,FS,0,0,0,0,Spring2019
5800,NW Cedar Hills & Leahy,9158,N,FS,1,5,6,0,Spring2019
5801,SW Conestoga & Boones Bend,9159,N,OP,0,7,7,0,Spring2019
5802,SW Conestoga & Welch,9160,W,NS,0,4,4,0,Spring2019
5803,SW Conestoga & Downing,9161,W,NS,0,10,10,0,Spring2019
5804,SW Conestoga & 125th,9162,W,NS,0,11,11,0,Spring2019
5805,SW 125th & Longhorn,9163,N,FS,1,7,8,1,Spring2019
5806,SW 125th & Footpath,9164,N,AT,1,3,4,0,Spring2019
5807,SW Brockman & Sorrento,9165,W,FS,0,2,2,0,Spring2019
5808,SW Brockman & 135th,9166,W,NS,0,8,8,0,Spring2019
5809,SW Brockman & Davies,9167,W,NS,0,4,4,0,Spring2019
5810,SW Brockman & Pony,9168,W,FS,0,3,3,0,Spring2019
5811,SW Scholls Ferry & Progress Park & Ride,9169,S,AT,8,27,35,1,Spring2019
5812,SW Teal & 152nd,9170,W,FS,2,2,4,0,Spring2019
5813,SW Teal & 155th,9171,S,NS,2,2,4,0,Spring2019
5814,SW Teal & Bobwhite Circle,9172,E,NS,1,1,2,0,Spring2019
5815,SW Teal & Pintail,9173,S,NS,5,3,8,0,Spring2019
5816,SW Scholls Ferry & Teal Blvd,9174,E,FS,18,14,32,0,Spring2019
5817,SW Scholls Ferry & 147th,9175,E,FS,6,3,9,0,Spring2019
5818,SW Brockman & Davies,9176,E,FS,4,0,4,0,Spring2019
5819,SW Brockman & 135th,9177,E,FS,9,0,9,0,Spring2019
5820,SW Brockman & Sorrento,9178,E,OP,2,0,2,0,Spring2019
5821,SW 125th & Footpath,9179,S,AT,6,0,6,0,Spring2019
5822,9600 Block SW 125th,9180,S,AT,8,3,11,0,Spring2019
5823,SW Conestoga & 125th,9181,E,FS,16,0,16,0,Spring2019
5830,SW Conestoga & Downing,9182,E,OP,6,0,6,0,Spring2019
5831,SW Conestoga & Trapper Terrace,9183,E,FS,5,0,5,0,Spring2019
5832,SW Conestoga & Boones Bend,9184,S,NS,10,0,10,0,Spring2019
5833,SW Scholls Ferry & Progress Park & Ride,9185,N,OP,27,9,36,0,Spring2019
5834,SW Tualatin-Sherwood Rd & Pacific Hwy,9186,S,FS,2,66,68,4,Spring2019
5835,SW Tualatin-Sherwood Rd & Baler,9187,E,NS,0,24,24,30,Spring2019
5836,SW Langer & Sherwood Plaza,9188,W,OP,2,23,25,8,Spring2019
5837,16400 Block SW Langer,9189,S,AT,3,14,17,3,Spring2019
5838,16100 Block SW Langer,9190,E,AT,11,1,12,1,Spring2019
5839,N Rivergate Blvd & Lombard St,9192,W,FS,11,17,28,0,Spring2019
5840,13300 Block N Rivergate,9193,N,OP,0,1,1,0,Spring2019
5841,N Rivergate Blvd & Ramsey,9194,N,NS,1,2,3,0,Spring2019
5842,13300 Block N Rivergate Blvd,9196,S,AT,0,0,0,0,Spring2019
5843,N Lombard & Simmons,9197,N,OP,3,2,5,0,Spring2019
5844,7100 Block N Marine,9198,E,AT,2,1,3,0,Spring2019
5845,5900 Block N Marine,9199,E,OP,0,1,1,0,Spring2019
5846,5700 Block N Marine,9200,E,OP,0,1,1,0,Spring2019
5847,5300 Block N Marine,9202,W,AT,0,0,0,0,Spring2019
5848,5700 Block N Marine,9203,W,FS,2,0,2,0,Spring2019
5849,5900 Block N Marine,9204,W,AT,1,0,1,0,Spring2019
5850,7100 Block N Marine,9205,W,OP,0,4,4,0,Spring2019
5851,N Lombard & Simmons,9206,S,NS,1,4,5,0,Spring2019
5852,SW Tualatin Valley Hwy & 198th,9207,E,FS,55,67,122,16,Spring2019
5853,14700 Block SW Teal,9208,W,OP,7,3,10,1,Spring2019
5854,NW Walker & 180th,9209,W,FS,0,2,2,0,Spring2019
5855,18000 Block NW Walker,9210,E,OP,1,0,1,0,Spring2019
5856,SE Main & 100th,9211,W,OP,4,3,7,2,Spring2019
5857,NW Cornell & Bronson Creek Pk,9212,W,AT,5,14,19,0,Spring2019
5858,NW Cornell & Birch Pointe Apts,9213,E,AT,23,7,30,1,Spring2019
5859,NW Cumberland & Culpepper,9214,W,OP,3,4,7,0,Spring2019
5860,SW Teal & Nighthawk Dr,9215,S,NS,1,1,2,0,Spring2019
5861,Willamette Dr & Lazy River Dr,9216,N,NS,9,3,12,0,Spring2019
5862,NE Wasco & 82nd,9217,E,NS,4,28,32,9,Spring2019
5863,SE Main & 100th,9218,E,NS,3,5,8,4,Spring2019
5864,SE 122nd & Stark,9219,S,FS,134,61,195,56,Spring2019
5865,Washington Square Transit Center,9220,S,AT,48,49,97,15,Spring2019
5866,SW Palmblad & Hall Blvd,9221,N,NS,4,2,6,0,Spring2019
5867,SW Durham & 79th,9224,E,OP,12,5,17,0,Spring2019
5868,SW Durham & 79th,9225,W,NS,9,11,20,0,Spring2019
5869,SW Hall & Ross,9226,N,FS,9,2,11,0,Spring2019
5870,NW Walker & Cambray,9230,E,FS,0,0,0,0,Spring2019
5871,NW Walker & 178th,9232,W,NS,0,0,0,0,Spring2019
5872,SE Orient Dr & 262nd,9233,E,NS,1,2,3,1,Spring2019
5873,SE Orient Dr & 262nd/Barnes/Salquist,9234,W,NS,1,0,1,0,Spring2019
5874,NW Cornell & 153rd,9245,W,NS,7,11,18,1,Spring2019
5875,SE Division & 61st,9248,W,NS,20,11,31,3,Spring2019
5876,SW 158th & Jenkins,9252,S,NS,1,3,4,0,Spring2019
5883,NE Fremont & 66th,9253,E,NS,1,3,4,0,Spring2019
5884,7200 Block SW Durham,9257,S,AT,1,10,11,0,Spring2019
5885,NW Graham/257th & W Columbia River Hwy,9261,S,NS,11,1,12,3,Spring2019
5886,SE Division & 148th,9263,W,FS,98,84,182,49,Spring2019
5887,SE Division & 42nd,9265,W,NS,57,36,93,19,Spring2019
5888,NE 181st & Wilkes,9266,N,NS,1,2,3,1,Spring2019
5889,Willamette Falls Dr & 12th St,9269,E,NS,2,0,2,2,Spring2019
5890,Blankenship & Virginia Lane,9270,N,OP,3,1,4,2,Spring2019
5891,Blankenship & 19th St,9276,W,NS,1,0,1,0,Spring2019
5892,Blankenship & Ostman,9277,W,NS,1,1,2,0,Spring2019
5893,Willamette Falls Dr & 19th St,9284,E,OP,0,0,0,0,Spring2019
5894,Willamette Falls Dr & 16th St,9285,E,FS,0,1,1,0,Spring2019
5895,Willamette Falls Dr & 14th St,9286,E,NS,3,1,4,0,Spring2019
5896,10th St & 8th Court,9296,N,NS,2,9,11,2,Spring2019
5897,Blankenship & Tannler Dr,9297,N,FS,1,2,3,1,Spring2019
5898,NW 6th & Davis MAX Station,9299,N,NS,842,638,1480,0,Spring2019
5899,NW 6th & Flanders,9300,N,NS,5,259,264,61,Spring2019
5900,NW 5th & Davis,9301,S,NS,636,451,1087,242,Spring2019
5901,NW 5th & Couch MAX Station,9303,S,NS,755,868,1623,1,Spring2019
5902,NE Multnomah & 11th,9305,E,FS,104,53,157,33,Spring2019
5903,SE Steele & 46th,9307,W,NS,20,4,24,3,Spring2019
5904,N Lombard & Ramsey,9308,N,NS,2,1,3,0,Spring2019
5905,N Lombard & Ramsey,9309,S,FS,2,4,6,0,Spring2019
5906,NW Glisan & 3rd,9311,W,FS,81,253,334,67,Spring2019
5907,SE Hwy 224 & Suttle Rd,9312,W,OP,1,0,1,0,Spring2019
5908,SE Hwy 224 & Suttle Rd,9313,E,FS,0,1,1,0,Spring2019
5909,SW Taylors Ferry & Capitol Hwy,9320,E,FS,3,19,22,1,Spring2019
5910,27500 Block SE Hwy 224,9321,E,AT,0,1,1,0,Spring2019
5911,27600 Block SE Hwy 224,9322,W,AT,0,0,0,0,Spring2019
5912,SW Murray & Barlow,9323,S,OP,1,5,6,0,Spring2019
5913,SW Murray & Brockman,9324,N,FS,23,11,34,4,Spring2019
5914,SW 45th & Nevada,9328,S,NS,0,1,1,0,Spring2019
5915,N Marine & Leadbetter,9334,E,FS,2,0,2,0,Spring2019
5916,N Marine & Leadbetter,9335,W,FS,0,8,8,0,Spring2019
5917,SW Canyon & Camelot Ct,9338,N,NS,46,12,58,9,Spring2019
5918,NE 33rd Dr & Sunderland,9339,N,OP,0,1,1,0,Spring2019
5919,NE 15th & Halsey,9342,N,NS,22,30,52,8,Spring2019
5920,W Powell & NW Miller,9347,W,FS,18,5,23,7,Spring2019
5921,NW 185th & Rock Creek,9351,S,FS,49,8,57,3,Spring2019
5922,SW Boones Ferry Rd & Avery,9352,S,FS,0,4,4,0,Spring2019
5923,SW Boones Ferry Rd & Avery,9353,N,FS,6,0,6,0,Spring2019
5924,W Burnside & SW Osage,9354,E,NS,35,31,66,5,Spring2019
5925,NE Multnomah & 3rd,9362,E,OP,21,56,77,39,Spring2019
5926,NE 33rd Dr & Elrod Dr,9365,N,NS,0,10,10,0,Spring2019
5927,9600 Block NE Sunderland,9367,S,AT,0,1,1,0,Spring2019
5928,NE Sunderland & Columbia River Corr Cntr,9368,S,AT,69,48,117,5,Spring2019
5929,NE 33rd Dr & Elrod Dr,9369,S,NS,24,0,24,0,Spring2019
5936,2400 Block NE Riverside Way,9371,W,AT,7,0,7,0,Spring2019
5937,SE Powell Valley & Barnes Flag Stop,9383,W,AT,0,0,0,0,Spring2019
5938,SW 1st & Arthur,9397,S,NS,8,3,11,0,Spring2019
5939,N Going & Port Center Way,9399,E,NS,51,9,60,4,Spring2019
5940,NE 21st & Riverside Way,9402,S,FS,6,0,6,0,Spring2019
5941,N Killingsworth & Greeley,9403,E,FS,42,6,48,5,Spring2019
5942,NW 23rd Pl & Westover,9404,N,NS,0,0,0,0,Spring2019
5943,SW Hamilton & 55th Pl,9405,E,OP,0,0,0,0,Spring2019
5944,SW Boones Ferry Rd & 13th Ct,9406,W,NS,0,0,0,0,Spring2019
5945,SW Boones Ferry Rd & 13th Ct,9407,E,FS,1,0,1,0,Spring2019
5946,Exceed Enterprises,9412,S,AT,8,9,17,43,Spring2019
5947,NE Sunderland & 33rd Dr (In),9414,E,NS,1,0,1,0,Spring2019
5948,NW Division & Angeline,9425,W,OP,6,2,8,5,Spring2019
5949,NW Division & Angeline,9426,E,NS,1,7,8,2,Spring2019
5950,SW 257th & Jennings Way,9427,E,NS,1,4,5,0,Spring2019
5951,SW 257th & Jennings Way,9428,W,OP,11,1,12,1,Spring2019
5952,SE Main & E 1st,9429,N,NS,2,1,3,0,Spring2019
5953,NE Main & E 1st,9430,S,NS,0,3,3,0,Spring2019
5954,N Lombard & Catlin,9431,N,NS,2,53,55,5,Spring2019
5955,N Lombard & Weyerhauser,9432,N,FS,0,25,25,4,Spring2019
5956,14500 Block N Lombard,9434,N,AT,1,2,3,0,Spring2019
5957,N Lombard & Catlin,9435,S,NS,88,2,90,15,Spring2019
5958,10200 Block N Lombard,9436,S,AT,43,0,43,5,Spring2019
5959,NE Vancouver Way & Freightliner,9438,N,FS,1,8,9,0,Spring2019
5960,N Marine & Leadbetter,9439,E,NS,2,2,4,0,Spring2019
5961,N Marine & Bybee Lake Road,9440,E,FS,1,0,1,0,Spring2019
5962,6100 Block N Marine,9441,E,AT,1,0,1,0,Spring2019
5963,5300 Block N Marine,9442,E,OP,0,0,0,0,Spring2019
5964,N Marine & Gantenbein,9444,E,OP,0,0,0,0,Spring2019
5965,9000 Block NE Vancouver Way,9449,W,AT,54,13,67,1,Spring2019
5966,NE Middlefield & 6th Drive,9451,E,NS,0,0,0,0,Spring2019
5967,NE 6th Drive & Faloma,9453,N,NS,2,0,2,0,Spring2019
5968,N Marine & Gantenbein,9454,W,NS,0,0,0,0,Spring2019
5969,N Marine & Anchor,9455,W,NS,1,0,1,0,Spring2019
5970,6100 Block N Marine,9457,W,AT,0,2,2,0,Spring2019
5971,N Marine & Bybee Lake Road,9458,W,NS,0,3,3,0,Spring2019
5972,N Marine & Pacific Gateway Blvd,9459,W,FS,2,3,5,0,Spring2019
5973,14500 Block N Lombard,9460,S,OP,1,3,4,0,Spring2019
5974,SW Hocken & Millikan,9462,S,NS,7,7,14,1,Spring2019
5975,13500 Block SW Millikan,9463,W,AT,3,3,6,0,Spring2019
5976,13900 Block SW Millikan,9464,W,AT,2,2,4,0,Spring2019
5977,14100 Block SW Millikan,9465,E,OP,1,3,4,0,Spring2019
5978,13900 Block SW Millikan,9466,E,OP,3,2,5,1,Spring2019
5979,NW 185th & Bronson,9467,N,FS,7,34,41,2,Spring2019
5980,13900 Block SW 72nd,9469,E,AT,0,2,2,0,Spring2019
5981,NW Graham/257th & 257th Way,9470,N,FS,3,30,33,2,Spring2019
5982,NW Graham/257th & 257th Way,9471,S,OP,27,2,29,4,Spring2019
5989,900 Block NW North Frontage Rd,9472,W,AT,0,3,3,0,Spring2019
5990,NE Middlefield Rd & N Vancouver Way,9477,N,FS,19,6,25,1,Spring2019
5991,1000 Block N Marine,9478,E,AT,0,1,1,0,Spring2019
5992,NE Vancouver Way & Gertz Rd,9480,S,FS,48,8,56,23,Spring2019
5993,1100 Block NW Frontage Rd,9481,E,AT,130,117,247,24,Spring2019
5994,9400 Block SW Commerce Circle,9484,W,AT,0,5,5,0,Spring2019
5995,SE 122nd & Schiller,9487,N,FS,21,4,25,7,Spring2019
5996,3505 SW US Veterans Rd,9488,W,OP,48,35,83,1,Spring2019
5997,5500 Block SE International Way,9503,S,AT,3,2,5,0,Spring2019
5998,N Lombard & New York,9505,S,NS,139,12,151,48,Spring2019
5999,13900 Block SW 72nd,9509,W,OP,0,0,0,0,Spring2019
6000,SW Boones Ferry Rd & Iowa Dr,9511,N,FS,6,0,6,0,Spring2019
6001,SW Boones Ferry Rd & Iowa Dr,9512,S,FS,1,5,6,0,Spring2019
6002,Beavercreek & Molalla,9516,E,NS,3,26,29,4,Spring2019
6003,Beavercreek & Library Ct,9517,N,OP,58,8,66,8,Spring2019
6004,20300 Block SW Pacific Hwy,9519,W,AT,0,4,4,1,Spring2019
6005,SE Eagle Creek Rd & Hinman,9520,N,NS,1,0,1,0,Spring2019
6006,SE Eagle Creek Rd & Strubhar Lane,9521,S,FS,0,0,0,0,Spring2019
6007,SW Garden Home & Orchard Lane,9525,S,NS,0,1,1,0,Spring2019
6008,W Burnside & SW 2nd,9526,E,NS,452,198,650,219,Spring2019
6009,SW Barnes & NW 118th,9531,W,NS,10,31,41,0,Spring2019
6010,SW Barnes & 117th,9532,E,NS,8,6,14,3,Spring2019
6011,5200 Block NE 148th (Relay Resources),9537,S,AT,2,0,2,1,Spring2019
6012,SW Laurelwood & Laurel,9544,S,FS,1,71,72,0,Spring2019
6013,Lake Oswego Transit Center,9545,E,NS,32,119,151,33,Spring2019
6014,NE Fremont & Sandy,9548,E,NS,6,11,17,5,Spring2019
6015,NE Riverside Way & 33rd Dr,9549,W,FS,24,0,24,0,Spring2019
6016,2800 Block NE Riverside Way,9550,E,AT,0,9,9,0,Spring2019
6017,SW Salmon & 18th,9552,W,NS,78,11,89,1,Spring2019
6018,Linn & Williams,9559,S,OP,4,30,34,6,Spring2019
6019,29200 Block SE Eagle Creek Rd,9561,S,AT,0,1,1,0,Spring2019
6020,29200 Block SE Eagle Creek Rd,9562,N,OP,0,0,0,0,Spring2019
6021,NE Cornell & 48th,9564,W,FS,10,10,20,4,Spring2019
6022,SW Durham & 72nd,9565,E,NS,1,5,6,0,Spring2019
6023,8800 Block SW Oleson,9570,E,OP,3,0,3,0,Spring2019
6024,N Lombard & Reno,9575,S,NS,8,0,8,0,Spring2019
6025,N Lombard & Reno,9576,N,NS,1,69,70,13,Spring2019
6026,1700 Block Beavercreek Rd,9578,W,AT,8,1,9,3,Spring2019
6027,1600 Block Beavercreek Rd,9579,W,AT,6,1,7,1,Spring2019
6028,Beavercreek & Hwy 213,9580,W,FS,16,1,17,3,Spring2019
6029,1600 Block Beavercreek Rd,9581,E,AT,0,10,10,2,Spring2019
6030,2000 Block Beavercreek Rd,9582,E,AT,0,7,7,1,Spring2019
6031,Beavercreek & Hwy 213,9583,E,NS,0,5,5,4,Spring2019
6032,SW Pacific Hwy & Royalty Parkway,9597,N,FS,54,10,64,18,Spring2019
6033,SW Morrison & 12th,9598,W,NS,70,34,104,22,Spring2019
6034,SW Morrison & 17th,9599,W,FS,182,61,243,32,Spring2019
6035,SW 11th & Alder,9600,S,NS,77,173,250,84,Spring2019
6042,NW Evergreen Pkwy & NE 79th (NW 215th),9601,W,NS,8,2,10,0,Spring2019
6043,NW Evergreen Pkwy & NE 79th (NW 215th),9602,E,NS,2,14,16,0,Spring2019
6044,2500 Block NE Century (NW 229th),9603,N,AT,7,28,35,0,Spring2019
6045,2500 Block NE Century (NW 229th),9604,S,AT,26,10,36,0,Spring2019
6046,NE 25th & Sunrise Lane,9606,N,OP,0,0,0,0,Spring2019
6047,NE 25th & Sunrise Lane,9607,S,NS,1,0,1,0,Spring2019
6048,Willow Creek Transit Center,9610,E,AT,511,186,697,85,Spring2019
6049,NE 57th & Failing,9611,N,NS,1,5,6,0,Spring2019
6050,SW Morrison & 16th,9613,W,NS,49,24,73,9,Spring2019
6051,NE Century (NW 229th) & Butler,9614,N,NS,3,9,12,1,Spring2019
6052,6400 Block SE Lake,9615,N,AT,1,1,2,1,Spring2019
6053,NE 105th & Marx,9619,N,NS,0,3,3,1,Spring2019
6054,Willow Creek Transit Center,9621,E,AT,209,186,395,60,Spring2019
6055,SW Murray & NW Milburn,9623,N,NS,6,6,12,0,Spring2019
6056,Sunset TC MAX Station,9624,W,AT,593,2377,2970,0,Spring2019
6057,Sunset Transit Center,9625,W,AT,244,266,510,69,Spring2019
6058,SW Barnes & Cedar Hills Blvd,9627,E,FS,33,41,74,11,Spring2019
6059,SW Barnes & Cedar Hills Blvd,9628,W,NS,39,37,76,10,Spring2019
6060,SW Hamilton & 58th,9634,W,FS,0,1,1,0,Spring2019
6061,N Portsmouth & Willamette,9635,S,NS,52,63,115,16,Spring2019
6062,NE 223rd & Glisan,9636,S,FS,18,6,24,7,Spring2019
6063,SW Tualatin-Sherwood Rd & Pacific Hwy,9639,N,NS,71,2,73,27,Spring2019
6064,SE Hwy 224 & Sherman Cooper,9640,E,NS,0,1,1,0,Spring2019
6065,SE Hwy 224 & Sherman Cooper,9641,W,OP,1,1,2,0,Spring2019
6066,NE 122nd & Multnomah,9642,S,OP,53,10,63,27,Spring2019
6067,1700 Block SE Orient Dr,9644,N,AT,3,0,3,0,Spring2019
6068,SW Pacific Hwy & 74th (Park & Ride),9648,E,FS,147,42,189,14,Spring2019
6069,Washington Square Transit Center,9649,N,AT,227,218,445,66,Spring2019
6070,Washington Square Transit Center,9650,N,AT,258,256,514,62,Spring2019
6071,Washington Square Transit Center,9651,N,AT,269,250,519,54,Spring2019
6072,Washington Square Transit Center,9652,S,AT,264,316,580,66,Spring2019
6073,SW Hart & Forest Dr,9663,W,NS,6,9,15,0,Spring2019
6074,SW Hart & Dunsmuir,9664,W,OP,1,2,3,0,Spring2019
6075,SW Hart & 155th,9665,W,FS,2,4,6,0,Spring2019
6076,SW Hart & 160th,9667,W,NS,8,14,22,0,Spring2019
6077,SW Hart & 165th,9668,W,OP,6,13,19,1,Spring2019
6078,SW Bany & Tallac Way,9669,W,OP,8,16,24,0,Spring2019
6079,SW 170th & Canby,9670,N,NS,4,4,8,0,Spring2019
6080,SW 170th & Ivy Glenn,9671,N,NS,1,2,3,0,Spring2019
6081,SW 170th & Oak,9672,N,FS,4,6,10,0,Spring2019
6082,SW 170th & Rosa Place,9673,N,FS,1,2,3,0,Spring2019
6083,SW Farmington & 185th,9674,W,NS,20,27,47,3,Spring2019
6084,SW 170th & Ivy Glenn,9675,S,NS,2,1,3,0,Spring2019
6085,SW 170th & Rosa Place,9676,S,OP,2,1,3,0,Spring2019
6086,SW 170th & Oak,9677,S,FS,4,4,8,0,Spring2019
6087,SW 170th & Cynthia,9678,S,NS,3,4,7,0,Spring2019
6088,SW Bany & Tallac Way,9679,E,FS,14,6,20,0,Spring2019
6095,SW Hart & 165th,9680,E,FS,15,8,23,0,Spring2019
6096,SW Hart & 161st,9681,E,FS,7,3,10,0,Spring2019
6097,SW Hart & 157th,9682,E,FS,9,5,14,0,Spring2019
6098,SW Hart & 155th,9683,E,FS,5,4,9,0,Spring2019
6099,SW Hart & Dunsmuir,9684,E,FS,2,1,3,0,Spring2019
6100,SW Arctic Dr & Western Ave,9685,E,FS,0,4,4,0,Spring2019
6101,SW Arctic Dr & Harvest Ct,9686,S,OP,0,19,19,0,Spring2019
6102,SW Allen & Lombard,9687,E,FS,1,5,6,4,Spring2019
6103,SW Allen & King,9688,E,NS,1,3,4,0,Spring2019
6104,10400 Block SW Allen,9689,E,AT,37,3,40,0,Spring2019
6105,SW Arctic Dr & Sunshine Ct,9694,N,NS,12,3,15,0,Spring2019
6106,SW Arctic Dr & Harvest Ct,9695,N,FS,7,2,9,0,Spring2019
6107,SW Arctic Dr & Western Ave,9696,W,NS,3,0,3,0,Spring2019
6108,SW 5th & Western,9697,W,FS,4,2,6,0,Spring2019
6109,10900 Block SW 5th,9698,W,OP,2,2,4,0,Spring2019
6110,10900 Block SW 5th,9699,E,AT,2,3,5,0,Spring2019
6111,SW 5th & Western,9700,E,NS,0,2,2,0,Spring2019
6112,SW Arctic Dr & Allen,9701,S,NS,2,9,11,0,Spring2019
6113,10500 Block SW Allen,9703,W,AT,0,20,20,0,Spring2019
6114,SW Allen & King,9704,W,NS,6,1,7,0,Spring2019
6115,5000 Block SW Griffith Drive,9705,N,AT,2,1,3,0,Spring2019
6116,4800 Block SW Griffith Drive,9706,N,AT,1,0,1,0,Spring2019
6117,4900 Block SW Griffith Drive,9707,E,AT,0,1,1,0,Spring2019
6118,SW Morrison & 14th,9708,W,NS,46,32,78,16,Spring2019
6119,NE Glisan & 28th,9709,W,FS,62,34,96,6,Spring2019
6120,18600 Block NE Sandy,9715,E,FS,1,3,4,0,Spring2019
6121,19000 Block NE Sandy (East Entrance),9716,E,NS,0,0,0,0,Spring2019
6122,21100 Block NE Sandy,9717,E,AT,3,4,7,1,Spring2019
6123,NE Sandy & 201st,9718,E,FS,24,19,43,26,Spring2019
6124,NE Sandy & 205th,9719,E,FS,27,20,47,16,Spring2019
6125,21100 Block NE Sandy,9722,W,OP,4,3,7,3,Spring2019
6126,NE Sandy & 206th Pl,9723,W,FS,19,24,43,14,Spring2019
6127,NE Sandy & 201st,9724,W,NS,19,25,44,21,Spring2019
6128,19000 Block NE Sandy (East Entrance),9725,W,OP,1,1,2,0,Spring2019
6129,18600 Block NE Sandy,9726,W,NS,1,1,2,0,Spring2019
6130,Beavercreek & Fir,9755,W,NS,3,0,3,3,Spring2019
6131,NE Sandy & 42nd,9756,W,FS,153,96,249,84,Spring2019
6132,Providence Park MAX Station,9757,W,AT,1091,1771,2862,0,Spring2019
6133,Providence Park MAX Station,9758,E,AT,1384,1067,2451,0,Spring2019
6134,Kings Hill/SW Salmon St MAX Station,9759,N,AT,333,312,645,0,Spring2019
6135,SW Apple Way & Laurelwood,9760,E,NS,2,0,2,0,Spring2019
6136,SW 78th & Westmoor,9761,N,FS,0,0,0,0,Spring2019
6137,SW 78th & Brentwood,9762,N,NS,0,0,0,0,Spring2019
6138,SW Brentwood & Laurelwood,9763,W,NS,0,0,0,0,Spring2019
6139,SW Laurelwood & Beaverton-Hillsdale Hwy,9764,S,NS,0,0,0,0,Spring2019
6140,8500 Block SW Apple Way,9765,S,FS,0,0,0,0,Spring2019
6141,NE 223rd & Glisan,9766,N,NS,4,22,26,9,Spring2019
6148,NE 223rd & Park Lane,9767,S,FS,32,19,51,36,Spring2019
6149,NE 223rd & Park Lane,9772,N,FS,19,29,48,43,Spring2019
6150,1400 Block NE 223rd,9773,N,AT,4,7,11,1,Spring2019
6151,NE Sandy & 223rd,9775,E,FS,6,9,15,1,Spring2019
6152,NE Sandy & 223rd,9776,W,FS,7,8,15,0,Spring2019
6153,SW Denney & King,9781,W,FS,6,2,8,0,Spring2019
6154,SW Lombard & Camden,9782,N,NS,2,1,3,0,Spring2019
6155,SW Lombard & Camden,9785,S,NS,1,1,2,0,Spring2019
6156,NE Century (NW 229th) & Evergreen Pkwy,9790,S,FS,8,4,12,0,Spring2019
6157,NE Century (NW 229th) & Evergreen Pkwy,9791,N,NS,5,15,20,0,Spring2019
6158,SE Stark & SW Sundial,9792,W,FS,30,25,55,33,Spring2019
6159,NW Cornell & 158th,9793,W,OP,7,29,36,3,Spring2019
6160,NW Eastman & Division,9795,S,FS,5,1,6,1,Spring2019
6161,SW Barnes & Cedar Hills Blvd,9808,W,FS,1,1,2,0,Spring2019
6162,19000 Block NE Sandy,9811,E,AT,1,2,3,0,Spring2019
6163,Beaverton TC MAX Station,9818,S,AT,1567,1590,3157,0,Spring2019
6164,Beaverton Creek MAX Station,9819,N,AT,123,771,894,0,Spring2019
6165,Kings Hill/SW Salmon St MAX Station,9820,S,AT,304,342,646,0,Spring2019
6166,Beaverton TC MAX Station,9821,N,AT,2862,3260,6122,0,Spring2019
6167,Beaverton Creek MAX Station,9822,S,AT,797,110,907,0,Spring2019
6168,Beaverton Central MAX Station,9823,W,AT,400,386,786,0,Spring2019
6169,Beaverton Central MAX Station,9824,E,AT,425,434,859,0,Spring2019
6170,Millikan Way MAX Station,9825,W,AT,413,1009,1422,0,Spring2019
6171,Millikan Way MAX Station,9826,E,AT,1066,403,1469,0,Spring2019
6172,Merlo Rd/SW 158th Ave MAX Station,9827,W,AT,219,633,852,0,Spring2019
6173,Merlo Rd/SW 158th Ave MAX Station,9828,E,AT,641,226,867,0,Spring2019
6174,Elmonica/SW 170th Ave MAX Station,9829,W,AT,318,1140,1458,0,Spring2019
6175,Elmonica/SW 170th Ave MAX Station,9830,E,AT,1111,249,1360,0,Spring2019
6176,Willow Creek/SW 185th Ave TC MAX Station,9831,E,AT,1253,460,1713,0,Spring2019
6177,Willow Creek/SW 185th Ave TC MAX Station,9832,W,AT,482,1236,1718,0,Spring2019
6178,Quatama MAX Station,9833,W,AT,232,1029,1261,0,Spring2019
6179,Quatama MAX Station,9834,E,AT,1078,243,1321,0,Spring2019
6180,Orenco MAX Station,9835,E,AT,931,319,1250,0,Spring2019
6181,Orenco MAX Station,9836,W,AT,336,955,1291,0,Spring2019
6182,Fair Complex/Hillsboro Airport MAX Stn,9837,W,AT,105,707,812,0,Spring2019
6183,Fair Complex/Hillsboro Airport MAX Stn,9838,E,AT,709,108,817,0,Spring2019
6184,Hawthorn Farm MAX Station,9839,E,AT,289,103,392,0,Spring2019
6185,Hawthorn Farm MAX Station,9840,W,AT,89,278,367,0,Spring2019
6186,Washington/SE 12th Ave MAX Station,9841,E,AT,362,104,466,0,Spring2019
6187,Washington/SE 12th Ave MAX Station,9842,W,AT,99,333,432,0,Spring2019
6188,Tuality Hospital/SE 8th Ave MAX Station,9843,E,AT,370,64,434,0,Spring2019
6189,Tuality Hospital/SE 8th Ave MAX Station,9844,W,AT,59,367,426,0,Spring2019
6190,Hillsboro Central/SE 3rd TC MAX Station,9845,W,AT,44,827,871,0,Spring2019
6191,Hillsboro Central/SE 3rd TC MAX Station,9846,E,AT,741,55,796,0,Spring2019
6192,Hatfield Government Center MAX Station,9848,S,AT,1026,930,1956,0,Spring2019
6193,SW Baseline & Dennis,9850,W,NS,18,21,39,7,Spring2019
6194,NE Century (NW 229th) & Rosebay Dr,9851,S,NS,1,1,2,0,Spring2019
6201,19000 Block NE Sandy,9853,W,OP,3,0,3,0,Spring2019
6202,W Burnside & SW 18th,9860,E,NS,1,2,3,1,Spring2019
6203,SW Terwilliger & Sam Jackson,9861,N,NS,6,28,34,3,Spring2019
6204,1100 Block N Hayden Meadows Dr,9862,N,NS,77,27,104,63,Spring2019
6205,Willow Creek Transit Center,9869,E,AT,184,505,689,88,Spring2019
6206,Willow Creek Transit Center,9871,E,AT,11,27,38,1,Spring2019
6207,7600 Block SW Barnes,9872,W,OP,3,12,15,0,Spring2019
6208,600 Block NW Naito Parkway,9873,N,AT,3,3,6,2,Spring2019
6209,900 Block NW Naito Parkway,9874,N,OP,3,5,8,9,Spring2019
6210,NW Naito Parkway & 9th,9875,N,OP,10,3,13,0,Spring2019
6211,NW Front & 15th,9877,N,FS,4,7,11,1,Spring2019
6212,NW Front & 17th,9878,N,FS,6,20,26,0,Spring2019
6213,NW Front & 21st,9879,N,OP,1,7,8,0,Spring2019
6214,NW Front & Nicolai,9880,N,FS,6,16,22,0,Spring2019
6215,3000 Block NW Front,9881,N,OP,1,14,15,0,Spring2019
6216,900 Block NW Naito Parkway,9889,S,AT,6,5,11,11,Spring2019
6217,NW Naito Parkway & 9th,9890,S,FS,6,19,25,2,Spring2019
6218,NW Front & 17th,9893,S,NS,28,11,39,0,Spring2019
6219,NW Front & 21st,9894,S,NS,4,1,5,0,Spring2019
6220,NW Front & Nicolai,9896,S,NS,10,7,17,0,Spring2019
6221,NE Evergreen & 13th,9920,W,OP,0,1,1,0,Spring2019
6222,NE Evergreen & NW Jackson School Rd N,9921,W,FS,0,0,0,0,Spring2019
6223,NE Orenco Station Loop & MAX Station,9923,E,AT,139,53,192,27,Spring2019
6224,300 Block E Main,9931,W,AT,1,0,1,0,Spring2019
6225,E Main & N 1st,9933,W,NS,2,0,2,0,Spring2019
6226,N 1st & NE Edison,9935,N,NS,1,0,1,0,Spring2019
6227,N 1st & NE Grant,9936,N,NS,0,0,0,0,Spring2019
6228,N 1st & NE Tiffany,9937,N,FS,0,0,0,0,Spring2019
6229,2800 Block NW Glencoe,9938,N,OP,3,9,12,0,Spring2019
6230,NW Glencoe & NE Cory,9939,N,FS,2,3,5,0,Spring2019
6231,NW Glencoe & NE Lenox,9940,N,NS,3,5,8,0,Spring2019
6232,NW Glencoe & NE Milne,9941,N,NS,1,1,2,0,Spring2019
6233,NE Evergreen & NW Glencoe,9942,E,FS,1,0,1,0,Spring2019
6234,NE Evergreen & 3rd,9943,E,NS,0,0,0,0,Spring2019
6235,NE Evergreen & Sunburst,9944,E,NS,0,1,1,0,Spring2019
6236,NE Evergreen & Jackson School Rd,9945,E,NS,1,0,1,0,Spring2019
6237,NE Evergreen & Jackson Road Loop,9946,E,NS,0,0,0,0,Spring2019
6238,NE Evergreen & 13th,9947,E,NS,1,1,2,0,Spring2019
6239,NE 15th & Jones Farm Pkwy,9948,S,NS,4,5,9,0,Spring2019
6240,NE Griffin Oaks & 15th,9949,E,FS,6,3,9,0,Spring2019
6241,1800 Block NE Griffin Oaks,9950,E,AT,2,0,2,0,Spring2019
6242,2200 Block NE Griffin Oaks,9951,E,AT,2,2,4,0,Spring2019
6243,NE 25th & Kathryn,9952,S,NS,1,0,1,0,Spring2019
6244,Fair Complex/Airport Park & Ride,9953,E,AT,41,45,86,46,Spring2019
6245,Hillsboro Transit Center,9954,E,AT,58,16,74,11,Spring2019
6246,Hillsboro Transit Center,9955,E,AT,278,420,698,112,Spring2019
6247,Hillsboro Transit Center,9956,E,AT,184,73,257,36,Spring2019
6254,Millikan Way MAX Station/Park and Ride,9957,W,AT,64,224,288,14,Spring2019
6255,Millikan Way MAX Station/Park and Ride,9958,W,AT,194,76,270,24,Spring2019
6256,NE Shaver & Parkrose HS,9959,W,AT,31,11,42,1,Spring2019
6257,NE 34th & Cornell,9962,N,NS,0,0,0,0,Spring2019
6258,NE 25th & Kathryn,9963,N,OP,0,1,1,0,Spring2019
6259,NE Griffin Oaks & 15th,9965,W,NS,4,1,5,0,Spring2019
6260,1800 Block NE Griffin Oaks,9966,W,OP,1,3,4,0,Spring2019
6261,NE 15th & Jones Farm Pkwy,9967,N,OP,5,4,9,1,Spring2019
6262,Sunset TC MAX Station,9969,E,AT,2353,496,2849,0,Spring2019
6263,Sunset Transit Center,9970,W,AT,134,77,211,44,Spring2019
6264,Sunset Transit Center,9971,W,AT,78,110,188,0,Spring2019
6265,Sunset Transit Center,9972,W,AT,17,20,37,2,Spring2019
6266,Sunset Transit Center,9975,W,AT,64,169,233,52,Spring2019
6267,Beaverton Transit Center,9976,S,AT,279,238,517,73,Spring2019
6268,Beaverton Transit Center,9977,E,AT,182,198,380,8,Spring2019
6269,Beaverton Transit Center,9978,S,AT,601,490,1091,229,Spring2019
6270,Beaverton Transit Center,9979,N,AT,416,360,776,120,Spring2019
6271,Beaverton Transit Center,9981,S,AT,522,27,549,125,Spring2019
6272,Beaverton Transit Center,9982,S,AT,545,38,583,148,Spring2019
6273,Beaverton Transit Center,9983,S,AT,142,152,294,41,Spring2019
6274,Beaverton Transit Center,9984,N,AT,1042,848,1890,225,Spring2019
6275,Beaverton Transit Center,9985,S,AT,395,347,742,94,Spring2019
6276,Beaverton Transit Center,9986,S,AT,563,483,1046,131,Spring2019
6277,NE Evergreen & Jackson School Rd S,9987,W,OP,0,0,0,0,Spring2019
6278,NE Evergreen & Sunburst,9988,W,OP,0,0,0,0,Spring2019
6279,NE Evergreen & 3rd,9989,W,OP,1,0,1,0,Spring2019
6280,30900 Block NE Evergreen,9990,W,OP,0,0,0,0,Spring2019
6281,2800 Block NW Glencoe,9991,S,AT,7,1,8,0,Spring2019
6282,NW Glencoe & Cory,9992,S,FS,3,2,5,0,Spring2019
6283,3100 Block NW Glencoe,9993,S,AT,10,3,13,0,Spring2019
6284,NW Glencoe & Milne,9994,S,NS,1,2,3,0,Spring2019
6285,N 1st & NW Garibaldi,9995,S,NS,1,0,1,0,Spring2019
6286,N 1st & NW Tiffany,9996,S,NS,1,0,1,0,Spring2019
6287,300 Block N 1st,9997,S,AT,0,1,1,3,Spring2019
6288,NE Lincoln & 2nd,9998,E,NS,0,2,2,0,Spring2019
6289,NE 3rd & E Main,10000,S,NS,0,1,1,0,Spring2019
6290,5400 Block NE Dawson Creek,10001,W,AT,2,0,2,0,Spring2019
6291,NE Evergreen & Brookwood,10004,E,NS,1,2,3,0,Spring2019
6292,3100 Block NE Dawson Creek,10005,N,AT,2,4,6,41,Spring2019
6293,SE 223rd & Stark,10006,S,FS,13,57,70,15,Spring2019
6294,600 Block SE 223rd,10007,N,AT,3,7,10,2,Spring2019
6295,NW Cornell & 192nd,10008,W,OP,7,19,26,2,Spring2019
6296,NW Cornell & NE Amberglen (NW 194th),10009,W,FS,14,13,27,2,Spring2019
6297,NW Cornell & NE Overlook (NW Amberbrook),10010,W,NS,6,7,13,0,Spring2019
6298,NW Cornell & NE John Olsen,10011,W,NS,15,15,30,7,Spring2019
6299,NW Cornell & NE Aloclek,10013,W,FS,3,9,12,0,Spring2019
6300,NE Cornell & Cornelius Pass,10014,W,FS,3,7,10,2,Spring2019
6307,NE Cornell & Butler,10015,S,FS,11,12,23,7,Spring2019
6308,NE Cornell & Walbridge,10016,W,FS,4,4,8,2,Spring2019
6309,NW Cornell & NE Amberglen (NW Amberwood),10021,E,NS,17,20,37,8,Spring2019
6310,NW Cornell & NE Overlook (NW Amberbrook),10022,E,NS,5,4,9,1,Spring2019
6311,NW Cornell & NE John Olsen (NW 206th),10023,E,NS,22,13,35,10,Spring2019
6312,NW Cornell & 192nd,10024,E,NS,10,3,13,0,Spring2019
6313,NW Cornell & NE Aloclek,10025,E,FS,5,3,8,1,Spring2019
6314,NE Cornell & 25th,10026,E,FS,24,23,47,7,Spring2019
6315,NE Cornell & 48th,10028,E,NS,7,10,17,4,Spring2019
6316,NW Cornell & NE Cornelius Pass,10029,E,FS,4,4,8,0,Spring2019
6317,NE Cornell & Butler,10030,E,NS,14,18,32,7,Spring2019
6318,NE Cornell & NW Walbridge,10031,E,NS,7,7,14,1,Spring2019
6319,NE Cornell & Stucki (NW Amberglen),10032,E,FS,38,18,56,4,Spring2019
6320,NE Century (NW 231st) & Alder/Orenco Stn,10033,N,FS,7,24,31,3,Spring2019
6321,4100 Block SW 110th,10035,S,OP,48,0,48,0,Spring2019
6322,4200 Block SW 110th,10036,N,AT,1,51,52,0,Spring2019
6323,10200 Block SW Park Way,10037,W,AT,1,0,1,0,Spring2019
6324,NE Century (NW 231st) & Carillion,10041,S,NS,1,6,7,0,Spring2019
6325,NE Century (NW 231st) & Orenco Max Stn,10042,S,NS,27,98,125,7,Spring2019
6326,NE Century (NW 231st) & Dogwood,10043,S,NS,1,3,4,0,Spring2019
6327,NE Century (NW 231st) & Orenco Ridge,10044,S,FS,1,6,7,0,Spring2019
6328,E Main (W Baseline) & SE 58th Ct,10045,W,OP,0,1,1,0,Spring2019
6329,E Main (W Baseline) & NE 53rd,10046,W,NS,6,7,13,1,Spring2019
6330,E Main (W Baseline) & NE 49th,10047,W,NS,2,1,3,4,Spring2019
6331,E Main (W Baseline) & SE 58th Ct,10049,E,NS,2,0,2,1,Spring2019
6332,E Main (W Baseline) & NE 53rd,10050,E,NS,11,8,19,5,Spring2019
6333,E Main (W Baseline) & NE 49th,10051,E,NS,2,1,3,5,Spring2019
6334,NE Century (NW 231st) & Campus Way,10052,N,NS,6,2,8,1,Spring2019
6335,NE Century (NW 231st) & Dogwood,10053,N,NS,3,0,3,0,Spring2019
6336,NE Century (NW 231st) & Deer Run,10054,N,FS,5,1,6,0,Spring2019
6337,NE Evergreen Pkwy & 106th (NW 188th),10056,E,NS,12,35,47,5,Spring2019
6338,Dawson Creek & Brookwood,10061,N,FS,1,5,6,1,Spring2019
6339,Shute Rd & Dawson Creek Dr,10063,S,NS,2,1,3,0,Spring2019
6340,NW 31st & Guam,10071,S,NS,1,19,20,1,Spring2019
6341,3300 Block NW Guam,10072,W,AT,0,2,2,0,Spring2019
6342,NW Guam & 35th,10073,W,NS,0,17,17,0,Spring2019
6343,3300 Block NW 35th,10074,N,AT,0,8,8,0,Spring2019
6344,NW Kaiser & Snowlily Dr,10076,N,NS,2,6,8,0,Spring2019
6345,NW Kaiser & Two Ponds Dr,10077,N,FS,3,12,15,3,Spring2019
6346,15500 Block NW Springville,10078,W,AT,1,4,5,0,Spring2019
6347,NW Springville & 160th,10079,W,FS,3,8,11,0,Spring2019
6348,NW Springville & Sickle Terrace,10080,W,FS,1,6,7,0,Spring2019
6349,NW Springville & Joss,10081,W,NS,0,7,7,11,Spring2019
6350,NW Springville & Samuel Drive,10082,W,OP,0,1,1,0,Spring2019
6351,NW Springville & 173rd,10083,W,OP,0,3,3,0,Spring2019
6352,NW Bethany & Cornell,10084,N,FS,21,20,41,12,Spring2019
6353,NW Bethany & Bronson,10085,N,FS,6,12,18,1,Spring2019
6360,NW Bethany & Oak Hills Dr,10086,N,NS,4,8,12,0,Spring2019
6361,NW Bethany & Telshire Terrace,10087,N,NS,0,2,2,0,Spring2019
6362,NW Bethany & Ridgetop Lane,10088,N,NS,1,1,2,0,Spring2019
6363,NW Bethany & West Union,10089,N,FS,2,6,8,1,Spring2019
6364,NW Bethany & Saint Andrews,10090,N,FS,1,3,4,0,Spring2019
6365,NW Bethany & Mitchell,10091,N,NS,1,3,4,0,Spring2019
6366,4700 Block NW Bethany,10092,N,AT,7,44,51,6,Spring2019
6367,NW Bethany & Laidlaw,10093,N,NS,6,21,27,6,Spring2019
6368,NW Bethany & Kaiser Rd,10094,N,NS,6,8,14,1,Spring2019
6369,Pier Park,10095,E,AT,108,96,204,30,Spring2019
6370,NW Springville & Kaiser Rd,10098,E,NS,8,4,12,0,Spring2019
6371,NW Springville & Oats Terrace,10099,E,NS,8,3,11,0,Spring2019
6372,NW Springville & Sickle Terrace,10100,E,NS,5,0,5,0,Spring2019
6373,NW Springville & 165th Terrace,10101,E,OP,7,1,8,0,Spring2019
6374,NW Springville & Samuel Drive,10102,E,NS,0,0,0,0,Spring2019
6375,NW Springville & 173rd,10103,E,NS,6,1,7,0,Spring2019
6376,NW Kaiser & Westbrook,10104,S,NS,6,2,8,0,Spring2019
6377,NW Kaiser & Graf St,10105,S,NS,10,2,12,2,Spring2019
6378,NW Bethany & Wismer,10106,S,FS,7,5,12,1,Spring2019
6379,NW Bethany & Laidlaw,10107,S,NS,49,18,67,7,Spring2019
6380,4700 Block NW Bethany,10108,S,OP,29,4,33,3,Spring2019
6381,NW Bethany & Claremont Dr,10109,S,NS,5,1,6,0,Spring2019
6382,NW Bethany & Saint Andrews,10110,S,NS,2,1,3,0,Spring2019
6383,NW Bethany & West Union,10111,S,NS,7,3,10,1,Spring2019
6384,NW Bethany & Ridgetop Lane,10112,S,FS,3,1,4,0,Spring2019
6385,NW Bethany & Telshire Terrace,10113,S,FS,1,0,1,0,Spring2019
6386,NW Bethany & Oak Hills Dr,10114,S,FS,10,4,14,0,Spring2019
6387,NW Bethany & Cornell,10115,S,NS,14,14,28,4,Spring2019
6388,Goose Hollow/SW Jefferson St MAX Station,10117,W,AT,920,445,1365,0,Spring2019
6389,Goose Hollow/SW Jefferson St MAX Station,10118,E,AT,431,1320,1751,0,Spring2019
6390,Washington Park MAX Station,10120,E,AT,477,251,728,0,Spring2019
6391,Washington Park MAX Station,10121,W,AT,207,626,833,0,Spring2019
6392,20700 Block NE Halsey,10125,E,OP,4,15,19,1,Spring2019
6393,SW Baseline & Main,10129,W,FS,15,28,43,10,Spring2019
6394,SW Murray & Nike,10132,N,OP,6,9,15,0,Spring2019
6395,SW Murray & Nike,10133,S,NS,8,5,13,0,Spring2019
6396,SE Sunnyside & 122nd,10135,W,NS,24,6,30,5,Spring2019
6397,SE Sunnyside & 128th,10136,E,FS,1,4,5,0,Spring2019
6398,SE Sunnyside & 128th,10137,W,FS,4,1,5,0,Spring2019
6399,SE Sunnyside & 132nd,10138,E,FS,3,14,17,5,Spring2019
6400,SE Sunnyside & 132nd,10139,W,NS,11,1,12,2,Spring2019
6401,SE Sunnyside & 139th,10140,E,FS,1,7,8,3,Spring2019
6402,SE Sunnyside & 140th,10141,W,FS,3,0,3,1,Spring2019
6403,SE Sunnyside & 142nd,10142,E,FS,1,11,12,5,Spring2019
6404,SE Sunnyside & 142nd,10143,W,NS,12,1,13,1,Spring2019
6405,14600 Block SE 147th,10146,S,AT,3,3,6,1,Spring2019
6406,SE Oregon Trail Dr & Hines,10148,E,NS,5,4,9,7,Spring2019
6413,SE Lake & Freeman Way,10149,W,FS,4,1,5,0,Spring2019
6414,NW Evergreen Pkwy & NE Stucki,10150,N,FS,24,8,32,6,Spring2019
6415,NW Cedar Hills & Leahy,10152,S,FS,4,1,5,0,Spring2019
6416,NE Century (NW 231st) & Oelrich,10153,S,NS,0,1,1,0,Spring2019
6417,NE Century (NW 231st) & Oelrich,10154,N,NS,1,0,1,0,Spring2019
6418,NE Century (NW 229th) & Walbridge,10155,N,NS,2,3,5,1,Spring2019
6419,SE Tualatin Valley Hwy & 44th,10157,E,OP,25,32,57,111,Spring2019
6420,N Lombard & Terminal 5 Access Rd,10162,S,NS,0,1,1,0,Spring2019
6421,N Lombard & Terminal 5 Access Rd,10163,N,OP,1,0,1,0,Spring2019
6422,NW Springville & PCC Drive,10165,W,NS,0,5,5,1,Spring2019
6423,SW Farmington & 185th,10166,E,FS,109,116,225,23,Spring2019
6424,SW Columbia & 18th,10168,E,NS,207,206,413,13,Spring2019
6425,NW Glencoe & Cody Ct,10169,N,FS,2,1,3,0,Spring2019
6426,400 Block SW 257th,10170,N,AT,0,1,1,0,Spring2019
6427,400 Block SW 257th,10171,S,OP,2,0,2,1,Spring2019
6428,South Shore & Cedar Rd,10175,E,FS,2,2,4,21,Spring2019
6429,700 SW Campus Dr at Doernbecher,10176,E,AT,97,11,108,3,Spring2019
6430,N Ivanhoe & Leavitt,10177,W,FS,23,1,24,4,Spring2019
6431,Tigard Transit Center,10180,S,AT,145,89,234,29,Spring2019
6432,NE Alberta & 7th,10184,W,NS,12,24,36,29,Spring2019
6433,22600 Block SE Hwy 224,10185,W,OP,0,0,0,0,Spring2019
6434,22600 Block SE Hwy 224,10186,E,AT,0,1,1,0,Spring2019
6435,SE 28th & Carlton,10189,S,OP,2,1,3,1,Spring2019
6436,SE Tualatin Valley Hwy & 30th,10190,W,NS,6,13,19,7,Spring2019
6437,NE Cornell & Elam Young East,10192,W,OP,4,4,8,1,Spring2019
6438,NE Cornell & Brookwood Pkwy,10193,E,NS,1,2,3,4,Spring2019
6439,17600 Block NE Sandy,10194,W,AT,25,6,31,1,Spring2019
6440,SE Foster & 63rd,10196,E,FS,8,43,51,4,Spring2019
6441,NE Cornell & Brookwood Pkwy,10197,W,NS,1,1,2,3,Spring2019
6442,2200 Block NE Griffin Oaks,10198,W,OP,2,2,4,0,Spring2019
6443,SE Sunnyside & 122nd,10203,E,FS,6,25,31,9,Spring2019
6444,SE Mather & Cedar Park Dr,10204,W,NS,2,0,2,0,Spring2019
6445,10500 Block SE Mather,10205,E,OP,1,4,5,14,Spring2019
6446,SE Mather & Bliss,10206,E,FS,0,1,1,0,Spring2019
6447,SE Mather & 116th Ct,10208,E,NS,0,2,2,0,Spring2019
6448,SE Mather & 119th Ct,10209,E,OP,0,0,0,0,Spring2019
6449,SE Mather & 122nd,10210,E,NS,1,3,4,0,Spring2019
6450,SW Hart & Forest Drive,10211,E,OP,2,5,7,0,Spring2019
6451,SE Sunnyside & Valley View Terr,10214,W,FS,17,3,20,2,Spring2019
6452,SE Sunnyside & 119th,10216,W,OP,20,2,22,5,Spring2019
6453,SE Oregon Trail Dr & 152nd,10219,E,NS,0,0,0,0,Spring2019
6454,SE 152nd & Territory Dr,10221,S,FS,2,0,2,0,Spring2019
6455,SE 152nd & Bollam Dr,10222,N,NS,1,2,3,0,Spring2019
6456,SE 152nd & Morning Way,10223,S,NS,1,0,1,0,Spring2019
6457,SE 152nd & Morning Way,10224,N,OP,0,1,1,0,Spring2019
6458,13300 Block SE Hubbard,10225,W,OP,5,0,5,0,Spring2019
6459,13300 Block SE Hubbard,10226,E,AT,0,2,2,0,Spring2019
6466,SE Hubbard & 125th,10227,W,OP,4,0,4,0,Spring2019
6467,SE Hubbard & 125th,10228,E,FS,1,4,5,0,Spring2019
6468,SE 122nd & Mountain Sun Dr,10229,N,NS,3,1,4,0,Spring2019
6469,SE 122nd & Mountain Sun Dr,10230,S,FS,1,1,2,0,Spring2019
6470,SE 122nd & Echo Valley,10231,N,OP,1,0,1,0,Spring2019
6471,SE 122nd & Echo Valley,10232,S,FS,0,1,1,0,Spring2019
6472,SE 97th & Lawnfield,10234,S,NS,1,7,8,2,Spring2019
6473,SE 97th & Talbert Dr,10235,S,OP,1,2,3,0,Spring2019
6474,SW 170th & Timberland Dr,10273,S,OP,2,1,3,0,Spring2019
6475,SW 170th & Timberland Dr,10274,N,NS,2,2,4,0,Spring2019
6476,27500 Block SE Eagle Creek Rd,10275,N,AT,0,0,0,0,Spring2019
6477,NE 15th & Edgefield,10277,S,NS,1,3,4,0,Spring2019
6478,NE 15th & Edgefield,10278,N,OP,3,2,5,1,Spring2019
6479,NE 15th & Prahl Pkwy,10279,S,NS,3,2,5,0,Spring2019
6480,NE 15th & Prahl Pkwy,10280,N,OP,2,1,3,0,Spring2019
6481,NW 23rd & Overton,10287,S,NS,84,6,90,20,Spring2019
6482,1300 Block NE 25th,10288,N,AT,0,0,0,0,Spring2019
6483,1200 Block NE 25th,10289,S,AT,0,0,0,0,Spring2019
6484,SE Washington & 2nd,10290,E,NS,18,39,57,23,Spring2019
6485,NW St Helens & Marina Way,10291,N,FS,0,0,0,0,Spring2019
6486,PSU South/SW 6th & College MAX Stn,10293,N,NS,1041,434,1475,0,Spring2019
6487,SE 152nd & Sedona Drive,10297,S,FS,2,0,2,0,Spring2019
6488,MAX Station/Oregon Zoo,10299,W,AT,43,38,81,1,Spring2019
6489,SE 17th & Spokane,10302,N,NS,27,6,33,4,Spring2019
6490,SE King & Home,10303,W,FS,11,10,21,4,Spring2019
6491,Kerr & Touchstone,10305,W,NS,14,5,19,39,Spring2019
6492,SE Flavel & 92nd (MAX Stn),10307,W,NS,28,12,40,37,Spring2019
6493,SE 152nd & Ranger Drive,10308,N,NS,1,2,3,0,Spring2019
6494,NE Sandy & 154th,10309,E,NS,5,12,17,1,Spring2019
6495,SW Patton & Humphrey,10310,S,NS,1,21,22,0,Spring2019
6496,NW Cornell & 169th Pl,10313,W,OP,2,5,7,0,Spring2019
6497,2400 Block NW Westover,10314,N,OP,0,0,0,0,Spring2019
6498,NE Sandy & 181st/Airport Way,10315,E,FS,22,30,52,2,Spring2019
6499,NE Sandy & Airport Way/181st,10318,W,FS,40,21,61,6,Spring2019
6500,NW Cornell & 169th Pl,10319,E,NS,3,3,6,0,Spring2019
6501,SE McLoughlin & Glen Echo,10323,S,FS,23,41,64,36,Spring2019
6502,McLoughlin & Gloucester,10324,S,FS,14,45,59,40,Spring2019
6503,McLoughlin & River Rd,10325,S,NS,26,56,82,21,Spring2019
6504,SE McLoughlin & Glen Echo,10326,N,FS,42,28,70,18,Spring2019
6505,SE McLoughlin & W Gloucester,10327,N,FS,41,15,56,66,Spring2019
6506,McLoughlin & W Arlington,10328,N,FS,82,32,114,20,Spring2019
6507,19300 Block McLoughlin,10421,N,AT,5,3,8,5,Spring2019
6508,19300 Block McLoughlin,10422,S,AT,4,7,11,9,Spring2019
6509,NE Weidler & 15th,10425,E,NS,38,51,89,13,Spring2019
6510,SW Hart & 149th,10436,W,OP,1,3,4,0,Spring2019
6511,SW Hart & 149th,10437,E,FS,2,1,3,0,Spring2019
6512,NW Leahy & Alpenglow Way,10442,E,NS,0,0,0,0,Spring2019
6519,SW 170th & Division,10443,S,OP,4,2,6,0,Spring2019
6520,SW Dosch & Patton,10445,S,FS,0,0,0,0,Spring2019
6521,SE 82nd & Sunnybrook,10446,S,NS,9,12,21,3,Spring2019
6522,Oregon City Transit Center,10447,S,AT,82,83,165,38,Spring2019
6523,8300 Block SW Apple Way,10448,E,AT,0,1,1,0,Spring2019
6524,SE Belmont & 51st,10449,W,FS,13,8,21,1,Spring2019
6525,8400 Block NE 33rd Dr,10450,S,OP,10,0,10,0,Spring2019
6526,8400 Block NE 33rd Dr,10452,N,AT,0,19,19,0,Spring2019
6527,NE Sandy & 154th,10453,W,FS,9,3,12,0,Spring2019
6528,NE Shaver & 141st,10454,E,NS,5,16,21,2,Spring2019
6529,NW 35th & Yeon,10455,N,NS,0,15,15,0,Spring2019
6530,NW Evergreen Pkwy & NE Venetian (NW 196th),10457,W,NS,9,2,11,0,Spring2019
6531,NW Evergreen Pkwy & NE Venetian (NW 196th),10458,E,NS,4,8,12,0,Spring2019
6532,N Williams & Emerson,10463,N,NS,4,37,41,4,Spring2019
6533,W Baseline & SW 185th,10464,E,NS,1,12,13,1,Spring2019
6534,SW 45th & Vermont,10466,S,FS,1,0,1,0,Spring2019
6535,400 Block Beavercreek Rd,10469,E,AT,6,56,62,27,Spring2019
6536,2600 Block N Marine,10477,E,AT,0,1,1,0,Spring2019
6537,SE 52nd & Woodstock,10481,S,NS,20,63,83,9,Spring2019
6538,NE Evergreen & Evergreen Middle School,10482,E,AT,0,0,0,0,Spring2019
6539,SE Woodstock & 51st,10484,E,FS,7,44,51,5,Spring2019
6540,SE International Way & Criterion Ct,10489,S,OP,2,2,4,18,Spring2019
6541,SE International Way & Criterion Ct,10490,N,NS,4,4,8,27,Spring2019
6542,SW 5th & Hall,10491,S,NS,592,267,859,76,Spring2019
6543,NE M L King & Morgan,10494,S,NS,25,11,36,3,Spring2019
6544,SW Allen & 107th,10499,W,NS,1,5,6,0,Spring2019
6545,26300 Block SE Hwy 224,10500,E,OP,2,0,2,1,Spring2019
6546,26300 Block SE Hwy 224,10501,W,AT,0,1,1,0,Spring2019
6547,NE 92nd & Hill,10505,N,FS,2,5,7,4,Spring2019
6548,Ostman & Willamette Falls,10523,S,NS,1,1,2,0,Spring2019
6549,Blankenship & Debok,10548,W,NS,6,6,12,1,Spring2019
6550,NE Sandy & 185th Dr,10569,E,NS,6,12,18,1,Spring2019
6551,NE Fremont & 51st,10571,E,NS,3,2,5,0,Spring2019
6552,Parkrose/Sumner TC MAX Station,10572,N,AT,179,841,1020,0,Spring2019
6553,Parkrose/Sumner TC MAX Station,10573,S,AT,876,197,1073,0,Spring2019
6554,Cascades MAX Station,10574,W,AT,53,479,532,0,Spring2019
6555,Cascades MAX Station,10575,E,AT,484,60,544,0,Spring2019
6556,Mt Hood Ave MAX Station,10576,N,AT,52,313,365,0,Spring2019
6557,Mt Hood Ave MAX Station,10577,S,AT,308,62,370,0,Spring2019
6559,SE Sunnyside & 117th,10580,E,NS,4,9,13,1,Spring2019
6560,SW Park Pl & Wright,10589,E,NS,3,1,4,0,Spring2019
6561,N Vancouver Way & NE Walker St,10590,S,NS,33,5,38,22,Spring2019
6562,N Vancouver Way & NE Walker St,10591,N,FS,3,17,20,21,Spring2019
6563,SE Sunnyside & 117th,10592,W,NS,8,2,10,2,Spring2019
6564,SE Holgate & 85th,10593,W,NS,74,110,184,105,Spring2019
6565,NE Fremont & 45th,10594,W,FS,14,5,19,1,Spring2019
6572,NE Fremont & 45th,10596,E,OP,6,9,15,0,Spring2019
6573,NE Fremont & 68th,10597,E,FS,7,9,16,12,Spring2019
6574,SW Halsey & Edgefield Meadows,10598,E,NS,1,10,11,0,Spring2019
6575,SW Murray & Millikan Way,10599,N,NS,4,12,16,1,Spring2019
6576,NE Killingsworth & Cully,10600,E,FS,132,77,209,23,Spring2019
6577,NE Killingsworth & Cully,10601,W,NS,157,244,401,29,Spring2019
6578,300 Block NE Division,10602,W,AT,33,4,37,5,Spring2019
6579,N Willis & Chautauqua,10611,W,NS,14,42,56,2,Spring2019
6580,3515 SW US Veterans Rd,10612,W,OP,71,101,172,0,Spring2019
6581,N Fessenden & Tioga,10614,E,NS,14,5,19,6,Spring2019
6582,SW Park Way & 134th,10615,W,OP,0,0,0,0,Spring2019
6583,SW Halsey & Edgefield Meadows,10630,W,OP,10,0,10,0,Spring2019
6584,SW Hall & Avon,10631,S,NS,6,36,42,1,Spring2019
6585,SW Canyon & Camelot Ct,10632,W,FS,12,48,60,25,Spring2019
6586,SW Canyon & Canyon Crest,10633,W,OP,3,9,12,0,Spring2019
6587,SW Canyon & Canyon Crest,10634,E,NS,8,5,13,19,Spring2019
6588,11600 Block SW Pacific Hwy,10639,W,AT,32,152,184,13,Spring2019
6589,SW Tualatin Valley Hwy & Hocken,10641,W,FS,60,37,97,19,Spring2019
6590,SE Lake & Hwy 224,10644,W,FS,1,2,3,0,Spring2019
6591,2300 Block SW 257th,10645,N,AT,0,3,3,1,Spring2019
6592,SW 257th & 24th,10646,S,FS,1,0,1,0,Spring2019
6593,22000 Block SE Hwy 224,10647,W,OP,2,0,2,0,Spring2019
6594,N Fremont & Kerby,10649,E,FS,56,17,73,7,Spring2019
6595,N Fremont & Kerby,10650,W,NS,12,28,40,0,Spring2019
6596,SE Lake & Hwy 224,10653,E,NS,1,2,3,0,Spring2019
6597,NE Hood & 5th,10654,N,NS,0,4,4,0,Spring2019
6598,NE Hood & 2nd,10657,N,NS,0,13,13,3,Spring2019
6599,SE Hwy 224 & Eilers Circle,10695,W,OP,0,0,0,0,Spring2019
6600,SE Hwy 224 & Eilers Circle,10696,E,FS,0,0,0,0,Spring2019
6601,Pier Park,10697,E,AT,174,170,344,75,Spring2019
6602,10900 Block SW 121st,10698,S,OP,4,1,5,0,Spring2019
6603,2900 Block NE 181st,10699,S,AT,22,4,26,2,Spring2019
6604,Oatfield & E Exeter,10700,N,OP,10,3,13,2,Spring2019
6605,SW Harbor & Harrison,10712,S,FS,30,2,32,1,Spring2019
6606,SW Harbor & River Pkwy,10713,N,FS,1,38,39,0,Spring2019
6607,NW Division & Norman,10714,W,NS,28,5,33,15,Spring2019
6608,NE Sandy & 102nd,10715,E,NS,21,10,31,7,Spring2019
6609,NE Airport Way & Win Sivers Drive,10716,E,NS,13,23,36,3,Spring2019
6610,13100 Block NE Airport Way,10717,E,AT,4,8,12,1,Spring2019
6611,NE Airport Way & 148th,10718,E,FS,6,8,14,2,Spring2019
6612,NE Airport Way & 152nd Pl,10719,E,OP,1,3,4,0,Spring2019
6613,16400 Block NE Airport Way,10720,E,AT,1,3,4,0,Spring2019
6614,NE Airport Way & Sandy Blvd,10721,S,NS,12,8,20,3,Spring2019
6615,NE 181st & Sandy,10723,N,NS,5,38,43,4,Spring2019
6616,16300 Block NE Airport Way,10724,W,AT,2,3,5,1,Spring2019
6617,15300 Block NE Airport Way,10725,W,AT,2,2,4,0,Spring2019
6618,NE Airport Way & 148th,10726,W,NS,7,11,18,2,Spring2019
6625,NE Airport Way & 138th,10727,W,NS,11,9,20,2,Spring2019
6626,12900 Block NE Airport Way,10728,W,AT,6,6,12,3,Spring2019
6627,NE Airport Way & 122nd,10729,W,NS,15,16,31,3,Spring2019
6628,NE Airport Way & Glenn Widing,10730,W,FS,24,21,45,2,Spring2019
6629,11000 Block NE Holman,10731,W,OP,10,4,14,1,Spring2019
6630,NE 105th & Simpson,10732,S,FS,1,4,5,1,Spring2019
6631,NE 105th & Marx,10733,S,NS,3,0,3,0,Spring2019
6632,NE 105th & Killingsworth,10734,S,FS,1,2,3,0,Spring2019
6633,NE Weidler & 103rd Pl,10746,W,FS,48,61,109,60,Spring2019
6634,NE Halsey & 102nd,10747,E,NS,97,77,174,50,Spring2019
6635,SW Cedar Hills & Celeste,10749,S,NS,9,3,12,1,Spring2019
6636,SW Cedar Hills & Celeste,10761,N,FS,5,9,14,0,Spring2019
6637,NE Sandy & 105th,10779,E,NS,14,17,31,3,Spring2019
6638,NE Sandy & 107th,10780,E,NS,12,11,23,7,Spring2019
6639,NE Sandy & 109th,10781,E,NS,8,8,16,7,Spring2019
6640,NE Sandy & 112th,10782,E,NS,5,19,24,4,Spring2019
6641,NE Sandy & 115th,10783,E,NS,7,16,23,6,Spring2019
6642,NE Sandy & 118th,10784,E,FS,14,9,23,3,Spring2019
6643,NE Sandy & 125th Pl,10785,E,NS,17,11,28,5,Spring2019
6644,NE Sandy & 131st Pl,10786,E,NS,7,11,18,1,Spring2019
6645,NE Sandy & 133rd,10787,E,FS,8,16,24,18,Spring2019
6646,NE Sandy & 138th,10788,E,FS,24,51,75,16,Spring2019
6647,14300 Block NE Sandy,10789,E,AT,3,2,5,1,Spring2019
6648,NE Sandy & 148th,10790,E,NS,9,20,29,3,Spring2019
6649,W Burnside & NW 10th,10791,W,FS,139,191,330,77,Spring2019
6650,W Burnside & SW 10th,10792,E,NS,247,99,346,60,Spring2019
6651,NE Sandy & 38th,10793,E,OP,13,61,74,33,Spring2019
6652,NE Sandy & 74th,10795,E,FS,8,33,41,6,Spring2019
6653,7500 Block SW 45th,10801,S,AT,0,0,0,0,Spring2019
6654,NW Thurman & 24th,10808,E,NS,11,0,11,4,Spring2019
6655,W Burnside & NW 17th,10809,W,NS,15,65,80,15,Spring2019
6656,NE Prescott & 89th,10820,W,NS,4,1,5,1,Spring2019
6657,NW Eastman & Burnside,10821,N,FS,18,8,26,20,Spring2019
6658,NE Sandy & 148th,10822,W,NS,14,6,20,5,Spring2019
6659,NE Sandy & 138th,10823,W,NS,62,28,90,36,Spring2019
6660,14300 Block NE Sandy,10824,W,OP,3,4,7,0,Spring2019
6661,NE Sandy & 133rd,10825,W,OP,5,4,9,1,Spring2019
6662,NE Sandy & 131st Pl,10826,W,FS,10,6,16,1,Spring2019
6663,NE Sandy & 125th Pl,10827,W,OP,10,11,21,3,Spring2019
6664,NE Sandy & 118th,10828,W,FS,6,11,17,2,Spring2019
6665,NE Sandy & 115th,10829,W,OP,11,4,15,4,Spring2019
6666,NE Sandy & 112th,10830,W,NS,21,7,28,3,Spring2019
6667,NE Sandy & 109th,10831,W,FS,5,8,13,1,Spring2019
6668,NE Sandy & 107th,10832,W,OP,10,13,23,7,Spring2019
6669,NE Sandy & 44th,10834,W,FS,54,46,100,42,Spring2019
6670,SE Eagle Creek Rd & Duus Rd,10835,S,OP,0,0,0,0,Spring2019
6671,SE Eagle Creek Rd & Duus Rd,10836,N,FS,0,0,0,0,Spring2019
6678,NE 102nd & Prescott,10838,S,NS,22,7,29,5,Spring2019
6679,NE 102nd & Shaver,10840,S,NS,3,0,3,1,Spring2019
6680,NE 102nd & Prescott,10842,N,NS,8,18,26,12,Spring2019
6681,SW Barbur & Spring Garden,10844,W,OP,7,27,34,2,Spring2019
6682,SW Barbur & Huber,10845,W,NS,32,48,80,12,Spring2019
6683,NE Jonesmore & 82nd,10846,W,NS,78,350,428,52,Spring2019
6684,SW Barbur & Bertha,10848,E,NS,107,38,145,15,Spring2019
6685,SW Barbur & 26th Way,10849,E,AT,16,2,18,2,Spring2019
6686,Parkrose/ Sumner Transit Center,10850,W,AT,440,426,866,148,Spring2019
6687,Parkrose/ Sumner Transit Center,10853,E,AT,13,248,261,62,Spring2019
6688,Parkrose/ Sumner Transit Center,10854,E,AT,371,45,416,45,Spring2019
6689,Parkrose/ Sumner Transit Center,10855,E,AT,403,8,411,53,Spring2019
6690,Gresham Transit Center,10858,E,AT,431,393,824,73,Spring2019
6691,Gresham Transit Center,10859,W,AT,188,160,348,23,Spring2019
6692,Gateway Transit Center,10860,S,AT,177,20,197,65,Spring2019
6693,Gateway Transit Center,10861,S,AT,186,15,201,89,Spring2019
6694,Gateway Transit Center,10862,S,AT,202,26,228,35,Spring2019
6695,Gateway Transit Center,10863,S,AT,183,130,313,25,Spring2019
6696,SW 36th & Capitol Hwy,10865,S,NS,5,4,9,0,Spring2019
6697,NE 9th & Halsey,10866,N,NS,20,46,66,17,Spring2019
6698,NE 9th & Weidler,10867,S,NS,26,27,53,20,Spring2019
6699,Hollywood Transit Center,10868,E,AT,350,349,699,77,Spring2019
6700,Hollywood Transit Center,10869,E,AT,106,80,186,51,Spring2019
6701,Hollywood Transit Center,10870,E,AT,90,118,208,60,Spring2019
6702,Hollywood Transit Center,10871,E,AT,39,39,78,3,Spring2019
6703,Hollywood Transit Center,10872,N,AT,368,358,726,85,Spring2019
6704,SW Pacific Hwy & Main,10873,E,FS,18,7,25,1,Spring2019
6705,NE Sandy & 185th Dr,10874,W,FS,9,13,22,1,Spring2019
6706,NE Multnomah & 9th,10876,W,FS,88,49,137,17,Spring2019
6707,E Burnside & NE 102nd,10877,W,FS,100,151,251,76,Spring2019
6708,NE Kane & 29th (MHCC),10878,S,FS,93,116,209,49,Spring2019
6709,"NE Kane & 29th, MHCC",10879,N,NS,132,94,226,48,Spring2019
6710,SE 103rd Dr & Stark,10910,N,FS,87,121,208,75,Spring2019
6711,SW Walnut & 121st,10913,E,FS,4,6,10,0,Spring2019
6712,SW Capitol & 40th,10932,S,NS,0,1,1,0,Spring2019
6713,SW Capitol & Garden Home,10933,S,FS,9,28,37,0,Spring2019
6714,SW Capitol & Taylors Ferry,10935,N,FS,43,9,52,23,Spring2019
6715,5600 Block SE International Way,10939,N,AT,3,3,6,0,Spring2019
6716,NE Evergreen Pkwy & Imbrie Dr,10940,N,NS,24,9,33,1,Spring2019
6717,NE Evergreen Pkwy & Imbrie Dr,10941,S,NS,5,29,34,1,Spring2019
6718,SW Capitol & Huber,10952,S,NS,30,56,86,4,Spring2019
6719,NE Grand & Wasco,10953,N,NS,155,49,204,36,Spring2019
6720,NE Killingsworth & Garfield,10957,W,NS,161,110,271,106,Spring2019
6721,N Willamette & Burr,10975,S,OP,9,0,9,0,Spring2019
6722,NE Airport Way & 158th,10994,E,FS,5,13,18,3,Spring2019
6723,NE Airport Way & 158th,10995,W,NS,5,6,11,1,Spring2019
6724,SW Harbor & Montgomery,11001,S,OP,19,2,21,0,Spring2019
6731,SW Harbor & Montgomery,11002,N,NS,1,17,18,0,Spring2019
6732,SW Tualatin Valley Hwy & 153rd,11003,W,NS,4,5,9,0,Spring2019
6733,SE 103rd Dr & Washington,11005,N,NS,31,40,71,41,Spring2019
6734,N Marine & Portland Rd,11006,W,FS,1,1,2,0,Spring2019
6735,N Fessenden & Seneca,11007,E,FS,70,22,92,13,Spring2019
6736,NE Columbia Blvd & 52nd (NAYA),11009,W,OP,29,31,60,6,Spring2019
6737,SW Terwilliger & Campus,11010,S,NS,4,192,196,4,Spring2019
6738,SW Barnes & 117th,11012,W,OP,1,5,6,1,Spring2019
6739,NE Airport Way & Riverside,11014,E,NS,13,12,25,3,Spring2019
6740,NE Airport Way & Riverside,11015,W,NS,2,19,21,2,Spring2019
6741,NW St Helens & Riverview Drive,11016,N,OP,0,1,1,0,Spring2019
6742,NW Glencoe & Cody Ct,11024,S,FS,1,1,2,0,Spring2019
6743,10500 Block SE Cherry Blossom,11026,E,AT,10,17,27,11,Spring2019
6744,SE 106th & Cherry Blossom,11027,N,NS,37,44,81,46,Spring2019
6745,SE Harold & 133rd,11029,E,NS,1,5,6,1,Spring2019
6746,SW Pacific Hwy & Garrett,11030,E,FS,24,8,32,1,Spring2019
6747,SW Barbur & 22nd,11031,E,FS,18,7,25,1,Spring2019
6748,W Burnside & NW 12th,11032,W,FS,105,153,258,85,Spring2019
6749,SE Stark & 155th Pl,11071,W,NS,22,7,29,4,Spring2019
6750,NE Sandy & 158th,11072,W,NS,38,35,73,6,Spring2019
6751,SE 181st Ave & 180th Ave,11073,S,FS,19,20,39,12,Spring2019
6752,Washington & 14th,11111,S,NS,3,7,10,2,Spring2019
6753,SW Rose Garden Way & Sherwood,11151,S,NS,5,5,10,0,Spring2019
6754,NE Sunderland & 33rd Dr,11171,S,FS,0,5,5,1,Spring2019
6755,SW Bertha & Barbur,11211,E,NS,15,10,25,1,Spring2019
6756,NE 181st & Wilkes,11231,S,OP,6,3,9,6,Spring2019
6757,SE 82nd & Sunnybrook,11251,N,FS,10,19,29,9,Spring2019
6758,SW Barbur & 13th,11271,N,OP,32,28,60,4,Spring2019
6759,SW Palatine Hill & Lewis & Clark Gate 3,11311,N,FS,15,0,15,0,Spring2019
6760,SW Palatine Hill & Lewis & Clark Gate 6,11312,W,NS,0,6,6,0,Spring2019
6761,NE Sandy & Cesar Chavez Blvd,11313,W,NS,109,38,147,34,Spring2019
6762,2nd & Tumwater,11331,E,NS,2,7,9,1,Spring2019
6763,SE 106th & Cherry Blossom,11411,S,FS,46,29,75,46,Spring2019
6764,10000 Block SE Stevens Rd,11453,S,OP,1,13,14,3,Spring2019
6765,10100 Block SE Stevens Rd,11454,N,AT,10,7,17,4,Spring2019
6766,NE Alberta & 21st,11471,E,NS,40,46,86,8,Spring2019
6767,NE Alberta & 21st,11472,W,NS,49,51,100,12,Spring2019
6768,1400 Block Molalla,11473,N,OP,10,2,12,1,Spring2019
6769,Beavercreek & Fir St,11475,E,FS,1,5,6,0,Spring2019
6770,NE Alberta & 7th,11478,E,NS,19,16,35,4,Spring2019
6771,NW St Helens & Marina Way,11479,S,OP,0,0,0,0,Spring2019
6772,N Williams & NE Weidler,11480,N,NS,36,52,88,19,Spring2019
6773,500 Block Molalla,11481,S,AT,4,5,9,0,Spring2019
6774,500 Block Molalla,11482,N,OP,4,3,7,1,Spring2019
6775,SE Grand & Taylor,11483,N,NS,68,23,91,8,Spring2019
6776,SE Grand & Belmont,11484,N,FS,91,42,133,22,Spring2019
6777,SW 6th & Columbia,11486,N,NS,108,287,395,38,Spring2019
6784,NE Cesar Chavez Blvd & Halsey,11487,N,NS,1,27,28,7,Spring2019
6785,NW St Helens & 112th,11490,S,FS,3,0,3,0,Spring2019
6786,NE Multnomah & 3rd,11492,W,FS,79,23,102,25,Spring2019
6787,SE 82nd Dr & Strawberry,11496,N,NS,7,2,9,1,Spring2019
6788,Expo Center MAX Station,11498,S,AT,596,602,1198,0,Spring2019
6789,Delta Park/Vanport MAX Station,11499,S,AT,940,49,989,0,Spring2019
6790,Kenton/N Denver Ave MAX Station,11500,S,AT,486,95,581,0,Spring2019
6791,N Lombard TC MAX Station,11501,S,AT,1156,225,1381,0,Spring2019
6792,Rosa Parks MAX Station,11502,S,AT,592,145,737,0,Spring2019
6793,N Killingsworth St MAX Station,11503,S,AT,709,265,974,0,Spring2019
6794,N Prescott St MAX Station,11504,S,AT,423,181,604,0,Spring2019
6795,Overlook Park MAX Station,11505,S,AT,410,118,528,0,Spring2019
6796,Albina/Mississippi MAX Station,11506,S,AT,229,95,324,0,Spring2019
6797,Interstate/Rose Quarter MAX Station,11507,S,AT,258,1307,1565,0,Spring2019
6798,Interstate/Rose Quarter MAX Station,11508,N,AT,1272,493,1765,0,Spring2019
6799,Albina/Mississippi MAX Station,11509,N,AT,118,233,351,0,Spring2019
6800,Overlook Park MAX Station,11510,N,AT,124,420,544,0,Spring2019
6801,N Prescott St MAX Station,11511,N,AT,183,457,640,0,Spring2019
6802,N Killingsworth St MAX Station,11512,N,AT,250,770,1020,0,Spring2019
6803,Rosa Parks MAX Station,11513,N,AT,143,630,773,0,Spring2019
6804,N Lombard TC MAX Station,11514,N,AT,212,1150,1362,0,Spring2019
6805,Kenton/N Denver Ave MAX Station,11515,N,AT,86,435,521,0,Spring2019
6806,Delta Park/Vanport MAX Station,11516,N,AT,62,962,1024,0,Spring2019
6807,SE Sunnyside & Stevens,11520,E,FS,14,30,44,18,Spring2019
6808,SW Scholls Ferry & Murray,11521,W,NS,63,51,114,2,Spring2019
6809,NE Alberta & 30th,11722,E,NS,21,32,53,10,Spring2019
6810,SE Powell & 125th Pl,11742,E,FS,12,40,52,7,Spring2019
6811,Willamette Falls Dr & West A,11762,N,NS,1,2,3,0,Spring2019
6812,Willamette Falls Dr & West A,11763,S,FS,1,3,4,0,Spring2019
6813,Willamette Falls Dr & 6th St,11764,W,OP,0,0,0,0,Spring2019
6814,Willamette Falls Dr & 6th St,11765,E,FS,0,0,0,0,Spring2019
6815,Willamette Falls Dr & 11th St,11766,E,NS,2,0,2,0,Spring2019
6816,E Main (W Baseline) & NE 63rd,11770,E,OP,6,4,10,2,Spring2019
6817,E Main (W Baseline) & NE 63rd,11771,W,NS,2,3,5,2,Spring2019
6818,NE Sandy & Arborcrest Dr,11772,W,FS,3,6,9,1,Spring2019
6819,NE Sandy & Blossom Hill,11773,E,FS,6,3,9,1,Spring2019
6820,Boones Ferry Rd & Mercantile Dr,11775,S,NS,1,2,3,0,Spring2019
6821,Boones Ferry Rd & Oakridge,11776,S,NS,3,2,5,0,Spring2019
6822,Boones Ferry Rd & Washington Ct,11777,S,NS,1,1,2,0,Spring2019
6823,Boones Ferry Rd & Pilkington,11778,S,OP,1,1,2,0,Spring2019
6824,Boones Ferry Rd & Jean,11779,S,NS,0,1,1,0,Spring2019
6825,Boones Ferry Rd & Jean,11780,N,NS,1,1,2,0,Spring2019
6826,Boones Ferry Rd & Pilkington,11781,N,NS,1,1,2,0,Spring2019
6827,Boones Ferry Rd & Washington Ct,11782,N,OP,1,0,1,0,Spring2019
6828,Boones Ferry Rd & Reese Rd,11783,N,FS,5,1,6,0,Spring2019
6829,Boones Ferry Rd & Mercantile Dr,11784,N,OP,3,3,6,0,Spring2019
6830,SE Powell & 156th,11786,W,FS,15,7,22,21,Spring2019
6837,SW Vermont & Idaho Dr,11789,E,FS,9,4,13,3,Spring2019
6838,3400 Block McNary,11804,W,AT,0,2,2,0,Spring2019
6839,South Shore & Patton,11805,E,OP,0,1,1,0,Spring2019
6840,SW Farmington & Hall,11810,E,FS,4,24,28,5,Spring2019
6841,N Interstate & Multnomah (Rose Quarter),11813,S,NS,25,123,148,7,Spring2019
6842,N Interstate & Rose Quarter TC,11814,N,AT,115,33,148,9,Spring2019
6843,NE Sandy & 172nd Pl,11815,W,FS,6,7,13,1,Spring2019
6844,NE Sandy & 172nd Pl,11816,E,NS,6,10,16,1,Spring2019
6845,Rose Quarter Transit Center,11817,E,NS,215,290,505,120,Spring2019
6846,N Macrum & Powers,11824,N,OP,4,0,4,0,Spring2019
6847,N Columbia Blvd & Oregonian,11825,W,NS,0,0,0,0,Spring2019
6848,N Columbia Blvd & Bank,11826,W,NS,0,0,0,0,Spring2019
6849,N Columbia Blvd & Upland Dr,11827,W,FS,0,1,1,0,Spring2019
6850,N Columbia Blvd & Swift,11828,W,FS,1,2,3,2,Spring2019
6851,N Marine & Pier 99 St,11829,S,OP,3,25,28,1,Spring2019
6852,NE Walker & N Vancouver Way,11830,W,NS,0,4,4,0,Spring2019
6853,NE Glisan & 74th,11831,W,NS,34,7,41,4,Spring2019
6854,N Marine & Pier 99 St,11832,N,NS,30,1,31,1,Spring2019
6855,N Columbia Blvd & Upland Dr,11833,E,NS,0,0,0,0,Spring2019
6856,N Columbia Blvd & Bank,11834,E,OP,0,0,0,0,Spring2019
6857,N Columbia Blvd & Oregonian,11835,E,FS,0,0,0,0,Spring2019
6858,N Macrum & Powers,11836,S,NS,0,3,3,0,Spring2019
6859,N Ivanhoe & Baltimore,11837,S,FS,3,13,16,4,Spring2019
6860,N Columbia Blvd & Hendricks,11838,E,NS,4,1,5,1,Spring2019
6861,N Interstate & Albina,11839,N,FS,16,10,26,0,Spring2019
6862,N Interstate & Tillamook,11840,N,FS,1,8,9,1,Spring2019
6863,N Interstate & Tillamook,11844,S,NS,4,2,6,0,Spring2019
6864,N Interstate & Larrabee,11845,S,NS,1,2,3,0,Spring2019
6865,Molalla & Garden Meadow,11846,S,FS,3,9,12,5,Spring2019
6866,9500 Block N Columbia Blvd,11849,S,OP,0,0,0,0,Spring2019
6867,9500 Block N Columbia Blvd,11850,N,AT,0,0,0,0,Spring2019
6868,SW Hocken & Cedar Hills Xing Entrance,11851,N,AT,25,40,65,31,Spring2019
6869,SW Hocken & Cedar Hills Xing Entrance,11852,S,OP,32,21,53,19,Spring2019
6870,SE Powell & 57th,11920,E,NS,22,30,52,5,Spring2019
6871,SE Powell & 62nd,11921,E,FS,9,30,39,3,Spring2019
6872,SE Powell & 75th,11922,E,OP,10,35,45,16,Spring2019
6873,SE Powell & 75th,11923,W,FS,45,14,59,34,Spring2019
6874,SE Powell & 65th,11924,W,FS,47,9,56,14,Spring2019
6875,SE Powell & 55th,11925,W,FS,38,51,89,5,Spring2019
6876,SE Bob Schumacher & Monterey,11926,S,FS,3,4,7,3,Spring2019
6877,SE Bob Schumacher & Monterey,11927,N,NS,2,2,4,2,Spring2019
6878,SE Sunnyside & Sunnybrook,11928,W,OP,0,0,0,0,Spring2019
6879,SE Sunnyside & 105th,11929,W,NS,7,4,11,3,Spring2019
6880,12700 Block SE Hwy 212,11930,E,AT,0,2,2,0,Spring2019
6881,12700 Block SE Hwy 212,11931,W,OP,2,0,2,0,Spring2019
6882,Molalla & Mountain View,11932,N,OP,8,3,11,1,Spring2019
6883,Molalla & Mountain View,11933,S,NS,4,10,14,1,Spring2019
6890,N Ivanhoe & New York,11934,N,FS,2,0,2,0,Spring2019
6891,N Ivanhoe & Chicago,11935,S,NS,0,1,1,0,Spring2019
6892,N St Louis & Central,11936,E,NS,13,1,14,15,Spring2019
6893,Sunset Transit Center,11939,W,AT,465,418,883,107,Spring2019
6894,16800 Block SW 72nd,11944,N,AT,161,11,172,7,Spring2019
6895,17000 Block SW 72nd,11945,S,AT,7,49,56,6,Spring2019
6896,N Cutter Circle & Leverman,11947,E,FS,9,27,36,1,Spring2019
6897,6000 Block N Cutter Circle,11948,N,AT,13,13,26,0,Spring2019
6898,6300 Block N Cutter Circle,11949,N,AT,4,2,6,0,Spring2019
6899,N Leverman & Cutter Circle,11950,S,NS,11,5,16,1,Spring2019
6900,SE 122nd & Summers Lane,11952,N,NS,13,3,16,0,Spring2019
6901,SE 122nd & Summers Lane,11953,S,FS,2,9,11,0,Spring2019
6902,SW Main & 2nd,11956,W,NS,103,1212,1315,77,Spring2019
6903,SE Clackamas Rd & Johnson,11958,W,NS,1,0,1,0,Spring2019
6904,SE Johnson & Cypress,11959,N,OP,1,1,2,0,Spring2019
6905,SE Johnson & Thiessen,11960,N,OP,0,0,0,0,Spring2019
6906,14400 Block SE Johnson,11961,N,AT,10,3,13,1,Spring2019
6907,SE Johnson & Lake,11962,N,FS,33,9,42,5,Spring2019
6908,SE Johnson & Lake,11963,S,OP,13,37,50,7,Spring2019
6909,14400 Block SE Johnson,11964,S,AT,4,1,5,1,Spring2019
6910,SE Johnson & Thiessen,11965,S,NS,1,2,3,0,Spring2019
6911,SE Johnson & Cypress,11966,S,NS,0,1,1,0,Spring2019
6912,SE Clackamas Rd & Johnson,11967,E,FS,0,1,1,0,Spring2019
6913,SE McKinley & Hood,11968,S,FS,2,1,3,0,Spring2019
6914,SE Sunnyside & Sunnybrook,11970,E,NS,0,2,2,0,Spring2019
6915,SW Walnut & 114th,11973,W,FS,2,1,3,0,Spring2019
6916,N Broadway & Benton,12374,W,NS,17,9,26,10,Spring2019
6917,N Leverman & Basin,12383,E,FS,1,5,6,0,Spring2019
6918,SW Taylors Ferry & Picasso Pl,12387,W,FS,1,1,2,0,Spring2019
6919,SE Stark & 187th,12397,W,NS,57,122,179,49,Spring2019
6920,SE Stark & 187th,12398,E,FS,102,54,156,37,Spring2019
6921,SW Hall & Greenburg,12402,W,NS,2,3,5,1,Spring2019
6922,SW Greenburg & Washington Square Rd,12403,N,FS,45,34,79,16,Spring2019
6923,SW Greenburg & Washington Square Rd,12404,S,NS,26,48,74,5,Spring2019
6924,SW Canyon & 103rd,12405,E,NS,16,19,35,5,Spring2019
6925,SW Canyon & 91st,12406,W,OP,5,6,11,0,Spring2019
6926,SW Farmington & Erickson,12451,W,NS,27,16,43,4,Spring2019
6927,10200 Block SE Main,12462,N,AT,0,0,0,0,Spring2019
6928,10200 Block SE Main,12463,S,OP,0,0,0,0,Spring2019
6929,N Marine & Portland Rd,12465,E,FS,0,0,0,0,Spring2019
6930,5700 Block SW Hamilton,12466,W,AT,0,0,0,0,Spring2019
6931,SW Chestnut & 12th Dr,12467,N,NS,5,2,7,0,Spring2019
6932,SW Hall & Wall,12468,S,NS,5,19,24,16,Spring2019
6933,NE Division & Kelly,12707,E,FS,16,2,18,3,Spring2019
6934,N Fessenden & Haven,12725,W,NS,75,109,184,32,Spring2019
6935,N Fessenden & Haven,12726,E,NS,115,75,190,18,Spring2019
6936,N Trenton & Newman,12727,W,NS,102,165,267,68,Spring2019
6943,10000 Block SW Terwilliger,12729,E,OP,0,5,5,0,Spring2019
6944,SW Bertha & Vermont,12730,N,NS,3,3,6,0,Spring2019
6945,SW Huddleson & Palatine Hill,12731,E,FS,13,9,22,0,Spring2019
6946,L & C Campus & Templeton Student Center,12732,N,AT,10,2,12,0,Spring2019
6947,Pacific Hwy & Tualatin Rvr Refuge,12743,W,AT,0,2,2,0,Spring2019
6948,SW Murray & Brockman,12746,N,NS,14,0,14,1,Spring2019
6949,N Trenton & Dwight,12750,E,NS,164,112,276,73,Spring2019
6950,4200 Block NW Yeon,12754,E,OP,2,0,2,0,Spring2019
6951,SE 82nd & Harrison,12755,N,NS,45,24,69,12,Spring2019
6952,SW Moody & Gibbs,12760,S,NS,107,100,207,14,Spring2019
6953,E Burnside & SE 69th,12761,E,FS,4,12,16,2,Spring2019
6954,SW 4th & Caruthers,12762,N,NS,26,55,81,2,Spring2019
6955,SW 4th & Hall,12763,N,NS,120,351,471,18,Spring2019
6956,SW Jefferson & 1st,12789,W,FS,4,404,408,18,Spring2019
6957,SW Jefferson between 4th & 5th,12790,W,FS,154,166,320,78,Spring2019
6958,SW Jefferson & 5th,12791,W,NS,152,160,312,42,Spring2019
6959,SW Columbia & 16th,12792,E,OP,116,41,157,13,Spring2019
6960,SW Columbia between 6th & 5th,12793,E,FS,168,268,436,65,Spring2019
6961,SW Columbia between 5th & 4th,12794,E,FS,426,9,435,32,Spring2019
6962,SW Oak & 1st,12798,W,NS,25,75,100,10,Spring2019
6963,NW Broadway & Hoyt,12805,S,NS,42,105,147,97,Spring2019
6964,E Columbia River Hwy & SE Harlow,12838,E,NS,0,1,1,0,Spring2019
6965,SE Main & Beta,12842,W,OP,0,2,2,0,Spring2019
6966,16200 Block SW Langer,12849,E,AT,21,4,25,13,Spring2019
6967,SE Tualatin Valley Hwy & Brookwood,12851,W,FS,54,65,119,11,Spring2019
6968,SW Lower Boones Ferry & 65th,12852,W,NS,0,5,5,0,Spring2019
6969,W Powell & N Main,12862,W,FS,26,4,30,9,Spring2019
6970,W Powell & NW Wilson,12863,W,FS,10,5,15,15,Spring2019
6971,W Powell & NW Willowbrook,12864,W,NS,2,1,3,1,Spring2019
6972,W Powell & NW Wilson,12866,E,OP,8,7,15,11,Spring2019
6973,W Powell & SW Eastman Parkway,12867,E,FS,11,31,42,21,Spring2019
6974,W Powell & NW Eastman Parkway,12868,W,FS,38,11,49,14,Spring2019
6975,"2800 Blk NE Brookwood Pkwy, Library",12875,N,AT,4,13,17,2,Spring2019
6976,SW Moody & Gaines,12880,S,FS,10,34,44,2,Spring2019
6977,NE Brookwood & Airport Rd,12884,N,FS,0,3,3,0,Spring2019
6978,SW Fairview & Kingston,12886,W,FS,1,0,1,0,Spring2019
6979,SE Hawthorne & 34th,12892,W,NS,119,51,170,7,Spring2019
6980,Merlo Rd/SW 158th MAX Stn Turnaround,12899,E,AT,233,234,467,40,Spring2019
6981,SE Holgate & 97th,12900,E,FS,2,18,20,0,Spring2019
6982,SE Sunnyside & 152nd,12901,E,FS,2,9,11,4,Spring2019
6983,SE Sunnyside & 157th,12902,W,NS,20,1,21,3,Spring2019
6984,SE Sunnyside & 152nd,12903,W,FS,9,2,11,1,Spring2019
6985,SE Foster & Cora,12904,W,NS,35,8,43,5,Spring2019
6986,SE 97th & Park Mountain Lane,12912,S,OP,1,6,7,0,Spring2019
6987,SE Holgate & 97th,12914,W,OP,18,3,21,0,Spring2019
6988,Delta Park/Vanport,12918,S,AT,86,104,190,55,Spring2019
6989,Clackamas Town Center Mall,12921,E,AT,95,1271,1366,271,Spring2019
6996,Clackamas Town Center Mall,12922,W,AT,1296,71,1367,270,Spring2019
6997,SE Sunnyside & Misty Dr,12923,W,FS,24,2,26,5,Spring2019
6998,SE Sunnyside & 147th,12924,E,NS,7,38,45,15,Spring2019
6999,SE 152nd & Oregon Trail,12925,N,NS,0,1,1,0,Spring2019
7000,SW Center & Lombard,12932,E,NS,1,13,14,0,Spring2019
7001,SW Lombard & Center,12933,N,NS,11,2,13,3,Spring2019
7002,E Burnside & SE 99th,12934,E,NS,17,19,36,5,Spring2019
7003,19000 Block SE Hwy 224,12936,N,AT,0,0,0,0,Spring2019
7004,19300 Block SE Hwy 224,12937,S,AT,0,0,0,0,Spring2019
7005,9600 N Ramsey Blvd,12942,W,AT,0,1,1,0,Spring2019
7006,SE Stark & 130th,12943,W,OP,66,24,90,8,Spring2019
7007,SW Lombard & Broadway,12944,N,NS,8,150,158,28,Spring2019
7008,SW Lombard & Broadway,12945,S,NS,134,14,148,20,Spring2019
7009,SE Foster & 56th,12946,E,FS,10,31,41,3,Spring2019
7010,SE Foster & 74th,12948,W,NS,24,12,36,33,Spring2019
7011,SE Stark & 142nd,12949,W,OP,42,15,57,4,Spring2019
7012,12600 Block SE Stark,12950,E,AT,29,92,121,27,Spring2019
7013,SE Powell & 28th Pl,12951,E,FS,86,106,192,20,Spring2019
7014,NE Kane & 15th,12952,S,OP,21,23,44,6,Spring2019
7015,SE Stark & 214th,12953,E,OP,10,21,31,2,Spring2019
7016,SE Stark & 169th,12954,E,FS,12,30,42,16,Spring2019
7017,E Burnside & SE 57th,12955,E,FS,5,17,22,6,Spring2019
7018,SE King & Cook Ct,12956,W,FS,33,26,59,5,Spring2019
7019,SE Stark & Cherry Park,12957,W,NS,74,40,114,37,Spring2019
7020,7500 Block SW Hunziker,12958,E,AT,2,4,6,0,Spring2019
7021,PCC Lower Drive (G St) & H St,12959,W,OP,6,0,6,2,Spring2019
7022,SW Barnes & 84th,12960,E,NS,13,6,19,1,Spring2019
7023,SE Stark & 238th,12961,E,FS,14,37,51,25,Spring2019
7024,7200 Block SW Durham,12962,N,OP,11,2,13,0,Spring2019
7025,SW Oleson & Skyhar Dr,12963,N,OP,4,2,6,0,Spring2019
7026,SW Oleson & Obrien,12964,N,OP,1,1,2,0,Spring2019
7027,2900 Block NW Front,12965,S,AT,13,1,14,0,Spring2019
7028,NE Prescott & 87th,12992,W,NS,8,3,11,2,Spring2019
7029,SW Cedar Hills & Foothill Dr,12993,S,NS,2,8,10,0,Spring2019
7030,SW Cedar Hills & Foothill Dr,13018,N,NS,17,5,22,1,Spring2019
7031,SW Palater & Palatine Hill,13022,E,OP,0,2,2,0,Spring2019
7032,SE Flavel & 69th,13024,W,NS,17,4,21,1,Spring2019
7033,"2800 Blk NE Brookwood Pkwy, Library",13025,S,OP,5,0,5,0,Spring2019
7034,NE Halsey & 159th Ct,13026,W,NS,12,2,14,1,Spring2019
7035,NE Kane & SE Stark,13031,S,FS,67,120,187,71,Spring2019
7036,SE Foster & 120th,13032,W,NS,8,12,20,1,Spring2019
7037,NE Hood & 2nd,13033,S,FS,38,5,43,23,Spring2019
7038,SW Walnut & Grant,13034,N,NS,4,2,6,0,Spring2019
7039,SW 197th & Brookfield,13035,S,NS,2,3,5,0,Spring2019
7040,SW 197th & Alderwood Ct,13036,N,NS,1,1,2,0,Spring2019
7041,SE 90th & Causey,13037,S,FS,7,23,30,35,Spring2019
7042,9400 Block NE Sunderland,13040,S,AT,1,16,17,35,Spring2019
7049,SW Canyon & 115th Ave,13042,E,FS,28,12,40,20,Spring2019
7050,SE Belmont & 26th Ave,13043,E,NS,57,139,196,38,Spring2019
7051,Bryant & Lamont Way,13044,S,NS,0,1,1,0,Spring2019
7054,Tigard TC WES Station,13068,S,AT,76,158,234,0,Spring2019
7057,NE Glisan & 120th,13071,W,NS,4,1,5,1,Spring2019
7058,Tigard TC WES Station,13073,N,AT,188,65,253,0,Spring2019
7059,NE Glisan & 152nd,13075,E,OP,0,1,1,0,Spring2019
7060,SE 182nd & Bush Terrace,13076,S,FS,1,2,3,1,Spring2019
7061,Kaiser Sunnyside Medical Center,13077,W,AT,18,10,28,27,Spring2019
7062,SW Boones Ferry Rd & Martinazzi,13078,W,FS,7,48,55,18,Spring2019
7063,SW Boones Ferry Rd & Nyberg,13079,S,NS,47,44,91,5,Spring2019
7064,SW Warm Springs & Boones Ferry,13080,E,FS,6,25,31,0,Spring2019
7065,SW Warm Springs & Martinazzi,13081,E,NS,12,25,37,12,Spring2019
7066,SW Warm Springs & Martinazzi,13082,W,FS,16,10,26,0,Spring2019
7067,SW Warm Springs & Boones Ferry,13083,W,NS,24,5,29,0,Spring2019
7068,SW Boones Ferry Rd & Seneca,13084,N,NS,46,17,63,2,Spring2019
7069,SW Boones Ferry Rd & Martinazzi,13085,E,NS,38,9,47,6,Spring2019
7070,22800 Block NE Sandy,13086,E,AT,3,1,4,0,Spring2019
7071,23200 Block NE Sandy,13087,E,AT,5,4,9,1,Spring2019
7072,23500 Block NE Sandy,13088,E,AT,83,56,139,57,Spring2019
7073,NE 223rd & Arata,13089,S,OP,32,9,41,11,Spring2019
7074,23500 Block NE Sandy,13090,W,AT,46,83,129,50,Spring2019
7075,22800 Block NE Sandy,13092,W,AT,1,3,4,0,Spring2019
7076,1700 Block NW Naito Parkway,13098,N,AT,1,1,2,0,Spring2019
7077,3500 Block Willamette Falls Dr,13108,E,AT,0,0,0,0,Spring2019
7078,17500 Block SE Hwy 224,13113,W,AT,0,0,0,0,Spring2019
7079,NE Brookwood Pkwy & 49th Pl,13115,W,NS,1,0,1,0,Spring2019
7080,NE Shaver & 115th,13116,W,NS,10,1,11,0,Spring2019
7081,NE 125th Pl & Shaver,13117,S,NS,3,0,3,0,Spring2019
7082,4200 Block NE 125th Pl,13118,W,NS,8,1,9,1,Spring2019
7083,SE Harold & 104th,13122,W,NS,19,2,21,0,Spring2019
7084,SW 6th & Madison MAX Station,13123,N,NS,1094,825,1919,0,Spring2019
7085,SE Main St MAX Station,13124,S,NS,366,534,900,0,Spring2019
7086,SE Division St MAX Station,13125,S,FS,218,459,677,0,Spring2019
7087,SE Powell Blvd MAX Station,13126,S,FS,170,738,908,0,Spring2019
7088,SE Holgate Blvd MAX Station,13127,S,NS,120,487,607,0,Spring2019
7089,Lents/SE Foster Rd MAX Station,13128,S,NS,184,563,747,0,Spring2019
7090,SE Flavel St MAX Station,13129,S,FS,101,373,474,0,Spring2019
7091,SE Fuller Rd MAX Station,13130,S,AT,48,403,451,0,Spring2019
7092,Clackamas Town Center TC MAX Station,13132,N,AT,2228,2460,4688,0,Spring2019
7093,SE Fuller Rd MAX Station,13133,N,AT,355,44,399,0,Spring2019
7094,SE Flavel St MAX Station,13134,N,NS,390,89,479,0,Spring2019
7095,Lents/SE Foster Rd MAX Station,13135,N,FS,544,174,718,0,Spring2019
7102,SE Holgate Blvd MAX Station,13136,N,FS,505,124,629,0,Spring2019
7103,SE Powell Blvd MAX Station,13137,N,NS,662,197,859,0,Spring2019
7104,SE Division St MAX Station,13138,N,NS,418,233,651,0,Spring2019
7105,SE Main St MAX Station,13139,N,FS,536,344,880,0,Spring2019
7106,NE 148th & Rose Parkway,13141,S,NS,5,2,7,4,Spring2019
7107,NE 148th & Rose Parkway,13142,N,NS,2,3,5,0,Spring2019
7108,12700 Block NE San Rafael,13143,W,AT,1,0,1,0,Spring2019
7109,Flavel & I-205 Overpass,13145,E,FS,87,83,170,23,Spring2019
7110,15700 Block SE McKinley,13146,N,AT,0,1,1,0,Spring2019
7111,SE Lake & 41st Ct,13147,E,OP,1,1,2,1,Spring2019
7112,SE Lake & Vernie/41st Ct,13148,W,OP,1,2,3,0,Spring2019
7113,17100 Block SE Webster,13149,S,AT,5,2,7,0,Spring2019
7114,NE M L King & Columbia Blvd,13150,N,NS,11,63,74,7,Spring2019
7115,Webster & Cason,13153,S,NS,2,3,5,2,Spring2019
7116,E Burnside & 63rd,13155,E,FS,4,13,17,0,Spring2019
7117,SE Hwy 224 & Goosehollow,13156,S,NS,0,5,5,0,Spring2019
7118,200 Block NE Gertz Rd,13161,E,AT,4,22,26,27,Spring2019
7119,NE Gertz Rd & Vancouver Way,13162,E,NS,3,22,25,1,Spring2019
7120,NE Century (NW 229th) & Intel South Drwy,13163,N,OP,7,6,13,0,Spring2019
7121,NE Century (NW 229th) & Intel South Drwy,13164,S,NS,6,6,12,1,Spring2019
7122,SW 5th & Clay,13167,S,NS,269,136,405,36,Spring2019
7123,SW Oak & 6th,13168,W,NS,157,158,315,30,Spring2019
7124,SW Main & 6th,13169,W,NS,542,1133,1675,169,Spring2019
7125,SW Broadway & W Burnside,13170,N,NS,61,127,188,46,Spring2019
7126,W Burnside & SW 5th,13171,E,NS,171,118,289,100,Spring2019
7127,NW Naito Parkway & Couch,13176,S,FS,2,49,51,10,Spring2019
7128,NW Broadway & Everett,13178,S,NS,45,103,148,42,Spring2019
7129,SW Moody & Thomas,13183,S,NS,14,41,55,4,Spring2019
7130,SW Macadam & Lowell,13184,N,NS,21,12,33,1,Spring2019
7131,SW Macadam & Tram Tower,13185,N,AT,34,194,228,3,Spring2019
7132,13800 Block SE Oatfield,13186,N,AT,0,1,1,0,Spring2019
7133,Molalla & Harris,13187,N,FS,7,1,8,0,Spring2019
7134,NE Glisan & 24th,13193,E,FS,28,62,90,5,Spring2019
7135,NE Glisan & 24th,13194,W,NS,53,21,74,8,Spring2019
7136,SW Lower Boones Ferry & McEwan Rd,13195,E,FS,4,2,6,1,Spring2019
7137,SW Hall & Burnham,13196,N,NS,1,2,3,0,Spring2019
7138,SW Watson & 5th,13197,S,NS,33,35,68,31,Spring2019
7139,SW Highland & 14th Dr,13198,W,FS,0,0,0,0,Spring2019
7140,3500 Block SE 182nd,13199,S,AT,2,14,16,1,Spring2019
7141,NE Airport Way & Mason Ct,13200,W,FS,1,2,3,0,Spring2019
7142,NE Airport Way & Mason Ct,13201,E,NS,2,4,6,1,Spring2019
7143,SW 158th & Greystone Ct,13202,N,NS,5,5,10,2,Spring2019
7144,NW Cornell & 158th,13205,E,NS,3,2,5,0,Spring2019
7145,SW 68th & Atlanta,13210,S,FS,4,1,5,0,Spring2019
7146,NE Hood & 5th,13211,S,NS,2,0,2,1,Spring2019
7147,N Richmond & Syracuse,13212,S,FS,30,4,34,8,Spring2019
7148,NW St Helens & Larson,13214,N,FS,0,2,2,0,Spring2019
7155,18100 Block SE River Rd,13215,S,AT,0,0,0,0,Spring2019
7156,SE Holgate & SE Holgate Blvd MAX Stn,13218,E,OP,78,80,158,42,Spring2019
7157,SE Holgate & SE Holgate Blvd MAX Stn,13219,W,AT,82,120,202,43,Spring2019
7158,SE Foster & 94th,13236,W,FS,300,16,316,51,Spring2019
7159,NW 35th & Yeon,13237,S,OP,5,1,6,0,Spring2019
7160,3300 Block NW 35th,13238,S,OP,7,1,8,0,Spring2019
7161,NW 35th & Guam,13239,S,NS,16,2,18,0,Spring2019
7162,3300 Block NW Guam,13240,E,OP,5,3,8,0,Spring2019
7163,NW Guam & 31st,13241,E,NS,17,1,18,1,Spring2019
7164,3100 Block NW 31st,13242,E,AT,20,2,22,0,Spring2019
7165,NW Saltzman & Thompson,13243,N,NS,4,3,7,0,Spring2019
7166,SE Harold & 130th,13244,E,NS,0,6,6,0,Spring2019
7167,SE 136th & Foster,13245,S,NS,6,12,18,0,Spring2019
7168,Clackamas Town Center TC,13247,E,FS,16,819,835,190,Spring2019
7169,Clackamas Town Center Transit Center,13248,S,AT,1260,376,1636,269,Spring2019
7170,SE 60th & Harrison,13249,N,NS,23,4,27,2,Spring2019
7171,Oatfield & E Hereford,13252,N,OP,5,1,6,0,Spring2019
7172,SE 10th & Washington,13255,S,NS,0,23,23,2,Spring2019
7173,9300 Block SW Taylor,13256,W,OP,1,0,1,0,Spring2019
7174,SW Taylor & Morrison,13257,W,NS,5,0,5,0,Spring2019
7175,SW Taylor & Valeria View,13258,W,NS,20,0,20,0,Spring2019
7176,SW Barnes & Valeria View,13259,S,FS,0,0,0,0,Spring2019
7177,SW Valeria View & Barnes,13260,N,FS,0,1,1,0,Spring2019
7178,SW Taylor & Windwood Way,13261,E,NS,0,5,5,0,Spring2019
7179,SW Taylor & Morrison,13262,E,FS,0,2,2,0,Spring2019
7180,9300 Block SW Taylor,13263,E,AT,0,1,1,0,Spring2019
7181,SW Taylor & 90th,13264,E,NS,0,1,1,0,Spring2019
7182,NW Leahy & Oak,13265,N,FS,0,1,1,0,Spring2019
7183,NW Leahy & Trillium Hollow,13266,W,AT,0,2,2,0,Spring2019
7184,NW Saltzman & Dogwood,13267,N,FS,1,3,4,0,Spring2019
7185,NW Saltzman & Westlawn Terrace,13268,N,FS,0,0,0,0,Spring2019
7186,NW Saltzman & Marshall,13269,N,NS,0,0,0,0,Spring2019
7187,NW Saltzman & Coleman,13270,N,NS,0,0,0,0,Spring2019
7188,NW Saltzman & 128th,13271,W,FS,1,2,3,0,Spring2019
7189,NW Saltzman & Burton,13272,N,FS,0,0,0,0,Spring2019
7190,NW Saltzman & Bauer Woods,13273,N,FS,0,1,1,0,Spring2019
7191,NW Saltzman & Creekside,13274,N,FS,0,0,0,0,Spring2019
7192,NW Saltzman & Hartford,13275,N,NS,0,0,0,0,Spring2019
7193,NW Thompson & 126th,13276,E,OP,0,0,0,0,Spring2019
7194,NW Thompson & 120th,13277,E,FS,0,1,1,0,Spring2019
7195,NW Thompson & Permian,13278,E,NS,0,1,1,0,Spring2019
7196,NW Thompson & Gerritz,13279,E,FS,0,0,0,0,Spring2019
7197,NW Thompson & McDaniel,13280,E,NS,0,0,0,0,Spring2019
7198,NW McDaniel & 111th Ct,13281,W,FS,0,0,0,0,Spring2019
7199,NW McDaniel & Blackhawk,13282,W,FS,0,0,0,0,Spring2019
7200,11800 Block NW McDaniel,13283,W,OP,1,1,2,0,Spring2019
7201,NW 119th & Kathleen Dr,13284,S,FS,0,0,0,0,Spring2019
7208,NW 119th & Maple Hill,13285,S,FS,0,0,0,0,Spring2019
7209,NW 119th & Old Quarry,13286,S,FS,0,0,0,0,Spring2019
7210,NW 119th & Sunningdale,13287,S,FS,0,0,0,0,Spring2019
7211,NW 119th & Coleman,13288,S,FS,0,0,0,0,Spring2019
7212,NW 119th & Vallevue,13289,S,FS,0,0,0,0,Spring2019
7213,NW 119th & Lovejoy,13290,S,FS,0,0,0,0,Spring2019
7214,NW 119th & Kearney,13291,S,FS,0,0,0,0,Spring2019
7215,NW 119th & Reeves,13292,S,FS,0,0,0,0,Spring2019
7216,NW St Helens & Saltzman,13293,N,OP,1,5,6,0,Spring2019
7217,NW St Helens & Saltzman,13294,S,FS,4,1,5,0,Spring2019
7218,SE Division & SE Division St MAX Station,13297,E,AT,327,81,408,89,Spring2019
7219,SE Division & SE Division St MAX Station,13298,W,OP,80,296,376,73,Spring2019
7220,SW Harrison & 6th,13305,W,NS,55,412,467,75,Spring2019
7221,NW Cornell & Murray,13309,E,NS,11,29,40,7,Spring2019
7222,SW Taylor & Selba Terrace,13310,W,OP,0,0,0,0,Spring2019
7223,SW Taylor & Selba Terrace,13311,E,NS,0,0,0,0,Spring2019
7224,NW Division & Wonderview,13312,W,NS,11,9,20,3,Spring2019
7225,Glenn Otto Park,13314,W,AT,8,6,14,0,Spring2019
7226,E Columbia River Hwy & SE Kibling,13315,W,OP,2,1,3,1,Spring2019
7227,SE 185th Ave/Rockwood,13320,S,NS,1,3,4,3,Spring2019
7228,2800 Block SW Hocken,13325,N,AT,5,12,17,2,Spring2019
7229,E Burnside & SE Sandy,13327,E,FS,199,354,553,231,Spring2019
7230,NE Couch & 12th,13328,W,NS,296,253,549,191,Spring2019
7231,NE Couch & 7th,13329,W,NS,148,101,249,37,Spring2019
7232,E Columbia River Hwy & SE Jackson Park,13331,S,NS,0,1,1,0,Spring2019
7233,E Columbia River Hwy & SE Jackson Park,13332,N,OP,0,0,0,0,Spring2019
7234,E Burnside & E 181st Ave Park & Ride,13345,E,AT,0,2,2,0,Spring2019
7235,SW Capitol & Carson,13347,N,FS,7,4,11,2,Spring2019
7236,Civic Drive MAX Station,13449,W,AT,288,91,379,0,Spring2019
7237,Civic Drive MAX Station,13450,E,AT,88,296,384,0,Spring2019
7238,NW McDaniel & Harding Ct,13455,W,FS,0,0,0,0,Spring2019
7239,Oatfield & Webster,13458,N,FS,5,2,7,0,Spring2019
7240,Webster & Oatfield,13459,N,FS,4,2,6,1,Spring2019
7241,NW Cornell & 118th,13465,E,FS,12,7,19,0,Spring2019
7242,NE Kane & SE 1st,13468,S,NS,6,2,8,3,Spring2019
7243,SE Kane & 5th St,13469,S,FS,0,0,0,1,Spring2019
7244,SE Kane & 5th St,13470,N,NS,1,1,2,1,Spring2019
7245,SE Division & 156th,13471,E,OP,32,81,113,36,Spring2019
7246,NE Columbia Blvd & 47th,13472,W,FS,23,48,71,3,Spring2019
7247,E Powell & NE Elliott,13473,W,NS,0,0,0,0,Spring2019
7248,E Powell & NE Elliott,13474,E,OP,1,0,1,1,Spring2019
7249,SE 257th/Kane & Powell Valley,13475,S,FS,0,2,2,0,Spring2019
7250,SE Kane & Powell Valley,13476,N,FS,9,14,23,0,Spring2019
7251,SE Jackson & Main,13477,E,FS,178,186,364,45,Spring2019
7252,23200 Block NE Sandy,13478,W,OP,8,7,15,3,Spring2019
7253,N Fessenden & Iris Way,13479,W,FS,26,79,105,17,Spring2019
7254,NE Glisan & 127th,13480,W,FS,1,1,2,0,Spring2019
7261,8300 Block SW Hall,13481,W,AT,45,24,69,13,Spring2019
7262,SE 21st & Jackson,13482,S,NS,99,278,377,74,Spring2019
7263,10100 Block SW Commerce Circle,13493,E,AT,44,39,83,39,Spring2019
7264,SE Hwy 224 & Dowty Rd,13495,S,FS,0,0,0,0,Spring2019
7265,SE Hwy 224 & Dowty Rd,13496,N,OP,0,0,0,0,Spring2019
7266,50 Block NE Gertz Rd,13497,E,OP,9,54,63,6,Spring2019
7267,SW 198th & Rock Rd,13498,N,NS,7,6,13,0,Spring2019
7268,3300 Block SW 198th,13499,N,OP,19,46,65,9,Spring2019
7269,SW Heiney & 18th Terrace,13500,N,OP,1,3,4,0,Spring2019
7270,SW Heiney & 18th Terrace,13501,S,NS,4,2,6,0,Spring2019
7271,SW Towle & 17th Ct,13502,N,NS,3,1,4,0,Spring2019
7272,Portland International Airport - Arrivals,13504,S,AT,8,6,14,1,Spring2019
7273,NE Halsey & 208th Pl,13505,W,FS,18,4,22,0,Spring2019
7274,Gresham Transit Center,13506,E,FS,2,20,22,7,Spring2019
7275,SW 198th & Oak Ct,13517,S,FS,4,4,8,0,Spring2019
7276,19400 Block SE Stark,13523,W,AT,17,15,32,12,Spring2019
7277,N Columbia Blvd & Burgard,13526,N,NS,0,1,1,0,Spring2019
7278,N Lombard & Burgard,13527,S,NS,0,0,0,0,Spring2019
7279,NE Evergreen & Evergreen Middle School,13528,W,OP,0,0,0,0,Spring2019
7280,NE Century (NW 229th) & Brighton St,13529,S,FS,2,6,8,2,Spring2019
7281,NW Cornell & 188th,13530,E,FS,19,27,46,5,Spring2019
7282,NW Graham/257th & W Columbia River Hwy,13532,N,FS,9,66,75,7,Spring2019
7283,SW Langer & Holland,13546,W,FS,3,16,19,2,Spring2019
7284,SE Stark & 169th,13547,W,NS,27,11,38,14,Spring2019
7285,E Main & SE 33rd,13548,E,NS,8,3,11,1,Spring2019
7286,SE Powell Valley & Ironwood Flag Stop,13551,E,AT,0,0,0,0,Spring2019
7287,SE 282nd & Salquist,13552,S,FS,0,0,0,0,Spring2019
7288,SE 282nd & Welch Rd,13553,S,NS,2,0,2,0,Spring2019
7289,SE 257th/Kane & 11th,13554,S,NS,0,2,2,0,Spring2019
7290,SE Orient Dr & Chase,13555,S,OP,1,1,2,0,Spring2019
7291,SE Orient Dr & Chase,13558,N,FS,0,0,0,0,Spring2019
7292,SE 257th/Kane & 11th,13559,N,NS,1,0,1,0,Spring2019
7293,SE 282nd & Welch Rd,13560,N,FS,1,2,3,0,Spring2019
7294,SE 282nd & Salquist,13561,N,FS,0,0,0,0,Spring2019
7295,Powell Valley & Old Woods Lp Flag Stop,13562,W,AT,0,0,0,0,Spring2019
7296,S Buxton & SW 2nd,13569,S,FS,4,0,4,0,Spring2019
7297,NE M L King & Winchell,13570,S,NS,62,16,78,10,Spring2019
7298,SW Dosch & Doschview,13571,N,NS,0,0,0,0,Spring2019
7299,2600 Block SW Ravensview,13572,N,AT,4,0,4,0,Spring2019
7300,2500 Block SW Vista,13573,W,OP,0,2,2,0,Spring2019
7301,SE Mather & Summers Ln,13576,N,FS,0,7,7,1,Spring2019
7302,12900 Block SW Canyon,13577,E,AT,3,33,36,4,Spring2019
7303,6500 Block SW Taylors Ferry,13578,W,OP,0,1,1,0,Spring2019
7304,SW Farmington & Rosa Rd,13579,W,NS,14,20,34,0,Spring2019
7305,9900 Block SW Hall,13581,S,AT,4,6,10,1,Spring2019
7306,SW Blum & Palmblad,13582,W,FS,1,8,9,0,Spring2019
7307,72nd & Cardinal,13583,S,FS,1,5,6,0,Spring2019
7314,SE M L King & Morrison,13584,S,FS,32,107,139,21,Spring2019
7315,NW Cornell & 118th,13586,W,OP,6,14,20,0,Spring2019
7316,SW Hamilton & 52nd,13587,W,FS,0,3,3,0,Spring2019
7317,SW Summit Dr & Greenburg,13588,E,NS,16,12,28,1,Spring2019
7318,SW Summit Dr & Palmblad,13589,W,NS,10,18,28,3,Spring2019
7319,SW 72nd & Cherry Dr,13590,S,NS,0,1,1,0,Spring2019
7320,NE Sandy & 104th,13591,W,OP,20,24,44,8,Spring2019
7321,Beavercreek & Danielson Dr,13592,W,NS,82,11,93,39,Spring2019
7322,NE 238th & Halsey,13594,N,FS,16,22,38,10,Spring2019
7323,SE Stark & 85th,13596,W,NS,18,3,21,4,Spring2019
7324,SE Grand & Stark,13597,N,FS,119,50,169,44,Spring2019
7325,800 Block NE 181st,13598,S,OP,12,6,18,3,Spring2019
7326,SW Moody & Meade South,13601,S,AT,83,30,113,9,Spring2019
7327,Willamette Dr & Webb,13603,N,NS,4,0,4,0,Spring2019
7328,SE M L King & Stark,13613,S,FS,40,89,129,32,Spring2019
7329,700 Block NW Naito Parkway,13621,S,AT,3,6,9,11,Spring2019
7330,N Hayden Island Dr & Tomahawk Island Dr,13629,N,FS,7,47,54,5,Spring2019
7331,Relay Resources,13630,N,AT,8,14,22,5,Spring2019
7332,Hwy 224 & Paul Bunyan Ln,13631,E,NS,0,0,0,0,Spring2019
7333,Hwy 224  & Paul Bunyan Ln,13632,W,OP,0,0,0,0,Spring2019
7334,NE 9th & Hassalo,13633,S,NS,48,33,81,8,Spring2019
7335,N Vancouver Way & Jubitz,13635,N,OP,10,25,35,6,Spring2019
7336,SW Main & Commercial,13636,E,FS,75,88,163,9,Spring2019
7337,NW Yeon & 44th,13637,E,NS,36,56,92,11,Spring2019
7338,NE 102nd & Sandy,13639,N,NS,8,12,20,7,Spring2019
7339,SW Jenkins & Murray,13640,W,NS,2,2,4,0,Spring2019
7340,N Kerby & Stanton,13642,S,NS,3,9,12,2,Spring2019
7341,N Vancouver Way & Jubitz,13643,S,AT,32,13,45,4,Spring2019
7342,Kerr & Hidalgo,13645,S,FS,5,7,12,1,Spring2019
7343,SW 40th & Troy,13647,S,FS,1,2,3,0,Spring2019
7344,N Vancouver Way & NE Middlefield,13648,N,NS,2,22,24,1,Spring2019
7345,900 Block Washington,13649,S,AT,2,3,5,20,Spring2019
7346,SE Orient Dr & Elsa St,13650,E,NS,0,0,0,0,Spring2019
7347,NE Sandy & 87th,13651,E,OP,3,18,21,16,Spring2019
7348,20300 Block SE Hwy 224,13654,W,AT,0,0,0,0,Spring2019
7349,20200 Block SE Hwy 224,13655,E,AT,0,0,0,0,Spring2019
7350,SE Hwy 224 & McPartland,13657,W,FS,0,0,0,0,Spring2019
7351,SE Hwy 224 & Eckert Ln,13662,N,NS,3,0,3,1,Spring2019
7352,SE Hwy 224 & Goosehollow,13663,N,NS,5,0,5,1,Spring2019
7353,NW Laidlaw & Preakness,13666,W,FS,7,3,10,0,Spring2019
7354,NW Laidlaw & 167th Pl,13667,W,OP,1,0,1,0,Spring2019
7355,NW Laidlaw & Cove,13668,S,OP,2,2,4,3,Spring2019
7356,NW Laidlaw & West Union,13669,S,FS,7,2,9,0,Spring2019
7357,NW Laidlaw & Emerald Canyon,13670,S,FS,3,2,5,0,Spring2019
7358,NW 174th & Lonerock,13671,S,FS,4,2,6,8,Spring2019
7359,NW 174th & Bethany Elem School,13672,S,AT,3,3,6,0,Spring2019
7360,NW 174th & Parkview,13673,S,FS,1,1,2,0,Spring2019
7367,NW Bronson & 179th,13674,W,FS,0,0,0,0,Spring2019
7368,3100 Block NW Bronson,13675,W,AT,9,6,15,0,Spring2019
7369,3100 Block NW Bronson,13676,E,OP,4,9,13,0,Spring2019
7370,NW 174th & Bethany Elem School,13678,N,OP,2,3,5,0,Spring2019
7371,NW 174th & Lonerock,13679,N,FS,2,4,6,10,Spring2019
7372,NW Laidlaw & Emerald Canyon,13680,N,FS,1,4,5,1,Spring2019
7373,NW Laidlaw & Cove,13681,N,FS,2,2,4,4,Spring2019
7374,NW Laidlaw & 167th Pl,13682,E,FS,0,0,0,0,Spring2019
7375,NW Laidlaw & Preakness,13683,E,OP,2,4,6,0,Spring2019
7376,NW Laidlaw & Bethany,13685,E,NS,5,18,23,4,Spring2019
7377,Morrison Bridge/Belmont & Grand,13689,E,NS,85,118,203,60,Spring2019
7378,NW Laidlaw & West Union,13691,N,NS,3,6,9,0,Spring2019
7379,NW 174th & Parkview,13692,N,NS,1,2,3,0,Spring2019
7380,SE 17th & Rhine,13693,N,FS,48,38,86,2,Spring2019
7381,SE Division & 42nd,13696,E,OP,34,57,91,25,Spring2019
7382,PCC Rock Creek Layover,13700,N,AT,113,53,166,22,Spring2019
7383,SW Shattuck & 59th Ct,13703,N,FS,3,5,8,0,Spring2019
7384,SE 17th & Rhine,13704,S,FS,35,45,80,8,Spring2019
7385,3300 Block SW 198th,13705,S,AT,31,24,55,5,Spring2019
7386,SW 197th & Limestone Ct,13706,N,FS,8,6,14,64,Spring2019
7387,SE 82nd & Center,13707,S,NS,55,190,245,40,Spring2019
7388,Lincoln St/SW 3rd Ave MAX Station,13710,E,AT,337,240,577,0,Spring2019
7389,South Waterfront/SW Moody MAX Station,13711,E,AT,648,506,1154,0,Spring2019
7390,OMSI/SE Water MAX Station,13712,E,AT,170,168,338,0,Spring2019
7391,Clinton St/SE 12th Ave MAX Station,13713,E,AT,143,366,509,0,Spring2019
7392,SE 17th Ave & Rhine St MAX Station,13714,S,AT,84,292,376,0,Spring2019
7393,SE 17th Ave & Holgate Blvd MAX Station,13715,S,AT,97,347,444,0,Spring2019
7394,SE Bybee Blvd MAX Station,13716,S,AT,46,499,545,0,Spring2019
7395,SE Tacoma/Johnson Creek MAX Station,13717,S,AT,56,681,737,0,Spring2019
7396,Milwaukie/Main St MAX Station,13718,S,AT,61,618,679,0,Spring2019
7397,SE Park Ave MAX Station,13720,N,AT,1722,1784,3506,0,Spring2019
7398,Milwaukie/Main St MAX Station,13721,N,AT,570,42,612,0,Spring2019
7399,SE Tacoma/Johnson Creek MAX Station,13722,N,AT,724,53,777,0,Spring2019
7400,SE Bybee Blvd MAX Station,13723,N,AT,457,47,504,0,Spring2019
7401,SE 17th Ave & Holgate Blvd MAX Station,13724,N,AT,361,97,458,0,Spring2019
7402,SE 17th Ave & Rhine St MAX Station,13725,N,AT,304,83,387,0,Spring2019
7403,Clinton St/SE 12th Ave MAX Station,13726,W,AT,352,146,498,0,Spring2019
7404,OMSI/SE Water MAX Station,13727,W,AT,163,174,337,0,Spring2019
7405,South Waterfront/SW Moody MAX Station,13728,W,AT,484,704,1188,0,Spring2019
7406,Lincoln St/SW 3rd Ave MAX Station,13729,W,AT,250,406,656,0,Spring2019
7407,South Waterfront/SW Moody,13732,E,AT,405,125,530,37,Spring2019
7408,South Waterfront/SW Moody,13733,W,AT,172,417,589,50,Spring2019
7409,SW Boones Ferry & Orchard Hill,13735,N,FS,3,0,3,0,Spring2019
7410,SW Beveland & 69th,13736,W,FS,52,7,59,13,Spring2019
7411,NE Glisan & 45th,13737,E,NS,14,34,48,20,Spring2019
7412,SE Division & 23rd,13741,W,FS,27,19,46,5,Spring2019
7413,Washington & 12th,13743,S,NS,2,5,7,9,Spring2019
7420,SE 32nd & Furat Ct,13744,S,FS,5,15,20,10,Spring2019
7421,12100 N Pavilion,13748,N,NS,108,4,112,18,Spring2019
7422,SE Division & 36th,13753,E,FS,30,93,123,12,Spring2019
7423,SE River Rd & Torbank,13756,S,NS,2,4,6,0,Spring2019
7424,SE Ellis & 89th,13757,W,NS,9,2,11,4,Spring2019
7425,SW Langer & Holland,13766,E,NS,19,2,21,7,Spring2019
7426,1500 Block SW Sunset Blvd,13767,S,OP,0,0,0,0,Spring2019
7427,SW Vermont & 34th,13768,W,FS,3,33,36,1,Spring2019
7428,SW Vermont & 34th,13769,E,FS,34,4,38,0,Spring2019
7429,SE Tacoma Park & Ride,13770,S,AT,16,57,73,4,Spring2019
7430,SE Tacoma Park & Ride,13771,N,AT,48,24,72,6,Spring2019
7431,OMSI/SE Water,13772,E,AT,83,34,117,23,Spring2019
7432,OMSI/SE Water,13773,W,AT,42,83,125,28,Spring2019
7433,SE 122nd & Raymond,13775,S,FS,6,34,40,25,Spring2019
7434,SE 21st & Adams,13776,N,NS,10,25,35,3,Spring2019
7435,SE Division Pl & 8th,13778,E,NS,18,30,48,5,Spring2019
7436,SW Hall & 5th,13780,W,NS,28,316,344,42,Spring2019
7437,SE Bybee & Bybee Blvd MAX Station,13781,E,AT,56,9,65,21,Spring2019
7438,SE Bybee & Bybee Blvd MAX Station,13782,W,AT,11,51,62,12,Spring2019
7439,SE Linwood & King,13783,N,FS,6,6,12,0,Spring2019
7440,SE Linwood & King,13784,S,NS,4,6,10,2,Spring2019
7441,SE Linwood & Needham Ct,13785,N,NS,2,1,3,0,Spring2019
7442,9700 Block SE Linwood,13786,S,AT,1,2,3,0,Spring2019
7443,SE Johnson Creek & 58th Dr,13787,W,FS,3,2,5,2,Spring2019
7444,SE Johnson Creek & Wichita,13788,E,NS,1,4,5,0,Spring2019
7445,SE Johnson Creek & Stanley,13789,W,FS,4,1,5,0,Spring2019
7446,SE Johnson Creek & Stanley,13790,E,OP,2,4,6,1,Spring2019
7447,SE Milwaukie & Gideon,13791,S,FS,115,85,200,14,Spring2019
7448,SE Powell & 12th,13792,E,NS,232,184,416,92,Spring2019
7449,3700 Block SW Huber,13794,E,AT,1,0,1,0,Spring2019
7450,SE Webster & Dolinda,13801,S,NS,2,4,6,0,Spring2019
7451,4900 Block SE Johnson Creek,13805,W,AT,3,1,4,0,Spring2019
7452,4900 Block SE Johnson Creek,13806,E,OP,1,2,3,0,Spring2019
7453,SE Johnson Creek & 32nd,13807,E,FS,1,1,2,3,Spring2019
7454,NE Halsey & Wood Village,13809,W,FS,63,19,82,22,Spring2019
7455,SW Kelly & Gibbs,13815,S,FS,15,5,20,0,Spring2019
7456,SW Macadam & Sellwood Bridge,13816,S,NS,3,7,10,1,Spring2019
7457,SW Macadam & Sellwood Bridge,13817,N,FS,7,4,11,0,Spring2019
7458,10400 Block NE 6th Dr,13818,S,OP,1,1,2,0,Spring2019
7459,SE 7th & Tilikum Way,13825,N,NS,23,24,47,5,Spring2019
7460,SW Tualatin-Sherwood Rd & 90th,13827,W,NS,3,0,3,1,Spring2019
7461,SW Tualatin-Sherwood Rd & 95th,13828,W,NS,0,3,3,0,Spring2019
7462,SW Tualatin-Sherwood Rd & Teton,13829,W,NS,1,5,6,0,Spring2019
7463,SW Tualatin-Sherwood Rd & 112th,13830,W,NS,1,3,4,0,Spring2019
7464,SW Tualatin-Sherwood Rd & 115th,13831,W,NS,0,8,8,0,Spring2019
7465,SW Tualatin-Sherwood Rd & Cipole,13833,W,NS,0,2,2,0,Spring2019
7466,SW Tualatin-Sherwood Rd & Oregon St,13834,W,OP,0,4,4,0,Spring2019
7473,SW Tualatin-Sherwood Rd & Gerda Ln,13835,W,NS,0,1,1,0,Spring2019
7474,SW Tualatin-Sherwood Rd & Langer Farms,13836,W,OP,0,3,3,0,Spring2019
7475,SW Tualatin-Sherwood Rd & Langer Farms,13837,E,FS,3,0,3,0,Spring2019
7476,SW Tualatin-Sherwood Rd & Gerda Ln,13838,E,OP,1,0,1,0,Spring2019
7477,SW Tualatin-Sherwood Rd & Oregon St,13839,E,NS,1,0,1,0,Spring2019
7478,SW Tualatin-Sherwood Rd & Cipole,13840,E,OP,1,0,1,0,Spring2019
7479,SW Tualatin-Sherwood Rd & 115th,13842,E,NS,9,0,9,0,Spring2019
7480,SW Tualatin-Sherwood Rd & Avery,13843,E,NS,2,0,2,0,Spring2019
7481,SW Tualatin-Sherwood Rd & Teton,13844,E,NS,2,0,2,0,Spring2019
7482,SW Tualatin-Sherwood Rd & 95th,13845,E,NS,0,1,1,0,Spring2019
7483,SW Tualatin-Sherwood Rd & 90th,13846,E,NS,0,1,1,0,Spring2019
7484,SW Tualatin-Sherwood Rd & Boones Ferry,13847,E,NS,0,13,13,0,Spring2019
7485,Jean Rd & Pilkington,13854,W,FS,2,1,3,1,Spring2019
7486,Jean Rd & Jean Way,13855,W,NS,0,0,0,0,Spring2019
7487,Jean Rd & Jean Way,13856,E,FS,0,0,0,0,Spring2019
7488,Jean Rd & Pilkington,13857,E,FS,1,1,2,0,Spring2019
7489,NE Cornell & Elam Young East,13858,E,FS,3,4,7,3,Spring2019
7490,SE 282nd & Powell Valley,13867,N,NS,1,2,3,2,Spring2019
7491,1400 Block NW Naito Parkway,13868,S,OP,0,0,0,0,Spring2019
7492,N Syracuse & Chicago,13869,S,FS,8,24,32,76,Spring2019
7493,SW Pacific Hwy & Dartmouth,13870,N,FS,55,41,96,16,Spring2019
7494,SE Monterey & Fuller,13871,E,FS,5,5,10,1,Spring2019
7495,8000 Block SE Monterey,13872,E,OP,1,4,5,3,Spring2019
7496,8000 Block SE Monterey,13873,W,AT,3,1,4,1,Spring2019
7497,SE Monterey & Fuller,13874,W,NS,7,4,11,0,Spring2019
7498,N St Louis & Lombard,13876,W,NS,3,92,95,28,Spring2019
7499,N Lombard & St Louis,13877,N,NS,82,119,201,90,Spring2019
7500,SE Division & 178th,13878,E,OP,22,75,97,17,Spring2019
7501,2500 Block NW Division,13879,W,AT,15,9,24,5,Spring2019
7502,2600 Block NW Division,13880,E,AT,12,18,30,9,Spring2019
7503,14200 Block SE Division,13881,E,AT,21,51,72,11,Spring2019
7504,NE Halsey & 92nd,13883,W,FS,12,6,18,2,Spring2019
7505,SE Sunnyside & 157th,13884,E,NS,1,20,21,3,Spring2019
7506,SE Sunnyside & 162nd,13885,E,NS,3,11,14,3,Spring2019
7507,SE 169th & Misty,13887,N,NS,9,22,31,7,Spring2019
7508,SE 172nd & Sunnyside,13888,S,NS,20,16,36,12,Spring2019
7509,SE Sunnyside & 169th,13889,W,NS,8,0,8,2,Spring2019
7510,SE Sunnyside & 162nd,13890,W,FS,8,1,9,2,Spring2019
7511,SW Boones Ferry & Trillium,13891,S,NS,0,1,1,0,Spring2019
7512,NE Multnomah & 21st,13892,W,FS,8,6,14,1,Spring2019
7513,NW 21st & Pettygrove,13899,S,NS,85,3,88,5,Spring2019
7514,SW Hall & Langtree,13900,S,NS,1,4,5,0,Spring2019
7515,SE 72nd & Clatsop,13904,N,FS,19,12,31,11,Spring2019
7516,N Hayden Meadows Dr & Kerby,13905,E,NS,6,3,9,1,Spring2019
7517,N Union Ct & East Delta Park Entrance,13906,N,FS,7,5,12,4,Spring2019
7518,N Union Ct & East Delta Park Entrance,13907,S,AT,2,11,13,3,Spring2019
7519,N Hayden Meadows Dr & Kerby,13908,W,FS,1,7,8,1,Spring2019
7526,1100 Block N Hayden Meadows Dr,13909,S,AT,25,73,98,51,Spring2019
7527,9800 Block N Whitaker,13910,N,NS,19,23,42,14,Spring2019
7528,9800 Block NE Prescott,13913,W,AT,2,7,9,1,Spring2019
7529,NE Prescott & 96th,13914,W,NS,1,9,10,1,Spring2019
7530,SW Farmington & Rose Ln,13916,W,FS,18,35,53,9,Spring2019
7531,SW Farmington & Rose Ln,13917,E,NS,41,16,57,9,Spring2019
7532,SW Denney & Queen,13924,E,FS,2,8,10,0,Spring2019
7533,SW Denney & 111th,13925,E,OP,1,6,7,0,Spring2019
7534,SW Hall & Oak,13927,S,NS,2,1,3,0,Spring2019
7535,SW Hall & Pfaffle,13928,S,NS,2,5,7,0,Spring2019
7536,11700 Block SW Hall,13929,S,OP,0,12,12,3,Spring2019
7537,SW Hall & Hunziker/Scoffins,13930,S,NS,1,3,4,1,Spring2019
7538,SW Lombard & Bruce Ln,13931,S,NS,7,8,15,4,Spring2019
7539,SW Hall & Scoffins/Hunziker,13932,N,NS,2,2,4,2,Spring2019
7540,11700 Block SW Hall,13933,N,AT,7,1,8,3,Spring2019
7541,SW Hall & Pfaffle,13934,N,FS,7,1,8,0,Spring2019
7542,SW Hall & Oak,13935,N,NS,2,1,3,0,Spring2019
7543,SW Denney & 103rd,13936,W,NS,12,6,18,12,Spring2019
7544,SW Denney & 111th,13937,W,NS,6,1,7,0,Spring2019
7545,SW Lombard & Cheshire,13938,N,FS,12,6,18,0,Spring2019
7546,NE 166th & Airport Way,13939,N,FS,3,4,7,1,Spring2019
7547,16200 Block NE Cameron,13940,W,AT,3,5,8,0,Spring2019
7548,NE 158th & Airport Way,13941,S,NS,7,1,8,0,Spring2019
7549,NE 158th & Mason,13942,S,NS,3,0,3,0,Spring2019
7550,NE 162nd & Fargo,13943,S,NS,6,0,6,1,Spring2019
7551,NE 162nd & Thompson,13944,S,NS,5,1,6,0,Spring2019
7552,NE 162nd & San Rafael,13945,S,NS,1,1,2,0,Spring2019
7553,NE 162nd & Halsey,13946,S,NS,16,6,22,4,Spring2019
7554,NE 162nd & Holladay,13947,S,FS,2,1,3,1,Spring2019
7555,NE 162nd & Glisan,13948,S,FS,15,8,23,3,Spring2019
7556,NE 162nd & E Burnside,13949,S,NS,23,34,57,17,Spring2019
7557,600 Block SE 162nd,13950,S,OP,37,17,54,15,Spring2019
7558,SE 162nd & Main,13951,S,FS,8,4,12,2,Spring2019
7559,SE Division & 49th,13952,E,FS,30,62,92,14,Spring2019
7560,SE 162nd & Mill,13953,S,FS,1,5,6,1,Spring2019
7561,SE 162nd & Grant,13954,S,NS,1,9,10,4,Spring2019
7562,SE 162nd & Division,13955,S,FS,12,48,60,28,Spring2019
7563,SE 162nd & Tibbets,13956,S,OP,1,2,3,0,Spring2019
7564,SE Powell & 162nd,13957,E,FS,11,49,60,16,Spring2019
7565,3700 Block SE 162nd,13958,N,AT,10,1,11,1,Spring2019
7566,SE 162nd & Tibbets,13959,N,FS,6,1,7,2,Spring2019
7567,SE 162nd & Division,13960,N,FS,55,15,70,21,Spring2019
7568,2000 Block SE162nd,13961,N,AT,5,0,5,1,Spring2019
7569,SE 162nd & Mill,13962,N,FS,12,2,14,1,Spring2019
7570,SE 162nd & Main,13963,N,FS,4,8,12,3,Spring2019
7571,SE 162nd & Stark,13964,N,FS,18,37,55,13,Spring2019
7572,NE 162nd & E Burnside,13965,N,FS,28,56,84,14,Spring2019
7579,600 Block NE 162nd,13966,N,OP,9,22,31,3,Spring2019
7580,NE 162nd & Holladay,13967,N,NS,0,2,2,0,Spring2019
7581,NE 162nd & Halsey,13968,N,FS,6,20,26,3,Spring2019
7582,NE 162nd & San Rafael,13969,N,FS,1,2,3,0,Spring2019
7583,NE 162nd & Thompson,13970,N,OP,1,4,5,0,Spring2019
7584,NE 162nd & Fargo,13971,N,NS,0,9,9,2,Spring2019
7585,NE 158th & Mason,13972,N,FS,3,5,8,0,Spring2019
7586,SE 1st & 3rd,13973,S,NS,8,6,14,5,Spring2019
7587,SE 3rd & 1st,13974,N,NS,2,0,2,0,Spring2019
7588,1200 Block NW Swigert Way,13975,E,AT,83,77,160,7,Spring2019
7589,1500 Block NE Graham Rd,13976,S,FS,1,0,1,0,Spring2019
7590,900 Block NE Graham Rd,13977,S,AT,2,0,2,0,Spring2019
7591,SE Hwy 224 & Oak,13978,E,NS,4,2,6,2,Spring2019
7592,SE Harmony & Fuller,13980,E,FS,1,1,2,0,Spring2019
7593,7700 Blk SE Harmony (Clack. Comm. College),13981,E,AT,2,2,4,0,Spring2019
7594,SE Harmony & Fuller,13983,W,FS,8,3,11,1,Spring2019
7595,SE Harmony & Cedarcrest,13984,W,NS,10,12,22,0,Spring2019
7596,SE Harmony & International Way,13985,S,NS,2,3,5,0,Spring2019
7597,SE Hwy 224 & Oak,13986,N,FS,3,5,8,2,Spring2019
7598,900 Block NE Graham Rd,13988,N,OP,2,3,5,0,Spring2019
7599,1500 Block NE Graham Rd,13989,N,AT,0,0,0,0,Spring2019
7600,NW Graham & N Entrance Rd,13990,W,NS,1,2,3,0,Spring2019
7601,NW Sundial & Rogers Circle,13991,N,OP,3,23,26,2,Spring2019
7602,SW Hall & Locust,13992,N,NS,2,2,4,0,Spring2019
7603,Molalla & Warner-Milne,13993,N,FS,7,0,7,1,Spring2019
7604,10800 SW Walnut,14000,E,AT,1,1,2,0,Spring2019
7605,9200 Block SE Foster,14002,W,AT,145,215,360,66,Spring2019
7606,SW Denney & 100th Terr,14003,E,NS,7,11,18,10,Spring2019
7607,NW McDaniel & Ridge,14005,S,FS,0,0,0,0,Spring2019
7608,SW Alder & 17th,14006,E,NS,69,146,215,50,Spring2019
7609,W Burnside & NW 24th Pl,14009,W,FS,14,46,60,5,Spring2019
7610,NE Couch & Grand,14015,W,FS,268,263,531,126,Spring2019
7611,SE Powell & 99th,14018,E,FS,11,23,34,5,Spring2019
7612,Clackamas Community College,14019,N,AT,37,37,74,6,Spring2019
7613,10100 Block SE 82nd,14028,N,FS,77,59,136,53,Spring2019
7614,SE Eagle Creek Rd & Hill Way,14029,N,FS,0,0,0,0,Spring2019
7615,SE Eagle Creek Rd & Hill Way,14030,S,NS,0,1,1,0,Spring2019
7616,N Kerby & Graham,14031,N,NS,8,7,15,2,Spring2019
7617,NW Thurman & 23rd,14032,E,FS,54,33,87,7,Spring2019
7618,NW 19th & Raleigh,14033,S,FS,10,19,29,3,Spring2019
7619,NW 19th & Marshall,14034,S,FS,8,22,30,4,Spring2019
7620,NW 19th & Flanders,14035,S,FS,3,21,24,8,Spring2019
7621,SW 17th & Yamhill,14036,S,NS,1,35,36,6,Spring2019
7622,NW 18th & Flanders,14037,N,FS,17,3,20,5,Spring2019
7623,NW 18th & Lovejoy,14038,N,NS,23,9,32,5,Spring2019
7624,NW 18th & Raleigh,14039,N,FS,22,12,34,3,Spring2019
7625,NW Thurman & 21st,14040,W,FS,5,23,28,5,Spring2019
7632,SE Thiessen & Topaz,14041,W,FS,1,1,2,1,Spring2019
7633,SE Thiessen & Anna Marie Ct,14042,W,FS,2,5,7,4,Spring2019
7634,SE Thiessen & Anna Marie Ct,14043,E,NS,3,1,4,3,Spring2019
7635,SE Thiessen & Topaz,14044,E,FS,1,1,2,0,Spring2019
7636,SE Thiessen & Johnson,14045,E,NS,1,1,2,0,Spring2019
7637,17800 Block SE 82nd Dr,14046,S,AT,2,6,8,2,Spring2019
7638,2000 Block Washington,14047,W,FS,3,4,7,0,Spring2019
7639,2000 Block Washington,14048,E,OP,3,4,7,1,Spring2019
7640,17800 Block SE 82nd Dr,14049,N,OP,5,3,8,2,Spring2019
7641,SW Hall & Spruce,14051,S,NS,2,2,4,1,Spring2019
7642,SW Hall & Spruce,14052,N,FS,2,2,4,1,Spring2019
7643,SW Columbia & 2nd,14053,E,NS,216,6,222,20,Spring2019
7644,Ostman & Fields,14054,S,NS,1,1,2,0,Spring2019
7645,27400 Block SE Eagle Creek Rd,14055,S,OP,0,0,0,0,Spring2019
7646,High St & 2nd,14056,S,NS,7,3,10,1,Spring2019
7647,W Burnside & NW 2nd,14057,W,FS,93,424,517,174,Spring2019
7648,6200 Block SW Hall,14059,S,OP,81,39,120,14,Spring2019
7649,5000 Block SW Vermont,14062,E,AT,0,0,0,0,Spring2019
7650,SE Jefferson & Main,14064,E,NS,19,69,88,14,Spring2019
